instant,datetime,season,year,month,hour,holiday,weekday,workingday,weather,temp,atemp,humidity,windspeed,casual,registered,total_count,recency,frequency,monetary
1,2011-01-01,Spring,2011,Jan,0,0,Saturday,0,Clear,0.24,0.2879,0.81,0.0,3,13,16,730,16,16
2,2011-01-01,Spring,2011,Jan,1,0,Saturday,0,Clear,0.22,0.2727,0.8,0.0,8,32,40,730,40,40
3,2011-01-01,Spring,2011,Jan,2,0,Saturday,0,Clear,0.22,0.2727,0.8,0.0,5,27,32,730,32,32
4,2011-01-01,Spring,2011,Jan,3,0,Saturday,0,Clear,0.24,0.2879,0.75,0.0,3,10,13,730,13,13
5,2011-01-01,Spring,2011,Jan,4,0,Saturday,0,Clear,0.24,0.2879,0.75,0.0,0,1,1,730,1,1
6,2011-01-01,Spring,2011,Jan,5,0,Saturday,0,Misty,0.24,0.2576,0.75,0.0896,0,1,1,730,1,1
7,2011-01-01,Spring,2011,Jan,6,0,Saturday,0,Clear,0.22,0.2727,0.8,0.0,2,0,2,730,2,2
8,2011-01-01,Spring,2011,Jan,7,0,Saturday,0,Clear,0.2,0.2576,0.86,0.0,1,2,3,730,3,3
9,2011-01-01,Spring,2011,Jan,8,0,Saturday,0,Clear,0.24,0.2879,0.75,0.0,1,7,8,730,8,8
10,2011-01-01,Spring,2011,Jan,9,0,Saturday,0,Clear,0.32,0.3485,0.76,0.0,8,6,14,730,14,14
11,2011-01-01,Spring,2011,Jan,10,0,Saturday,0,Clear,0.38,0.3939,0.76,0.2537,12,24,36,730,36,36
12,2011-01-01,Spring,2011,Jan,11,0,Saturday,0,Clear,0.36,0.3333,0.81,0.2836,26,30,56,730,56,56
13,2011-01-01,Spring,2011,Jan,12,0,Saturday,0,Clear,0.42,0.4242,0.77,0.2836,29,55,84,730,84,84
14,2011-01-01,Spring,2011,Jan,13,0,Saturday,0,Misty,0.46,0.4545,0.72,0.2985,47,47,94,730,94,94
15,2011-01-01,Spring,2011,Jan,14,0,Saturday,0,Misty,0.46,0.4545,0.72,0.2836,35,71,106,730,106,106
16,2011-01-01,Spring,2011,Jan,15,0,Saturday,0,Misty,0.44,0.4394,0.77,0.2985,40,70,110,730,110,110
17,2011-01-01,Spring,2011,Jan,16,0,Saturday,0,Misty,0.42,0.4242,0.82,0.2985,41,52,93,730,93,93
18,2011-01-01,Spring,2011,Jan,17,0,Saturday,0,Misty,0.44,0.4394,0.82,0.2836,15,52,67,730,67,67
19,2011-01-01,Spring,2011,Jan,18,0,Saturday,0,Light_rainsnow,0.42,0.4242,0.88,0.2537,9,26,35,730,35,35
20,2011-01-01,Spring,2011,Jan,19,0,Saturday,0,Light_rainsnow,0.42,0.4242,0.88,0.2537,6,31,37,730,37,37
21,2011-01-01,Spring,2011,Jan,20,0,Saturday,0,Misty,0.4,0.4091,0.87,0.2537,11,25,36,730,36,36
22,2011-01-01,Spring,2011,Jan,21,0,Saturday,0,Misty,0.4,0.4091,0.87,0.194,3,31,34,730,34,34
23,2011-01-01,Spring,2011,Jan,22,0,Saturday,0,Misty,0.4,0.4091,0.94,0.2239,11,17,28,730,28,28
24,2011-01-01,Spring,2011,Jan,23,0,Saturday,0,Misty,0.46,0.4545,0.88,0.2985,15,24,39,730,39,39
25,2011-01-02,Spring,2011,Jan,0,0,Sunday,0,Misty,0.46,0.4545,0.88,0.2985,4,13,17,729,17,17
26,2011-01-02,Spring,2011,Jan,1,0,Sunday,0,Misty,0.44,0.4394,0.94,0.2537,1,16,17,729,17,17
27,2011-01-02,Spring,2011,Jan,2,0,Sunday,0,Misty,0.42,0.4242,1.0,0.2836,1,8,9,729,9,9
28,2011-01-02,Spring,2011,Jan,3,0,Sunday,0,Misty,0.46,0.4545,0.94,0.194,2,4,6,729,6,6
29,2011-01-02,Spring,2011,Jan,4,0,Sunday,0,Misty,0.46,0.4545,0.94,0.194,2,1,3,729,3,3
30,2011-01-02,Spring,2011,Jan,6,0,Sunday,0,Light_rainsnow,0.42,0.4242,0.77,0.2985,0,2,2,729,2,2
31,2011-01-02,Spring,2011,Jan,7,0,Sunday,0,Misty,0.4,0.4091,0.76,0.194,0,1,1,729,1,1
32,2011-01-02,Spring,2011,Jan,8,0,Sunday,0,Light_rainsnow,0.4,0.4091,0.71,0.2239,0,8,8,729,8,8
33,2011-01-02,Spring,2011,Jan,9,0,Sunday,0,Misty,0.38,0.3939,0.76,0.2239,1,19,20,729,20,20
34,2011-01-02,Spring,2011,Jan,10,0,Sunday,0,Misty,0.36,0.3485,0.81,0.2239,7,46,53,729,53,53
35,2011-01-02,Spring,2011,Jan,11,0,Sunday,0,Misty,0.36,0.3333,0.71,0.2537,16,54,70,729,70,70
36,2011-01-02,Spring,2011,Jan,12,0,Sunday,0,Misty,0.36,0.3333,0.66,0.2985,20,73,93,729,93,93
37,2011-01-02,Spring,2011,Jan,13,0,Sunday,0,Misty,0.36,0.3485,0.66,0.1343,11,64,75,729,75,75
38,2011-01-02,Spring,2011,Jan,14,0,Sunday,0,Light_rainsnow,0.36,0.3485,0.76,0.194,4,55,59,729,59,59
39,2011-01-02,Spring,2011,Jan,15,0,Sunday,0,Light_rainsnow,0.34,0.3333,0.81,0.1642,19,55,74,729,74,74
40,2011-01-02,Spring,2011,Jan,16,0,Sunday,0,Light_rainsnow,0.34,0.3333,0.71,0.1642,9,67,76,729,76,76
41,2011-01-02,Spring,2011,Jan,17,0,Sunday,0,Clear,0.34,0.3333,0.57,0.194,7,58,65,729,65,65
42,2011-01-02,Spring,2011,Jan,18,0,Sunday,0,Misty,0.36,0.3333,0.46,0.3284,10,43,53,729,53,53
43,2011-01-02,Spring,2011,Jan,19,0,Sunday,0,Clear,0.32,0.2879,0.42,0.4478,1,29,30,729,30,30
44,2011-01-02,Spring,2011,Jan,20,0,Sunday,0,Clear,0.3,0.2727,0.39,0.3582,5,17,22,729,22,22
45,2011-01-02,Spring,2011,Jan,21,0,Sunday,0,Clear,0.26,0.2273,0.44,0.3284,11,20,31,729,31,31
46,2011-01-02,Spring,2011,Jan,22,0,Sunday,0,Clear,0.24,0.2121,0.44,0.2985,0,9,9,729,9,9
47,2011-01-02,Spring,2011,Jan,23,0,Sunday,0,Clear,0.22,0.2273,0.47,0.1642,0,8,8,729,8,8
48,2011-01-03,Spring,2011,Jan,0,0,Monday,1,Clear,0.22,0.197,0.44,0.3582,0,5,5,728,5,5
49,2011-01-03,Spring,2011,Jan,1,0,Monday,1,Clear,0.2,0.1667,0.44,0.4179,0,2,2,728,2,2
50,2011-01-03,Spring,2011,Jan,4,0,Monday,1,Clear,0.16,0.1364,0.47,0.3881,0,1,1,728,1,1
51,2011-01-03,Spring,2011,Jan,5,0,Monday,1,Clear,0.16,0.1364,0.47,0.2836,0,3,3,728,3,3
52,2011-01-03,Spring,2011,Jan,6,0,Monday,1,Clear,0.14,0.1061,0.5,0.3881,0,30,30,728,30,30
53,2011-01-03,Spring,2011,Jan,7,0,Monday,1,Clear,0.14,0.1364,0.5,0.194,1,63,64,728,64,64
54,2011-01-03,Spring,2011,Jan,8,0,Monday,1,Clear,0.14,0.1212,0.5,0.2836,1,153,154,728,154,154
55,2011-01-03,Spring,2011,Jan,9,0,Monday,1,Clear,0.16,0.1364,0.43,0.3881,7,81,88,728,88,88
56,2011-01-03,Spring,2011,Jan,10,0,Monday,1,Clear,0.18,0.1667,0.43,0.2537,11,33,44,728,44,44
57,2011-01-03,Spring,2011,Jan,11,0,Monday,1,Clear,0.2,0.1818,0.4,0.3284,10,41,51,728,51,51
58,2011-01-03,Spring,2011,Jan,12,0,Monday,1,Clear,0.22,0.2121,0.35,0.2985,13,48,61,728,61,61
59,2011-01-03,Spring,2011,Jan,13,0,Monday,1,Clear,0.24,0.2121,0.35,0.2836,8,53,61,728,61,61
60,2011-01-03,Spring,2011,Jan,14,0,Monday,1,Clear,0.26,0.2424,0.3,0.2836,11,66,77,728,77,77
61,2011-01-03,Spring,2011,Jan,15,0,Monday,1,Clear,0.26,0.2424,0.3,0.2537,14,58,72,728,72,72
62,2011-01-03,Spring,2011,Jan,16,0,Monday,1,Clear,0.26,0.2424,0.3,0.2537,9,67,76,728,76,76
63,2011-01-03,Spring,2011,Jan,17,0,Monday,1,Clear,0.24,0.2273,0.3,0.2239,11,146,157,728,157,157
64,2011-01-03,Spring,2011,Jan,18,0,Monday,1,Clear,0.24,0.2576,0.32,0.1045,9,148,157,728,157,157
65,2011-01-03,Spring,2011,Jan,19,0,Monday,1,Clear,0.2,0.2576,0.47,0.0,8,102,110,728,110,110
66,2011-01-03,Spring,2011,Jan,20,0,Monday,1,Clear,0.2,0.2273,0.47,0.1045,3,49,52,728,52,52
67,2011-01-03,Spring,2011,Jan,21,0,Monday,1,Clear,0.18,0.197,0.64,0.1343,3,49,52,728,52,52
68,2011-01-03,Spring,2011,Jan,22,0,Monday,1,Clear,0.14,0.1515,0.69,0.1343,0,20,20,728,20,20
69,2011-01-03,Spring,2011,Jan,23,0,Monday,1,Clear,0.18,0.2121,0.55,0.1045,1,11,12,728,12,12
70,2011-01-04,Spring,2011,Jan,0,0,Tuesday,1,Clear,0.16,0.1818,0.55,0.1045,0,5,5,727,5,5
71,2011-01-04,Spring,2011,Jan,1,0,Tuesday,1,Clear,0.16,0.1818,0.59,0.1045,0,2,2,727,2,2
72,2011-01-04,Spring,2011,Jan,2,0,Tuesday,1,Clear,0.14,0.1515,0.63,0.1343,0,1,1,727,1,1
73,2011-01-04,Spring,2011,Jan,4,0,Tuesday,1,Clear,0.14,0.1818,0.63,0.0896,0,2,2,727,2,2
74,2011-01-04,Spring,2011,Jan,5,0,Tuesday,1,Clear,0.12,0.1515,0.68,0.1045,0,4,4,727,4,4
75,2011-01-04,Spring,2011,Jan,6,0,Tuesday,1,Clear,0.12,0.1515,0.74,0.1045,0,36,36,727,36,36
76,2011-01-04,Spring,2011,Jan,7,0,Tuesday,1,Clear,0.12,0.1515,0.74,0.1343,2,92,94,727,94,94
77,2011-01-04,Spring,2011,Jan,8,0,Tuesday,1,Clear,0.14,0.1515,0.69,0.1642,2,177,179,727,179,179
78,2011-01-04,Spring,2011,Jan,9,0,Tuesday,1,Clear,0.16,0.1515,0.64,0.2239,2,98,100,727,100,100
79,2011-01-04,Spring,2011,Jan,10,0,Tuesday,1,Misty,0.16,0.1364,0.69,0.3284,5,37,42,727,42,42
80,2011-01-04,Spring,2011,Jan,11,0,Tuesday,1,Clear,0.22,0.2121,0.51,0.2985,7,50,57,727,57,57
81,2011-01-04,Spring,2011,Jan,12,0,Tuesday,1,Clear,0.22,0.2273,0.51,0.1642,12,66,78,727,78,78
82,2011-01-04,Spring,2011,Jan,13,0,Tuesday,1,Clear,0.24,0.2273,0.56,0.194,18,79,97,727,97,97
83,2011-01-04,Spring,2011,Jan,14,0,Tuesday,1,Clear,0.26,0.2576,0.52,0.2239,9,54,63,727,63,63
84,2011-01-04,Spring,2011,Jan,15,0,Tuesday,1,Clear,0.28,0.2727,0.52,0.2537,17,48,65,727,65,65
85,2011-01-04,Spring,2011,Jan,16,0,Tuesday,1,Clear,0.3,0.2879,0.49,0.2537,15,68,83,727,83,83
86,2011-01-04,Spring,2011,Jan,17,0,Tuesday,1,Clear,0.28,0.2727,0.48,0.2239,10,202,212,727,212,212
87,2011-01-04,Spring,2011,Jan,18,0,Tuesday,1,Clear,0.26,0.2576,0.48,0.194,3,179,182,727,182,182
88,2011-01-04,Spring,2011,Jan,19,0,Tuesday,1,Clear,0.24,0.2576,0.48,0.1045,2,110,112,727,112,112
89,2011-01-04,Spring,2011,Jan,20,0,Tuesday,1,Clear,0.24,0.2576,0.48,0.1045,1,53,54,727,54,54
90,2011-01-04,Spring,2011,Jan,21,0,Tuesday,1,Clear,0.22,0.2727,0.64,0.0,0,48,48,727,48,48
91,2011-01-04,Spring,2011,Jan,22,0,Tuesday,1,Clear,0.22,0.2576,0.64,0.0896,1,34,35,727,35,35
92,2011-01-04,Spring,2011,Jan,23,0,Tuesday,1,Clear,0.2,0.2273,0.69,0.0896,2,9,11,727,11,11
93,2011-01-05,Spring,2011,Jan,0,0,Wednesday,1,Clear,0.2,0.2576,0.64,0.0,0,6,6,726,6,6
94,2011-01-05,Spring,2011,Jan,1,0,Wednesday,1,Clear,0.16,0.197,0.74,0.0896,0,6,6,726,6,6
95,2011-01-05,Spring,2011,Jan,2,0,Wednesday,1,Clear,0.16,0.197,0.74,0.0896,0,2,2,726,2,2
96,2011-01-05,Spring,2011,Jan,4,0,Wednesday,1,Clear,0.24,0.2273,0.48,0.2239,0,2,2,726,2,2
97,2011-01-05,Spring,2011,Jan,5,0,Wednesday,1,Clear,0.22,0.2273,0.47,0.1642,0,3,3,726,3,3
98,2011-01-05,Spring,2011,Jan,6,0,Wednesday,1,Clear,0.2,0.197,0.47,0.2239,0,33,33,726,33,33
99,2011-01-05,Spring,2011,Jan,7,0,Wednesday,1,Clear,0.18,0.1818,0.43,0.194,1,87,88,726,88,88
100,2011-01-05,Spring,2011,Jan,8,0,Wednesday,1,Clear,0.2,0.1818,0.4,0.2985,3,192,195,726,195,195
101,2011-01-05,Spring,2011,Jan,9,0,Wednesday,1,Clear,0.22,0.197,0.37,0.3284,6,109,115,726,115,115
102,2011-01-05,Spring,2011,Jan,10,0,Wednesday,1,Clear,0.22,0.197,0.37,0.3284,4,53,57,726,57,57
103,2011-01-05,Spring,2011,Jan,11,0,Wednesday,1,Clear,0.26,0.2273,0.33,0.3284,12,34,46,726,46,46
104,2011-01-05,Spring,2011,Jan,12,0,Wednesday,1,Clear,0.26,0.2273,0.33,0.3284,5,74,79,726,79,79
105,2011-01-05,Spring,2011,Jan,13,0,Wednesday,1,Clear,0.28,0.2576,0.3,0.2985,6,65,71,726,71,71
106,2011-01-05,Spring,2011,Jan,14,0,Wednesday,1,Clear,0.3,0.2879,0.28,0.194,10,52,62,726,62,62
107,2011-01-05,Spring,2011,Jan,15,0,Wednesday,1,Clear,0.3,0.2879,0.28,0.194,7,55,62,726,62,62
108,2011-01-05,Spring,2011,Jan,16,0,Wednesday,1,Clear,0.3,0.3182,0.28,0.0896,4,85,89,726,89,89
109,2011-01-05,Spring,2011,Jan,17,0,Wednesday,1,Clear,0.24,0.2273,0.38,0.194,4,186,190,726,190,190
110,2011-01-05,Spring,2011,Jan,18,0,Wednesday,1,Clear,0.24,0.2424,0.38,0.1343,3,166,169,726,169,169
111,2011-01-05,Spring,2011,Jan,19,0,Wednesday,1,Clear,0.24,0.2576,0.38,0.1045,5,127,132,726,132,132
112,2011-01-05,Spring,2011,Jan,20,0,Wednesday,1,Clear,0.22,0.2273,0.47,0.1642,7,82,89,726,89,89
113,2011-01-05,Spring,2011,Jan,21,0,Wednesday,1,Clear,0.2,0.197,0.51,0.194,3,40,43,726,43,43
114,2011-01-05,Spring,2011,Jan,22,0,Wednesday,1,Clear,0.18,0.197,0.55,0.1343,1,41,42,726,42,42
115,2011-01-05,Spring,2011,Jan,23,0,Wednesday,1,Clear,0.2,0.2576,0.47,0.0,1,18,19,726,19,19
116,2011-01-06,Spring,2011,Jan,0,0,Thursday,1,Clear,0.18,0.2424,0.55,0.0,0,11,11,725,11,11
117,2011-01-06,Spring,2011,Jan,1,0,Thursday,1,Clear,0.16,0.2273,0.64,0.0,0,4,4,725,4,4
118,2011-01-06,Spring,2011,Jan,2,0,Thursday,1,Clear,0.16,0.2273,0.64,0.0,0,2,2,725,2,2
119,2011-01-06,Spring,2011,Jan,4,0,Thursday,1,Misty,0.16,0.197,0.64,0.0896,0,1,1,725,1,1
120,2011-01-06,Spring,2011,Jan,5,0,Thursday,1,Misty,0.14,0.1818,0.69,0.0896,0,4,4,725,4,4
121,2011-01-06,Spring,2011,Jan,6,0,Thursday,1,Misty,0.14,0.1667,0.63,0.1045,0,36,36,725,36,36
122,2011-01-06,Spring,2011,Jan,7,0,Thursday,1,Misty,0.16,0.2273,0.59,0.0,0,95,95,725,95,95
123,2011-01-06,Spring,2011,Jan,8,0,Thursday,1,Clear,0.16,0.2273,0.59,0.0,3,216,219,725,219,219
124,2011-01-06,Spring,2011,Jan,9,0,Thursday,1,Misty,0.18,0.2424,0.51,0.0,6,116,122,725,122,122
125,2011-01-06,Spring,2011,Jan,10,0,Thursday,1,Clear,0.2,0.2576,0.47,0.0,3,42,45,725,45,45
126,2011-01-06,Spring,2011,Jan,11,0,Thursday,1,Clear,0.22,0.2576,0.44,0.0896,2,57,59,725,59,59
127,2011-01-06,Spring,2011,Jan,12,0,Thursday,1,Clear,0.26,0.2879,0.35,0.0,6,78,84,725,84,84
128,2011-01-06,Spring,2011,Jan,13,0,Thursday,1,Clear,0.26,0.2727,0.35,0.1045,12,55,67,725,67,67
129,2011-01-06,Spring,2011,Jan,14,0,Thursday,1,Clear,0.28,0.2727,0.36,0.1642,11,59,70,725,70,70
130,2011-01-06,Spring,2011,Jan,15,0,Thursday,1,Clear,0.28,0.2727,0.36,0.0,8,54,62,725,62,62
131,2011-01-06,Spring,2011,Jan,16,0,Thursday,1,Clear,0.26,0.2576,0.38,0.1642,12,74,86,725,86,86
132,2011-01-06,Spring,2011,Jan,17,0,Thursday,1,Clear,0.22,0.2273,0.51,0.1642,9,163,172,725,172,172
133,2011-01-06,Spring,2011,Jan,18,0,Thursday,1,Clear,0.22,0.2273,0.51,0.1343,5,158,163,725,163,163
134,2011-01-06,Spring,2011,Jan,19,0,Thursday,1,Clear,0.22,0.2576,0.55,0.0896,3,109,112,725,112,112
135,2011-01-06,Spring,2011,Jan,20,0,Thursday,1,Clear,0.2,0.2121,0.51,0.1642,3,66,69,725,69,69
136,2011-01-06,Spring,2011,Jan,21,0,Thursday,1,Misty,0.22,0.2121,0.55,0.2239,0,48,48,725,48,48
137,2011-01-06,Spring,2011,Jan,22,0,Thursday,1,Misty,0.22,0.2121,0.51,0.2836,1,51,52,725,52,52
138,2011-01-06,Spring,2011,Jan,23,0,Thursday,1,Misty,0.2,0.197,0.59,0.194,4,19,23,725,23,23
139,2011-01-07,Spring,2011,Jan,0,0,Friday,1,Misty,0.2,0.197,0.64,0.194,4,13,17,724,17,17
140,2011-01-07,Spring,2011,Jan,1,0,Friday,1,Misty,0.2,0.197,0.69,0.2239,2,5,7,724,7,7
141,2011-01-07,Spring,2011,Jan,2,0,Friday,1,Misty,0.2,0.197,0.69,0.2239,0,1,1,724,1,1
142,2011-01-07,Spring,2011,Jan,4,0,Friday,1,Misty,0.2,0.2121,0.69,0.1343,0,1,1,724,1,1
143,2011-01-07,Spring,2011,Jan,5,0,Friday,1,Light_rainsnow,0.22,0.2727,0.55,0.0,0,5,5,724,5,5
144,2011-01-07,Spring,2011,Jan,6,0,Friday,1,Misty,0.2,0.2576,0.69,0.0,8,26,34,724,34,34
145,2011-01-07,Spring,2011,Jan,7,0,Friday,1,Clear,0.2,0.2121,0.69,0.1343,8,76,84,724,84,84
146,2011-01-07,Spring,2011,Jan,8,0,Friday,1,Clear,0.2,0.197,0.51,0.2537,20,190,210,724,210,210
147,2011-01-07,Spring,2011,Jan,9,0,Friday,1,Clear,0.2,0.1818,0.47,0.2985,9,125,134,724,134,134
148,2011-01-07,Spring,2011,Jan,10,0,Friday,1,Clear,0.22,0.197,0.37,0.3284,16,47,63,724,63,63
149,2011-01-07,Spring,2011,Jan,11,0,Friday,1,Misty,0.2,0.197,0.4,0.2239,19,48,67,724,67,67
150,2011-01-07,Spring,2011,Jan,12,0,Friday,1,Misty,0.2,0.197,0.37,0.2537,9,50,59,724,59,59
151,2011-01-07,Spring,2011,Jan,13,0,Friday,1,Misty,0.2,0.1818,0.37,0.2836,9,64,73,724,73,73
152,2011-01-07,Spring,2011,Jan,14,0,Friday,1,Misty,0.2,0.197,0.4,0.2537,7,43,50,724,50,50
153,2011-01-07,Spring,2011,Jan,15,0,Friday,1,Misty,0.2,0.2121,0.37,0.1642,9,63,72,724,72,72
154,2011-01-07,Spring,2011,Jan,16,0,Friday,1,Misty,0.2,0.2121,0.37,0.1642,5,82,87,724,87,87
155,2011-01-07,Spring,2011,Jan,17,0,Friday,1,Misty,0.2,0.2576,0.37,0.0,9,178,187,724,187,187
156,2011-01-07,Spring,2011,Jan,18,0,Friday,1,Clear,0.2,0.2273,0.4,0.0896,7,116,123,724,123,123
157,2011-01-07,Spring,2011,Jan,19,0,Friday,1,Clear,0.16,0.197,0.55,0.0896,3,92,95,724,95,95
158,2011-01-07,Spring,2011,Jan,20,0,Friday,1,Clear,0.18,0.2121,0.47,0.1045,1,50,51,724,51,51
159,2011-01-07,Spring,2011,Jan,21,0,Friday,1,Clear,0.18,0.197,0.47,0.1343,0,39,39,724,39,39
160,2011-01-07,Spring,2011,Jan,22,0,Friday,1,Misty,0.18,0.197,0.43,0.1642,2,34,36,724,36,36
161,2011-01-07,Spring,2011,Jan,23,0,Friday,1,Misty,0.18,0.197,0.51,0.1642,1,14,15,724,15,15
162,2011-01-08,Spring,2011,Jan,0,0,Saturday,0,Misty,0.18,0.197,0.51,0.1642,1,24,25,723,25,25
163,2011-01-08,Spring,2011,Jan,1,0,Saturday,0,Misty,0.18,0.2121,0.55,0.0896,1,15,16,723,16,16
164,2011-01-08,Spring,2011,Jan,2,0,Saturday,0,Misty,0.18,0.2424,0.55,0.0,3,13,16,723,16,16
165,2011-01-08,Spring,2011,Jan,3,0,Saturday,0,Light_rainsnow,0.18,0.197,0.55,0.1642,0,7,7,723,7,7
166,2011-01-08,Spring,2011,Jan,4,0,Saturday,0,Light_rainsnow,0.18,0.197,0.55,0.1642,0,1,1,723,1,1
167,2011-01-08,Spring,2011,Jan,5,0,Saturday,0,Misty,0.16,0.1667,0.74,0.1642,0,5,5,723,5,5
168,2011-01-08,Spring,2011,Jan,6,0,Saturday,0,Misty,0.16,0.1667,0.74,0.1642,0,2,2,723,2,2
169,2011-01-08,Spring,2011,Jan,7,0,Saturday,0,Misty,0.16,0.1818,0.74,0.1045,1,8,9,723,9,9
170,2011-01-08,Spring,2011,Jan,8,0,Saturday,0,Light_rainsnow,0.16,0.1818,0.93,0.1045,0,15,15,723,15,15
171,2011-01-08,Spring,2011,Jan,9,0,Saturday,0,Light_rainsnow,0.16,0.1818,0.93,0.1045,0,20,20,723,20,20
172,2011-01-08,Spring,2011,Jan,10,0,Saturday,0,Misty,0.18,0.197,0.8,0.1642,5,56,61,723,61,61
173,2011-01-08,Spring,2011,Jan,11,0,Saturday,0,Misty,0.2,0.1818,0.69,0.3881,2,60,62,723,62,62
174,2011-01-08,Spring,2011,Jan,12,0,Saturday,0,Misty,0.2,0.1818,0.59,0.3582,8,90,98,723,98,98
175,2011-01-08,Spring,2011,Jan,13,0,Saturday,0,Clear,0.2,0.1818,0.44,0.3284,7,95,102,723,102,102
176,2011-01-08,Spring,2011,Jan,14,0,Saturday,0,Clear,0.2,0.1667,0.32,0.4925,12,83,95,723,95,95
177,2011-01-08,Spring,2011,Jan,15,0,Saturday,0,Clear,0.2,0.1667,0.32,0.4478,5,69,74,723,74,74
178,2011-01-08,Spring,2011,Jan,16,0,Saturday,0,Clear,0.18,0.1364,0.29,0.4478,8,68,76,723,76,76
179,2011-01-08,Spring,2011,Jan,17,0,Saturday,0,Clear,0.16,0.1212,0.37,0.5522,5,64,69,723,69,69
180,2011-01-08,Spring,2011,Jan,18,0,Saturday,0,Clear,0.14,0.1212,0.39,0.2985,3,52,55,723,55,55
181,2011-01-08,Spring,2011,Jan,19,0,Saturday,0,Clear,0.14,0.1212,0.36,0.2537,4,26,30,723,30,30
182,2011-01-08,Spring,2011,Jan,20,0,Saturday,0,Clear,0.12,0.1212,0.36,0.2537,0,28,28,723,28,28
183,2011-01-08,Spring,2011,Jan,21,0,Saturday,0,Clear,0.12,0.1061,0.39,0.3582,2,35,37,723,37,37
184,2011-01-08,Spring,2011,Jan,22,0,Saturday,0,Clear,0.12,0.1061,0.36,0.3881,1,33,34,723,34,34
185,2011-01-08,Spring,2011,Jan,23,0,Saturday,0,Clear,0.1,0.0606,0.39,0.4478,0,22,22,723,22,22
186,2011-01-09,Spring,2011,Jan,0,0,Sunday,0,Clear,0.1,0.0758,0.42,0.3881,1,24,25,722,25,25
187,2011-01-09,Spring,2011,Jan,1,0,Sunday,0,Clear,0.1,0.0606,0.42,0.4627,0,12,12,722,12,12
188,2011-01-09,Spring,2011,Jan,2,0,Sunday,0,Clear,0.1,0.0606,0.46,0.4627,0,11,11,722,11,11
189,2011-01-09,Spring,2011,Jan,3,0,Sunday,0,Clear,0.1,0.0758,0.46,0.4179,0,4,4,722,4,4
190,2011-01-09,Spring,2011,Jan,4,0,Sunday,0,Clear,0.08,0.0909,0.53,0.194,0,1,1,722,1,1
191,2011-01-09,Spring,2011,Jan,5,0,Sunday,0,Clear,0.08,0.0909,0.53,0.194,0,1,1,722,1,1
192,2011-01-09,Spring,2011,Jan,6,0,Sunday,0,Clear,0.1,0.0909,0.49,0.2836,0,1,1,722,1,1
193,2011-01-09,Spring,2011,Jan,7,0,Sunday,0,Clear,0.08,0.0909,0.53,0.194,1,5,6,722,6,6
194,2011-01-09,Spring,2011,Jan,8,0,Sunday,0,Clear,0.1,0.0909,0.49,0.2836,0,10,10,722,10,10
195,2011-01-09,Spring,2011,Jan,9,0,Sunday,0,Clear,0.12,0.0758,0.46,0.5224,0,19,19,722,19,19
196,2011-01-09,Spring,2011,Jan,10,0,Sunday,0,Clear,0.14,0.1061,0.43,0.3881,0,49,49,722,49,49
197,2011-01-09,Spring,2011,Jan,11,0,Sunday,0,Clear,0.16,0.1212,0.4,0.5224,2,47,49,722,49,49
198,2011-01-09,Spring,2011,Jan,12,0,Sunday,0,Clear,0.18,0.1364,0.37,0.4478,4,79,83,722,83,83
199,2011-01-09,Spring,2011,Jan,13,0,Sunday,0,Clear,0.2,0.1667,0.34,0.4478,6,69,75,722,75,75
200,2011-01-09,Spring,2011,Jan,14,0,Sunday,0,Clear,0.22,0.1818,0.32,0.4627,8,64,72,722,72,72
201,2011-01-09,Spring,2011,Jan,15,0,Sunday,0,Clear,0.22,0.197,0.35,0.3582,5,77,82,722,82,82
202,2011-01-09,Spring,2011,Jan,16,0,Sunday,0,Clear,0.2,0.1667,0.34,0.4478,13,79,92,722,92,92
203,2011-01-09,Spring,2011,Jan,17,0,Sunday,0,Clear,0.18,0.1515,0.37,0.3881,3,59,62,722,62,62
204,2011-01-09,Spring,2011,Jan,18,0,Sunday,0,Clear,0.16,0.1364,0.4,0.3284,4,44,48,722,48,48
205,2011-01-09,Spring,2011,Jan,19,0,Sunday,0,Clear,0.16,0.1364,0.43,0.3284,1,40,41,722,41,41
206,2011-01-09,Spring,2011,Jan,20,0,Sunday,0,Clear,0.14,0.1212,0.46,0.2537,0,38,38,722,38,38
207,2011-01-09,Spring,2011,Jan,21,0,Sunday,0,Clear,0.14,0.1061,0.46,0.4179,1,19,20,722,20,20
208,2011-01-09,Spring,2011,Jan,22,0,Sunday,0,Clear,0.14,0.1212,0.46,0.2985,5,10,15,722,15,15
209,2011-01-09,Spring,2011,Jan,23,0,Sunday,0,Clear,0.12,0.1364,0.5,0.194,0,6,6,722,6,6
210,2011-01-10,Spring,2011,Jan,0,0,Monday,1,Clear,0.12,0.1212,0.5,0.2836,2,3,5,721,5,5
211,2011-01-10,Spring,2011,Jan,1,0,Monday,1,Clear,0.12,0.1212,0.5,0.2836,1,0,1,721,1,1
212,2011-01-10,Spring,2011,Jan,2,0,Monday,1,Clear,0.12,0.1212,0.5,0.2239,0,3,3,721,3,3
213,2011-01-10,Spring,2011,Jan,3,0,Monday,1,Clear,0.12,0.1212,0.5,0.2239,0,1,1,721,1,1
214,2011-01-10,Spring,2011,Jan,4,0,Monday,1,Clear,0.1,0.1212,0.54,0.1343,1,2,3,721,3,3
215,2011-01-10,Spring,2011,Jan,5,0,Monday,1,Clear,0.1,0.1061,0.54,0.2537,0,3,3,721,3,3
216,2011-01-10,Spring,2011,Jan,6,0,Monday,1,Clear,0.12,0.1212,0.5,0.2836,0,31,31,721,31,31
217,2011-01-10,Spring,2011,Jan,7,0,Monday,1,Clear,0.12,0.1212,0.5,0.2239,2,75,77,721,77,77
218,2011-01-10,Spring,2011,Jan,8,0,Monday,1,Misty,0.12,0.1212,0.5,0.2836,4,184,188,721,188,188
219,2011-01-10,Spring,2011,Jan,9,0,Monday,1,Misty,0.14,0.1212,0.5,0.2537,2,92,94,721,94,94
220,2011-01-10,Spring,2011,Jan,10,0,Monday,1,Misty,0.14,0.1212,0.5,0.2985,0,31,31,721,31,31
221,2011-01-10,Spring,2011,Jan,11,0,Monday,1,Misty,0.16,0.1364,0.47,0.2836,2,28,30,721,30,30
222,2011-01-10,Spring,2011,Jan,12,0,Monday,1,Misty,0.2,0.1818,0.4,0.2836,5,47,52,721,52,52
223,2011-01-10,Spring,2011,Jan,13,0,Monday,1,Misty,0.2,0.1818,0.4,0.2836,4,50,54,721,54,54
224,2011-01-10,Spring,2011,Jan,14,0,Monday,1,Misty,0.2,0.197,0.4,0.2239,0,47,47,721,47,47
225,2011-01-10,Spring,2011,Jan,15,0,Monday,1,Misty,0.2,0.197,0.4,0.2239,2,43,45,721,45,45
226,2011-01-10,Spring,2011,Jan,16,0,Monday,1,Clear,0.2,0.2121,0.4,0.1343,4,70,74,721,74,74
227,2011-01-10,Spring,2011,Jan,17,0,Monday,1,Clear,0.2,0.2273,0.4,0.1045,4,174,178,721,178,178
228,2011-01-10,Spring,2011,Jan,18,0,Monday,1,Clear,0.2,0.197,0.4,0.2239,1,154,155,721,155,155
229,2011-01-10,Spring,2011,Jan,19,0,Monday,1,Clear,0.16,0.1667,0.47,0.1642,3,92,95,721,95,95
230,2011-01-10,Spring,2011,Jan,20,0,Monday,1,Clear,0.16,0.1667,0.5,0.1642,1,73,74,721,74,74
231,2011-01-10,Spring,2011,Jan,21,0,Monday,1,Clear,0.14,0.1364,0.59,0.194,1,37,38,721,38,38
232,2011-01-10,Spring,2011,Jan,22,0,Monday,1,Clear,0.14,0.1515,0.59,0.1642,2,22,24,721,24,24
233,2011-01-10,Spring,2011,Jan,23,0,Monday,1,Clear,0.14,0.1515,0.59,0.1642,0,18,18,721,18,18
234,2011-01-11,Spring,2011,Jan,0,0,Tuesday,1,Clear,0.14,0.1667,0.59,0.1045,2,10,12,720,12,12
235,2011-01-11,Spring,2011,Jan,1,0,Tuesday,1,Clear,0.14,0.1515,0.59,0.1642,0,3,3,720,3,3
236,2011-01-11,Spring,2011,Jan,2,0,Tuesday,1,Misty,0.16,0.1515,0.55,0.194,0,3,3,720,3,3
237,2011-01-11,Spring,2011,Jan,5,0,Tuesday,1,Misty,0.16,0.1818,0.55,0.1343,0,6,6,720,6,6
238,2011-01-11,Spring,2011,Jan,6,0,Tuesday,1,Misty,0.16,0.1818,0.55,0.1343,0,27,27,720,27,27
239,2011-01-11,Spring,2011,Jan,7,0,Tuesday,1,Misty,0.16,0.2273,0.55,0.0,2,97,99,720,99,99
240,2011-01-11,Spring,2011,Jan,8,0,Tuesday,1,Misty,0.18,0.2121,0.51,0.0896,3,214,217,720,217,217
241,2011-01-11,Spring,2011,Jan,9,0,Tuesday,1,Misty,0.18,0.197,0.51,0.1642,3,127,130,720,130,130
242,2011-01-11,Spring,2011,Jan,10,0,Tuesday,1,Misty,0.2,0.2121,0.51,0.1642,3,51,54,720,54,54
243,2011-01-11,Spring,2011,Jan,11,0,Tuesday,1,Misty,0.2,0.2121,0.47,0.1343,4,31,35,720,35,35
244,2011-01-11,Spring,2011,Jan,12,0,Tuesday,1,Misty,0.2,0.2273,0.51,0.1045,2,55,57,720,57,57
245,2011-01-11,Spring,2011,Jan,13,0,Tuesday,1,Misty,0.2,0.2273,0.59,0.0896,6,46,52,720,52,52
246,2011-01-11,Spring,2011,Jan,14,0,Tuesday,1,Misty,0.2,0.2273,0.59,0.0896,3,60,63,720,63,63
247,2011-01-11,Spring,2011,Jan,15,0,Tuesday,1,Misty,0.16,0.197,0.8,0.0896,2,45,47,720,47,47
248,2011-01-11,Spring,2011,Jan,16,0,Tuesday,1,Misty,0.16,0.1515,0.86,0.2239,4,72,76,720,76,76
249,2011-01-11,Spring,2011,Jan,17,0,Tuesday,1,Misty,0.16,0.1515,0.86,0.2239,6,130,136,720,136,136
250,2011-01-11,Spring,2011,Jan,18,0,Tuesday,1,Light_rainsnow,0.16,0.1818,0.93,0.1045,1,94,95,720,95,95
251,2011-01-11,Spring,2011,Jan,19,0,Tuesday,1,Light_rainsnow,0.16,0.2273,0.93,0.0,0,51,51,720,51,51
252,2011-01-11,Spring,2011,Jan,20,0,Tuesday,1,Light_rainsnow,0.16,0.1515,0.93,0.194,0,32,32,720,32,32
253,2011-01-11,Spring,2011,Jan,21,0,Tuesday,1,Light_rainsnow,0.16,0.197,0.86,0.0896,0,20,20,720,20,20
254,2011-01-11,Spring,2011,Jan,22,0,Tuesday,1,Light_rainsnow,0.16,0.1818,0.93,0.1045,1,28,29,720,29,29
255,2011-01-11,Spring,2011,Jan,23,0,Tuesday,1,Light_rainsnow,0.16,0.197,0.93,0.0896,1,18,19,720,19,19
256,2011-01-12,Spring,2011,Jan,0,0,Wednesday,1,Misty,0.16,0.197,0.86,0.0896,0,7,7,719,7,7
257,2011-01-12,Spring,2011,Jan,1,0,Wednesday,1,Misty,0.16,0.1818,0.86,0.1045,0,6,6,719,6,6
258,2011-01-12,Spring,2011,Jan,2,0,Wednesday,1,Clear,0.14,0.1515,0.86,0.1343,0,1,1,719,1,1
259,2011-01-12,Spring,2011,Jan,5,0,Wednesday,1,Clear,0.14,0.1515,0.86,0.1642,0,5,5,719,5,5
260,2011-01-12,Spring,2011,Jan,6,0,Wednesday,1,Clear,0.12,0.1515,0.93,0.1343,0,16,16,719,16,16
261,2011-01-12,Spring,2011,Jan,7,0,Wednesday,1,Clear,0.14,0.1515,0.69,0.1343,0,54,54,719,54,54
262,2011-01-12,Spring,2011,Jan,8,0,Wednesday,1,Clear,0.16,0.1667,0.59,0.1642,3,125,128,719,128,128
263,2011-01-12,Spring,2011,Jan,9,0,Wednesday,1,Clear,0.16,0.1364,0.59,0.3284,3,78,81,719,81,81
264,2011-01-12,Spring,2011,Jan,10,0,Wednesday,1,Clear,0.18,0.1818,0.55,0.2239,0,39,39,719,39,39
265,2011-01-12,Spring,2011,Jan,11,0,Wednesday,1,Clear,0.2,0.1818,0.51,0.3881,3,32,35,719,35,35
266,2011-01-12,Spring,2011,Jan,12,0,Wednesday,1,Clear,0.2,0.1515,0.47,0.5821,3,52,55,719,55,55
267,2011-01-12,Spring,2011,Jan,13,0,Wednesday,1,Clear,0.22,0.197,0.44,0.3582,0,49,49,719,49,49
268,2011-01-12,Spring,2011,Jan,14,0,Wednesday,1,Clear,0.2,0.1818,0.47,0.3284,0,44,44,719,44,44
269,2011-01-12,Spring,2011,Jan,15,0,Wednesday,1,Clear,0.2,0.1667,0.47,0.4179,1,48,49,719,49,49
270,2011-01-12,Spring,2011,Jan,16,0,Wednesday,1,Clear,0.22,0.197,0.44,0.3284,5,63,68,719,68,68
271,2011-01-12,Spring,2011,Jan,17,0,Wednesday,1,Clear,0.2,0.1818,0.47,0.3582,0,139,139,719,139,139
272,2011-01-12,Spring,2011,Jan,18,0,Wednesday,1,Clear,0.2,0.1515,0.47,0.5224,2,135,137,719,137,137
273,2011-01-12,Spring,2011,Jan,19,0,Wednesday,1,Clear,0.18,0.1515,0.47,0.4179,1,82,83,719,83,83
274,2011-01-12,Spring,2011,Jan,20,0,Wednesday,1,Clear,0.16,0.1364,0.5,0.3284,2,54,56,719,56,56
275,2011-01-12,Spring,2011,Jan,21,0,Wednesday,1,Clear,0.16,0.1364,0.55,0.3284,0,57,57,719,57,57
276,2011-01-12,Spring,2011,Jan,22,0,Wednesday,1,Clear,0.16,0.1212,0.55,0.4478,1,32,33,719,33,33
277,2011-01-12,Spring,2011,Jan,23,0,Wednesday,1,Clear,0.14,0.1061,0.59,0.4179,1,19,20,719,20,20
278,2011-01-13,Spring,2011,Jan,0,0,Thursday,1,Clear,0.14,0.1212,0.59,0.2836,1,6,7,718,7,7
279,2011-01-13,Spring,2011,Jan,1,0,Thursday,1,Clear,0.14,0.1212,0.5,0.2836,0,2,2,718,2,2
280,2011-01-13,Spring,2011,Jan,2,0,Thursday,1,Clear,0.14,0.1212,0.5,0.3582,0,2,2,718,2,2
281,2011-01-13,Spring,2011,Jan,3,0,Thursday,1,Clear,0.14,0.1212,0.5,0.3284,0,3,3,718,3,3
282,2011-01-13,Spring,2011,Jan,4,0,Thursday,1,Clear,0.14,0.1212,0.5,0.2537,0,4,4,718,4,4
283,2011-01-13,Spring,2011,Jan,5,0,Thursday,1,Clear,0.14,0.1212,0.5,0.2985,0,3,3,718,3,3
284,2011-01-13,Spring,2011,Jan,6,0,Thursday,1,Clear,0.12,0.1515,0.54,0.1343,0,28,28,718,28,28
285,2011-01-13,Spring,2011,Jan,7,0,Thursday,1,Clear,0.12,0.1515,0.54,0.1343,0,72,72,718,72,72
286,2011-01-13,Spring,2011,Jan,8,0,Thursday,1,Clear,0.14,0.1364,0.5,0.194,5,197,202,718,202,202
287,2011-01-13,Spring,2011,Jan,9,0,Thursday,1,Clear,0.14,0.1212,0.5,0.3284,2,137,139,718,139,139
288,2011-01-13,Spring,2011,Jan,10,0,Thursday,1,Misty,0.16,0.1364,0.5,0.3582,2,36,38,718,38,38
289,2011-01-13,Spring,2011,Jan,11,0,Thursday,1,Misty,0.2,0.1667,0.44,0.4478,4,33,37,718,37,37
290,2011-01-13,Spring,2011,Jan,12,0,Thursday,1,Clear,0.2,0.1667,0.44,0.4179,3,49,52,718,52,52
291,2011-01-13,Spring,2011,Jan,13,0,Thursday,1,Clear,0.22,0.197,0.41,0.4478,2,81,83,718,83,83
292,2011-01-13,Spring,2011,Jan,14,0,Thursday,1,Clear,0.22,0.197,0.41,0.3881,3,39,42,718,42,42
293,2011-01-13,Spring,2011,Jan,15,0,Thursday,1,Clear,0.24,0.2121,0.38,0.2985,5,55,60,718,60,60
294,2011-01-13,Spring,2011,Jan,16,0,Thursday,1,Clear,0.24,0.2121,0.38,0.3582,2,76,78,718,78,78
295,2011-01-13,Spring,2011,Jan,17,0,Thursday,1,Clear,0.2,0.1818,0.4,0.2836,4,158,162,718,162,162
296,2011-01-13,Spring,2011,Jan,18,0,Thursday,1,Clear,0.2,0.1818,0.4,0.3284,3,141,144,718,144,144
297,2011-01-13,Spring,2011,Jan,19,0,Thursday,1,Clear,0.16,0.1515,0.47,0.2537,1,98,99,718,99,99
298,2011-01-13,Spring,2011,Jan,20,0,Thursday,1,Clear,0.16,0.1515,0.47,0.2239,0,64,64,718,64,64
299,2011-01-13,Spring,2011,Jan,21,0,Thursday,1,Clear,0.14,0.1212,0.46,0.2985,0,40,40,718,40,40
300,2011-01-13,Spring,2011,Jan,22,0,Thursday,1,Clear,0.14,0.1212,0.46,0.3284,0,30,30,718,30,30
301,2011-01-13,Spring,2011,Jan,23,0,Thursday,1,Clear,0.12,0.1364,0.5,0.194,1,14,15,718,15,15
302,2011-01-14,Spring,2011,Jan,0,0,Friday,1,Clear,0.12,0.1364,0.5,0.194,0,14,14,717,14,14
303,2011-01-14,Spring,2011,Jan,1,0,Friday,1,Clear,0.1,0.1212,0.54,0.1642,0,5,5,717,5,5
304,2011-01-14,Spring,2011,Jan,2,0,Friday,1,Clear,0.1,0.1212,0.54,0.1343,0,1,1,717,1,1
305,2011-01-14,Spring,2011,Jan,3,0,Friday,1,Clear,0.1,0.1364,0.54,0.1045,0,1,1,717,1,1
306,2011-01-14,Spring,2011,Jan,5,0,Friday,1,Clear,0.1,0.1364,0.54,0.0896,0,8,8,717,8,8
307,2011-01-14,Spring,2011,Jan,6,0,Friday,1,Clear,0.1,0.1818,0.54,0.0,0,17,17,717,17,17
308,2011-01-14,Spring,2011,Jan,7,0,Friday,1,Clear,0.1,0.1212,0.74,0.1642,0,70,70,717,70,70
309,2011-01-14,Spring,2011,Jan,8,0,Friday,1,Clear,0.12,0.1667,0.68,0.0,2,156,158,717,158,158
310,2011-01-14,Spring,2011,Jan,9,0,Friday,1,Clear,0.14,0.1515,0.69,0.1343,0,117,117,717,117,117
311,2011-01-14,Spring,2011,Jan,10,0,Friday,1,Clear,0.18,0.1818,0.55,0.194,4,40,44,717,44,44
312,2011-01-14,Spring,2011,Jan,11,0,Friday,1,Clear,0.18,0.1667,0.51,0.2836,6,47,53,717,53,53
313,2011-01-14,Spring,2011,Jan,12,0,Friday,1,Clear,0.2,0.197,0.44,0.2537,2,59,61,717,61,61
314,2011-01-14,Spring,2011,Jan,13,0,Friday,1,Clear,0.22,0.197,0.37,0.3881,4,73,77,717,77,77
315,2011-01-14,Spring,2011,Jan,14,0,Friday,1,Clear,0.22,0.2121,0.41,0.2836,5,59,64,717,64,64
316,2011-01-14,Spring,2011,Jan,15,0,Friday,1,Clear,0.24,0.2424,0.38,0.1642,9,59,68,717,68,68
317,2011-01-14,Spring,2011,Jan,16,0,Friday,1,Clear,0.22,0.2424,0.41,0.1045,3,87,90,717,90,90
318,2011-01-14,Spring,2011,Jan,17,0,Friday,1,Clear,0.22,0.2273,0.41,0.1642,4,155,159,717,159,159
319,2011-01-14,Spring,2011,Jan,18,0,Friday,1,Clear,0.2,0.2576,0.47,0.0,5,134,139,717,139,139
320,2011-01-14,Spring,2011,Jan,19,0,Friday,1,Clear,0.16,0.197,0.59,0.0896,3,89,92,717,92,92
321,2011-01-14,Spring,2011,Jan,20,0,Friday,1,Clear,0.18,0.2424,0.59,0.0,0,68,68,717,68,68
322,2011-01-14,Spring,2011,Jan,21,0,Friday,1,Clear,0.16,0.2273,0.69,0.0,4,48,52,717,52,52
323,2011-01-14,Spring,2011,Jan,22,0,Friday,1,Misty,0.16,0.2273,0.69,0.0,2,34,36,717,36,36
324,2011-01-14,Spring,2011,Jan,23,0,Friday,1,Misty,0.18,0.2424,0.55,0.0,1,26,27,717,27,27
325,2011-01-15,Spring,2011,Jan,0,0,Saturday,0,Clear,0.18,0.2424,0.55,0.0,3,25,28,716,28,28
326,2011-01-15,Spring,2011,Jan,1,0,Saturday,0,Misty,0.16,0.197,0.59,0.0896,2,18,20,716,20,20
327,2011-01-15,Spring,2011,Jan,2,0,Saturday,0,Misty,0.16,0.197,0.59,0.0896,0,12,12,716,12,12
328,2011-01-15,Spring,2011,Jan,3,0,Saturday,0,Misty,0.16,0.2273,0.59,0.0,1,7,8,716,8,8
329,2011-01-15,Spring,2011,Jan,4,0,Saturday,0,Misty,0.16,0.2273,0.59,0.0,0,5,5,716,5,5
330,2011-01-15,Spring,2011,Jan,5,0,Saturday,0,Clear,0.16,0.2273,0.59,0.0,0,1,1,716,1,1
331,2011-01-15,Spring,2011,Jan,6,0,Saturday,0,Clear,0.14,0.1667,0.63,0.1045,1,2,3,716,3,3
332,2011-01-15,Spring,2011,Jan,7,0,Saturday,0,Clear,0.14,0.2121,0.63,0.0,1,9,10,716,10,10
333,2011-01-15,Spring,2011,Jan,8,0,Saturday,0,Clear,0.14,0.1515,0.63,0.1343,1,22,23,716,23,23
334,2011-01-15,Spring,2011,Jan,9,0,Saturday,0,Clear,0.16,0.1818,0.64,0.1343,2,31,33,716,33,33
335,2011-01-15,Spring,2011,Jan,10,0,Saturday,0,Clear,0.18,0.197,0.59,0.1642,2,57,59,716,59,59
336,2011-01-15,Spring,2011,Jan,11,0,Saturday,0,Clear,0.2,0.197,0.55,0.2239,18,54,72,716,72,72
337,2011-01-15,Spring,2011,Jan,12,0,Saturday,0,Clear,0.24,0.2273,0.48,0.2239,15,74,89,716,89,89
338,2011-01-15,Spring,2011,Jan,13,0,Saturday,0,Clear,0.28,0.2576,0.38,0.2985,21,80,101,716,101,101
339,2011-01-15,Spring,2011,Jan,14,0,Saturday,0,Clear,0.3,0.2879,0.39,0.2836,26,92,118,716,118,118
340,2011-01-15,Spring,2011,Jan,15,0,Saturday,0,Misty,0.32,0.3182,0.36,0.194,21,108,129,716,129,129
341,2011-01-15,Spring,2011,Jan,16,0,Saturday,0,Misty,0.34,0.3333,0.34,0.194,33,95,128,716,128,128
342,2011-01-15,Spring,2011,Jan,17,0,Saturday,0,Misty,0.32,0.303,0.36,0.2836,29,54,83,716,83,83
343,2011-01-15,Spring,2011,Jan,18,0,Saturday,0,Misty,0.3,0.2879,0.45,0.2537,15,69,84,716,84,84
344,2011-01-15,Spring,2011,Jan,19,0,Saturday,0,Misty,0.32,0.303,0.39,0.2537,14,60,74,716,74,74
345,2011-01-15,Spring,2011,Jan,20,0,Saturday,0,Misty,0.32,0.303,0.39,0.2537,6,35,41,716,41,41
346,2011-01-15,Spring,2011,Jan,21,0,Saturday,0,Misty,0.32,0.303,0.39,0.2239,6,51,57,716,57,57
347,2011-01-15,Spring,2011,Jan,22,0,Saturday,0,Misty,0.3,0.3182,0.42,0.1045,0,26,26,716,26,26
348,2011-01-15,Spring,2011,Jan,23,0,Saturday,0,Clear,0.3,0.2879,0.45,0.2836,5,39,44,716,44,44
349,2011-01-16,Spring,2011,Jan,0,0,Sunday,0,Clear,0.26,0.303,0.56,0.0,6,33,39,715,39,39
350,2011-01-16,Spring,2011,Jan,1,0,Sunday,0,Clear,0.26,0.2727,0.56,0.1343,4,19,23,715,23,23
351,2011-01-16,Spring,2011,Jan,2,0,Sunday,0,Clear,0.26,0.2879,0.56,0.0896,3,13,16,715,16,16
352,2011-01-16,Spring,2011,Jan,3,0,Sunday,0,Clear,0.22,0.2727,0.69,0.0,9,6,15,715,15,15
353,2011-01-16,Spring,2011,Jan,4,0,Sunday,0,Clear,0.26,0.2576,0.56,0.1642,0,1,1,715,1,1
354,2011-01-16,Spring,2011,Jan,5,0,Sunday,0,Misty,0.26,0.2576,0.56,0.1642,1,1,2,715,2,2
355,2011-01-16,Spring,2011,Jan,6,0,Sunday,0,Misty,0.26,0.2576,0.56,0.1642,0,1,1,715,1,1
356,2011-01-16,Spring,2011,Jan,7,0,Sunday,0,Misty,0.24,0.2121,0.56,0.2985,0,3,3,715,3,3
357,2011-01-16,Spring,2011,Jan,8,0,Sunday,0,Clear,0.22,0.2121,0.55,0.2836,0,18,18,715,18,18
358,2011-01-16,Spring,2011,Jan,9,0,Sunday,0,Clear,0.22,0.2121,0.51,0.2537,3,29,32,715,32,32
359,2011-01-16,Spring,2011,Jan,10,0,Sunday,0,Clear,0.22,0.2121,0.51,0.2836,8,71,79,715,79,79
360,2011-01-16,Spring,2011,Jan,11,0,Sunday,0,Clear,0.24,0.2273,0.44,0.2537,23,70,93,715,93,93
361,2011-01-16,Spring,2011,Jan,12,0,Sunday,0,Clear,0.24,0.2121,0.41,0.2836,29,75,104,715,104,104
362,2011-01-16,Spring,2011,Jan,13,0,Sunday,0,Clear,0.26,0.2273,0.35,0.2985,23,95,118,715,118,118
363,2011-01-16,Spring,2011,Jan,14,0,Sunday,0,Clear,0.28,0.2727,0.36,0.2537,22,69,91,715,91,91
364,2011-01-16,Spring,2011,Jan,15,0,Sunday,0,Clear,0.26,0.2424,0.38,0.2537,35,78,113,715,113,113
365,2011-01-16,Spring,2011,Jan,16,0,Sunday,0,Clear,0.24,0.2273,0.38,0.2239,22,77,99,715,99,99
366,2011-01-16,Spring,2011,Jan,17,0,Sunday,0,Clear,0.22,0.2121,0.37,0.2537,23,82,105,715,105,105
367,2011-01-16,Spring,2011,Jan,18,0,Sunday,0,Clear,0.2,0.2121,0.4,0.1642,11,56,67,715,67,67
368,2011-01-16,Spring,2011,Jan,19,0,Sunday,0,Clear,0.18,0.197,0.47,0.1343,14,47,61,715,61,61
369,2011-01-16,Spring,2011,Jan,20,0,Sunday,0,Clear,0.18,0.197,0.47,0.1642,7,50,57,715,57,57
370,2011-01-16,Spring,2011,Jan,21,0,Sunday,0,Clear,0.18,0.197,0.51,0.1642,6,22,28,715,28,28
371,2011-01-16,Spring,2011,Jan,22,0,Sunday,0,Misty,0.2,0.2121,0.49,0.1343,2,19,21,715,21,21
372,2011-01-16,Spring,2011,Jan,23,0,Sunday,0,Misty,0.2,0.2273,0.4,0.1045,0,18,18,715,18,18
373,2011-01-17,Spring,2011,Jan,0,1,Monday,0,Misty,0.2,0.197,0.47,0.2239,1,16,17,714,17,17
374,2011-01-17,Spring,2011,Jan,1,1,Monday,0,Misty,0.2,0.197,0.44,0.194,1,15,16,714,16,16
375,2011-01-17,Spring,2011,Jan,2,1,Monday,0,Misty,0.18,0.1667,0.43,0.2537,0,8,8,714,8,8
376,2011-01-17,Spring,2011,Jan,3,1,Monday,0,Misty,0.18,0.1818,0.43,0.194,0,2,2,714,2,2
377,2011-01-17,Spring,2011,Jan,4,1,Monday,0,Misty,0.18,0.197,0.43,0.1343,1,2,3,714,3,3
378,2011-01-17,Spring,2011,Jan,5,1,Monday,0,Misty,0.18,0.197,0.43,0.1642,0,1,1,714,1,1
379,2011-01-17,Spring,2011,Jan,6,1,Monday,0,Misty,0.18,0.1818,0.43,0.194,0,5,5,714,5,5
380,2011-01-17,Spring,2011,Jan,7,1,Monday,0,Misty,0.16,0.1818,0.5,0.1343,4,9,13,714,13,13
381,2011-01-17,Spring,2011,Jan,8,1,Monday,0,Misty,0.16,0.1515,0.47,0.2239,3,30,33,714,33,33
382,2011-01-17,Spring,2011,Jan,9,1,Monday,0,Misty,0.16,0.1515,0.47,0.2239,8,39,47,714,47,47
383,2011-01-17,Spring,2011,Jan,10,1,Monday,0,Misty,0.16,0.1515,0.5,0.2537,7,50,57,714,57,57
384,2011-01-17,Spring,2011,Jan,11,1,Monday,0,Misty,0.16,0.1515,0.55,0.194,9,55,64,714,64,64
385,2011-01-17,Spring,2011,Jan,12,1,Monday,0,Misty,0.18,0.197,0.47,0.1343,10,70,80,714,80,80
386,2011-01-17,Spring,2011,Jan,13,1,Monday,0,Misty,0.18,0.197,0.47,0.1343,13,80,93,714,93,93
387,2011-01-17,Spring,2011,Jan,14,1,Monday,0,Misty,0.18,0.2121,0.43,0.1045,12,74,86,714,86,86
388,2011-01-17,Spring,2011,Jan,15,1,Monday,0,Misty,0.2,0.2121,0.47,0.1642,21,72,93,714,93,93
389,2011-01-17,Spring,2011,Jan,16,1,Monday,0,Misty,0.2,0.2121,0.47,0.1642,6,76,82,714,82,82
390,2011-01-17,Spring,2011,Jan,17,1,Monday,0,Clear,0.2,0.197,0.51,0.194,4,67,71,714,71,71
391,2011-01-17,Spring,2011,Jan,18,1,Monday,0,Misty,0.18,0.1667,0.55,0.2537,7,85,92,714,92,92
392,2011-01-17,Spring,2011,Jan,19,1,Monday,0,Light_rainsnow,0.18,0.1818,0.59,0.194,2,58,60,714,60,60
393,2011-01-17,Spring,2011,Jan,20,1,Monday,0,Light_rainsnow,0.16,0.1515,0.8,0.194,4,29,33,714,33,33
394,2011-01-17,Spring,2011,Jan,21,1,Monday,0,Light_rainsnow,0.16,0.1515,0.8,0.194,3,24,27,714,27,27
395,2011-01-17,Spring,2011,Jan,22,1,Monday,0,Light_rainsnow,0.14,0.1212,0.93,0.2537,0,13,13,714,13,13
396,2011-01-17,Spring,2011,Jan,23,1,Monday,0,Light_rainsnow,0.16,0.1364,0.86,0.2836,1,3,4,714,4,4
397,2011-01-18,Spring,2011,Jan,12,0,Tuesday,1,Misty,0.2,0.1818,0.86,0.3284,0,3,3,713,3,3
398,2011-01-18,Spring,2011,Jan,13,0,Tuesday,1,Misty,0.2,0.197,0.86,0.2239,0,22,22,713,22,22
399,2011-01-18,Spring,2011,Jan,14,0,Tuesday,1,Misty,0.22,0.2273,0.8,0.1642,2,26,28,713,28,28
400,2011-01-18,Spring,2011,Jan,15,0,Tuesday,1,Misty,0.22,0.2273,0.87,0.1642,3,32,35,713,35,35
401,2011-01-18,Spring,2011,Jan,16,0,Tuesday,1,Misty,0.22,0.2273,0.87,0.194,0,61,61,713,61,61
402,2011-01-18,Spring,2011,Jan,17,0,Tuesday,1,Misty,0.22,0.2273,0.82,0.194,1,124,125,713,125,125
403,2011-01-18,Spring,2011,Jan,18,0,Tuesday,1,Misty,0.22,0.2273,0.8,0.1642,1,132,133,713,133,133
404,2011-01-18,Spring,2011,Jan,19,0,Tuesday,1,Misty,0.22,0.2273,0.8,0.1343,1,98,99,713,99,99
405,2011-01-18,Spring,2011,Jan,20,0,Tuesday,1,Misty,0.22,0.2727,0.87,0.0,0,83,83,713,83,83
406,2011-01-18,Spring,2011,Jan,21,0,Tuesday,1,Misty,0.22,0.2424,0.93,0.1045,0,41,41,713,41,41
407,2011-01-18,Spring,2011,Jan,22,0,Tuesday,1,Misty,0.22,0.2576,0.93,0.0896,0,33,33,713,33,33
408,2011-01-18,Spring,2011,Jan,23,0,Tuesday,1,Misty,0.22,0.2727,0.93,0.0,1,19,20,713,20,20
409,2011-01-19,Spring,2011,Jan,0,0,Wednesday,1,Misty,0.22,0.2727,0.93,0.0,0,3,3,712,3,3
410,2011-01-19,Spring,2011,Jan,1,0,Wednesday,1,Light_rainsnow,0.22,0.2273,0.93,0.1343,1,6,7,712,7,7
411,2011-01-19,Spring,2011,Jan,2,0,Wednesday,1,Light_rainsnow,0.22,0.2273,0.93,0.1343,0,3,3,712,3,3
412,2011-01-19,Spring,2011,Jan,4,0,Wednesday,1,Light_rainsnow,0.22,0.2273,0.93,0.1343,1,1,2,712,2,2
413,2011-01-19,Spring,2011,Jan,5,0,Wednesday,1,Misty,0.22,0.2576,0.93,0.0896,0,7,7,712,7,7
414,2011-01-19,Spring,2011,Jan,6,0,Wednesday,1,Misty,0.22,0.2576,0.93,0.0896,0,32,32,712,32,32
415,2011-01-19,Spring,2011,Jan,7,0,Wednesday,1,Misty,0.24,0.2576,0.92,0.1045,1,89,90,712,90,90
416,2011-01-19,Spring,2011,Jan,8,0,Wednesday,1,Misty,0.24,0.2576,0.93,0.1045,1,196,197,712,197,197
417,2011-01-19,Spring,2011,Jan,9,0,Wednesday,1,Misty,0.24,0.2576,0.93,0.1045,2,107,109,712,109,109
418,2011-01-19,Spring,2011,Jan,10,0,Wednesday,1,Misty,0.26,0.2727,0.93,0.1343,1,46,47,712,47,47
419,2011-01-19,Spring,2011,Jan,11,0,Wednesday,1,Misty,0.28,0.303,0.87,0.0896,5,47,52,712,52,52
420,2011-01-19,Spring,2011,Jan,12,0,Wednesday,1,Misty,0.3,0.3182,0.81,0.0896,5,65,70,712,70,70
421,2011-01-19,Spring,2011,Jan,13,0,Wednesday,1,Clear,0.4,0.4091,0.62,0.2836,11,67,78,712,78,78
422,2011-01-19,Spring,2011,Jan,14,0,Wednesday,1,Clear,0.4,0.4091,0.58,0.2537,7,68,75,712,75,75
423,2011-01-19,Spring,2011,Jan,15,0,Wednesday,1,Clear,0.4,0.4091,0.54,0.2836,4,78,82,712,82,82
424,2011-01-19,Spring,2011,Jan,16,0,Wednesday,1,Clear,0.38,0.3939,0.58,0.3881,10,94,104,712,104,104
425,2011-01-19,Spring,2011,Jan,17,0,Wednesday,1,Clear,0.36,0.3333,0.57,0.3284,7,190,197,712,197,197
426,2011-01-19,Spring,2011,Jan,18,0,Wednesday,1,Clear,0.34,0.3182,0.61,0.2836,5,156,161,712,161,161
427,2011-01-19,Spring,2011,Jan,19,0,Wednesday,1,Clear,0.32,0.2879,0.57,0.4179,4,108,112,712,112,112
428,2011-01-19,Spring,2011,Jan,20,0,Wednesday,1,Clear,0.32,0.303,0.49,0.2985,2,74,76,712,76,76
429,2011-01-19,Spring,2011,Jan,21,0,Wednesday,1,Clear,0.32,0.2879,0.49,0.4179,4,55,59,712,59,59
430,2011-01-19,Spring,2011,Jan,22,0,Wednesday,1,Clear,0.3,0.303,0.52,0.1642,6,53,59,712,59,59
431,2011-01-19,Spring,2011,Jan,23,0,Wednesday,1,Clear,0.3,0.2727,0.52,0.4627,1,27,28,712,28,28
432,2011-01-20,Spring,2011,Jan,0,0,Thursday,1,Clear,0.26,0.2273,0.56,0.3881,5,8,13,711,13,13
433,2011-01-20,Spring,2011,Jan,1,0,Thursday,1,Clear,0.26,0.2727,0.56,0.0,2,3,5,711,5,5
434,2011-01-20,Spring,2011,Jan,2,0,Thursday,1,Clear,0.26,0.2727,0.56,0.0,0,2,2,711,2,2
435,2011-01-20,Spring,2011,Jan,3,0,Thursday,1,Clear,0.26,0.2576,0.56,0.1642,0,1,1,711,1,1
436,2011-01-20,Spring,2011,Jan,4,0,Thursday,1,Clear,0.26,0.2576,0.56,0.1642,0,1,1,711,1,1
437,2011-01-20,Spring,2011,Jan,5,0,Thursday,1,Clear,0.24,0.2273,0.6,0.2239,0,6,6,711,6,6
438,2011-01-20,Spring,2011,Jan,6,0,Thursday,1,Clear,0.22,0.2121,0.6,0.2239,0,35,35,711,35,35
439,2011-01-20,Spring,2011,Jan,7,0,Thursday,1,Clear,0.22,0.2121,0.55,0.2239,1,100,101,711,101,101
440,2011-01-20,Spring,2011,Jan,8,0,Thursday,1,Clear,0.22,0.2121,0.55,0.2836,2,247,249,711,249,249
441,2011-01-20,Spring,2011,Jan,9,0,Thursday,1,Misty,0.24,0.2273,0.52,0.2239,3,140,143,711,143,143
442,2011-01-20,Spring,2011,Jan,10,0,Thursday,1,Clear,0.26,0.2273,0.48,0.2985,1,56,57,711,57,57
443,2011-01-20,Spring,2011,Jan,11,0,Thursday,1,Misty,0.28,0.2727,0.45,0.1642,5,63,68,711,68,68
444,2011-01-20,Spring,2011,Jan,12,0,Thursday,1,Misty,0.3,0.3333,0.42,0.0,7,77,84,711,84,84
445,2011-01-20,Spring,2011,Jan,13,0,Thursday,1,Misty,0.28,0.2879,0.45,0.1045,12,86,98,711,98,98
446,2011-01-20,Spring,2011,Jan,14,0,Thursday,1,Misty,0.3,0.303,0.45,0.1343,6,75,81,711,81,81
447,2011-01-20,Spring,2011,Jan,15,0,Thursday,1,Misty,0.32,0.3182,0.45,0.194,8,62,70,711,70,70
448,2011-01-20,Spring,2011,Jan,16,0,Thursday,1,Misty,0.3,0.303,0.49,0.1343,8,83,91,711,91,91
449,2011-01-20,Spring,2011,Jan,17,0,Thursday,1,Misty,0.3,0.3182,0.49,0.1045,8,207,215,711,215,215
450,2011-01-20,Spring,2011,Jan,18,0,Thursday,1,Misty,0.26,0.2576,0.56,0.194,1,184,185,711,185,185
451,2011-01-20,Spring,2011,Jan,19,0,Thursday,1,Clear,0.26,0.2273,0.56,0.3284,6,146,152,711,152,152
452,2011-01-20,Spring,2011,Jan,20,0,Thursday,1,Misty,0.26,0.2424,0.6,0.2836,2,124,126,711,126,126
453,2011-01-20,Spring,2011,Jan,21,0,Thursday,1,Misty,0.24,0.2273,0.6,0.2537,3,54,57,711,57,57
454,2011-01-20,Spring,2011,Jan,22,0,Thursday,1,Misty,0.24,0.2121,0.65,0.2836,0,56,56,711,56,56
455,2011-01-20,Spring,2011,Jan,23,0,Thursday,1,Misty,0.24,0.2121,0.65,0.3284,3,28,31,711,31,31
456,2011-01-21,Spring,2011,Jan,0,0,Friday,1,Misty,0.24,0.2273,0.7,0.2537,1,20,21,710,21,21
457,2011-01-21,Spring,2011,Jan,1,0,Friday,1,Misty,0.24,0.2273,0.7,0.2537,0,6,6,710,6,6
458,2011-01-21,Spring,2011,Jan,2,0,Friday,1,Light_rainsnow,0.24,0.2424,0.75,0.1642,0,2,2,710,2,2
459,2011-01-21,Spring,2011,Jan,3,0,Friday,1,Light_rainsnow,0.22,0.2121,0.8,0.2985,0,1,1,710,1,1
460,2011-01-21,Spring,2011,Jan,4,0,Friday,1,Misty,0.22,0.2576,0.87,0.0896,0,1,1,710,1,1
461,2011-01-21,Spring,2011,Jan,5,0,Friday,1,Clear,0.24,0.197,0.6,0.4179,1,4,5,710,5,5
462,2011-01-21,Spring,2011,Jan,6,0,Friday,1,Clear,0.22,0.2121,0.55,0.2537,0,27,27,710,27,27
463,2011-01-21,Spring,2011,Jan,7,0,Friday,1,Clear,0.2,0.1818,0.51,0.2836,2,66,68,710,68,68
464,2011-01-21,Spring,2011,Jan,8,0,Friday,1,Clear,0.2,0.1818,0.47,0.3284,7,210,217,710,217,217
465,2011-01-21,Spring,2011,Jan,9,0,Friday,1,Clear,0.2,0.1818,0.51,0.3582,7,159,166,710,166,166
466,2011-01-21,Spring,2011,Jan,10,0,Friday,1,Clear,0.2,0.1667,0.47,0.4627,6,57,63,710,63,63
467,2011-01-21,Spring,2011,Jan,11,0,Friday,1,Clear,0.22,0.1818,0.41,0.4627,6,53,59,710,59,59
468,2011-01-21,Spring,2011,Jan,12,0,Friday,1,Clear,0.22,0.1818,0.27,0.5821,11,67,78,710,78,78
469,2011-01-21,Spring,2011,Jan,13,0,Friday,1,Clear,0.2,0.1515,0.21,0.5821,8,65,73,710,73,73
470,2011-01-21,Spring,2011,Jan,14,0,Friday,1,Clear,0.2,0.1515,0.25,0.5224,6,56,62,710,62,62
471,2011-01-21,Spring,2011,Jan,15,0,Friday,1,Clear,0.16,0.1212,0.26,0.4478,4,61,65,710,65,65
472,2011-01-21,Spring,2011,Jan,16,0,Friday,1,Clear,0.16,0.1364,0.26,0.3582,0,97,97,710,97,97
473,2011-01-21,Spring,2011,Jan,17,0,Friday,1,Clear,0.14,0.1212,0.28,0.3582,10,151,161,710,161,161
474,2011-01-21,Spring,2011,Jan,18,0,Friday,1,Clear,0.12,0.1212,0.3,0.2537,1,119,120,710,120,120
475,2011-01-21,Spring,2011,Jan,19,0,Friday,1,Clear,0.12,0.1061,0.3,0.3284,3,93,96,710,96,96
476,2011-01-21,Spring,2011,Jan,20,0,Friday,1,Clear,0.1,0.0758,0.33,0.4179,1,52,53,710,53,53
477,2011-01-21,Spring,2011,Jan,21,0,Friday,1,Clear,0.08,0.0758,0.38,0.2836,0,41,41,710,41,41
478,2011-01-21,Spring,2011,Jan,22,0,Friday,1,Clear,0.06,0.0303,0.41,0.3881,1,33,34,710,34,34
479,2011-01-21,Spring,2011,Jan,23,0,Friday,1,Clear,0.06,0.0455,0.38,0.3284,0,27,27,710,27,27
480,2011-01-22,Spring,2011,Jan,0,0,Saturday,0,Clear,0.04,0.0303,0.45,0.2537,0,13,13,709,13,13
481,2011-01-22,Spring,2011,Jan,1,0,Saturday,0,Misty,0.04,0.0,0.41,0.3881,3,9,12,709,12,12
482,2011-01-22,Spring,2011,Jan,2,0,Saturday,0,Misty,0.04,0.0303,0.41,0.2537,0,11,11,709,11,11
483,2011-01-22,Spring,2011,Jan,3,0,Saturday,0,Misty,0.04,0.0303,0.41,0.2836,1,6,7,709,7,7
484,2011-01-22,Spring,2011,Jan,4,0,Saturday,0,Misty,0.02,0.0152,0.48,0.2985,0,3,3,709,3,3
485,2011-01-22,Spring,2011,Jan,6,0,Saturday,0,Misty,0.02,0.0303,0.44,0.2239,0,2,2,709,2,2
486,2011-01-22,Spring,2011,Jan,7,0,Saturday,0,Clear,0.02,0.0152,0.44,0.2836,0,8,8,709,8,8
487,2011-01-22,Spring,2011,Jan,8,0,Saturday,0,Clear,0.02,0.0,0.44,0.3284,1,26,27,709,27,27
488,2011-01-22,Spring,2011,Jan,9,0,Saturday,0,Clear,0.04,0.0303,0.41,0.2537,3,37,40,709,40,40
489,2011-01-22,Spring,2011,Jan,10,0,Saturday,0,Misty,0.04,0.0606,0.41,0.1642,3,50,53,709,53,53
490,2011-01-22,Spring,2011,Jan,11,0,Saturday,0,Misty,0.06,0.0758,0.38,0.1343,4,59,63,709,63,63
491,2011-01-22,Spring,2011,Jan,12,0,Saturday,0,Misty,0.06,0.1061,0.38,0.1045,10,60,70,709,70,70
492,2011-01-22,Spring,2011,Jan,13,0,Saturday,0,Clear,0.08,0.1667,0.35,0.0,12,72,84,709,84,84
493,2011-01-22,Spring,2011,Jan,14,0,Saturday,0,Clear,0.1,0.1364,0.33,0.1045,11,64,75,709,75,75
494,2011-01-22,Spring,2011,Jan,15,0,Saturday,0,Clear,0.12,0.1515,0.28,0.0,10,93,103,709,103,103
495,2011-01-22,Spring,2011,Jan,16,0,Saturday,0,Clear,0.12,0.1364,0.28,0.194,11,72,83,709,83,83
496,2011-01-22,Spring,2011,Jan,17,0,Saturday,0,Clear,0.12,0.197,0.28,0.0,8,59,67,709,67,67
497,2011-01-22,Spring,2011,Jan,18,0,Saturday,0,Clear,0.08,0.0909,0.35,0.194,0,54,54,709,54,54
498,2011-01-22,Spring,2011,Jan,19,0,Saturday,0,Clear,0.08,0.1061,0.35,0.1343,6,53,59,709,59,59
499,2011-01-22,Spring,2011,Jan,20,0,Saturday,0,Clear,0.06,0.0758,0.45,0.1642,1,44,45,709,45,45
500,2011-01-22,Spring,2011,Jan,21,0,Saturday,0,Clear,0.06,0.1061,0.41,0.0896,0,39,39,709,39,39
501,2011-01-22,Spring,2011,Jan,22,0,Saturday,0,Clear,0.06,0.1515,0.49,0.0,7,23,30,709,30,30
502,2011-01-22,Spring,2011,Jan,23,0,Saturday,0,Clear,0.04,0.0758,0.57,0.1045,2,31,33,709,33,33
503,2011-01-23,Spring,2011,Jan,0,0,Sunday,0,Clear,0.04,0.0758,0.57,0.1045,2,20,22,708,22,22
504,2011-01-23,Spring,2011,Jan,1,0,Sunday,0,Clear,0.04,0.0758,0.57,0.1045,1,12,13,708,13,13
505,2011-01-23,Spring,2011,Jan,2,0,Sunday,0,Clear,0.02,0.0606,0.62,0.1343,3,15,18,708,18,18
506,2011-01-23,Spring,2011,Jan,3,0,Sunday,0,Clear,0.02,0.0606,0.62,0.1343,1,4,5,708,5,5
507,2011-01-23,Spring,2011,Jan,5,0,Sunday,0,Misty,0.04,0.0758,0.57,0.1045,0,3,3,708,3,3
508,2011-01-23,Spring,2011,Jan,6,0,Sunday,0,Misty,0.04,0.0758,0.57,0.1045,0,1,1,708,1,1
509,2011-01-23,Spring,2011,Jan,7,0,Sunday,0,Clear,0.08,0.1061,0.58,0.1642,1,1,2,708,2,2
510,2011-01-23,Spring,2011,Jan,8,0,Sunday,0,Clear,0.06,0.0758,0.62,0.1642,2,17,19,708,19,19
511,2011-01-23,Spring,2011,Jan,9,0,Sunday,0,Clear,0.1,0.0758,0.54,0.3582,3,25,28,708,28,28
512,2011-01-23,Spring,2011,Jan,10,0,Sunday,0,Clear,0.14,0.1061,0.46,0.3881,7,51,58,708,58,58
513,2011-01-23,Spring,2011,Jan,11,0,Sunday,0,Clear,0.14,0.1364,0.43,0.2239,22,77,99,708,99,99
514,2011-01-23,Spring,2011,Jan,12,0,Sunday,0,Clear,0.16,0.1212,0.37,0.4627,24,92,116,708,116,116
515,2011-01-23,Spring,2011,Jan,13,0,Sunday,0,Clear,0.14,0.1061,0.33,0.3881,12,75,87,708,87,87
516,2011-01-23,Spring,2011,Jan,14,0,Sunday,0,Clear,0.16,0.1364,0.28,0.3582,17,93,110,708,110,110
517,2011-01-23,Spring,2011,Jan,15,0,Sunday,0,Clear,0.16,0.1364,0.28,0.3582,13,64,77,708,77,77
518,2011-01-23,Spring,2011,Jan,16,0,Sunday,0,Clear,0.16,0.1364,0.26,0.3284,9,56,65,708,65,65
519,2011-01-23,Spring,2011,Jan,17,0,Sunday,0,Clear,0.14,0.1061,0.26,0.3881,5,50,55,708,55,55
520,2011-01-23,Spring,2011,Jan,18,0,Sunday,0,Clear,0.12,0.1212,0.3,0.2537,5,44,49,708,49,49
521,2011-01-23,Spring,2011,Jan,19,0,Sunday,0,Clear,0.12,0.1212,0.3,0.2836,5,45,50,708,50,50
522,2011-01-23,Spring,2011,Jan,20,0,Sunday,0,Clear,0.1,0.1061,0.36,0.2537,4,31,35,708,35,35
523,2011-01-23,Spring,2011,Jan,21,0,Sunday,0,Clear,0.1,0.1061,0.36,0.194,5,20,25,708,25,25
524,2011-01-23,Spring,2011,Jan,22,0,Sunday,0,Clear,0.08,0.0909,0.38,0.194,5,23,28,708,28,28
525,2011-01-23,Spring,2011,Jan,23,0,Sunday,0,Clear,0.06,0.0606,0.41,0.2239,4,17,21,708,21,21
526,2011-01-24,Spring,2011,Jan,0,0,Monday,1,Clear,0.06,0.0606,0.41,0.194,0,7,7,707,7,7
527,2011-01-24,Spring,2011,Jan,1,0,Monday,1,Clear,0.04,0.0455,0.45,0.194,0,1,1,707,1,1
528,2011-01-24,Spring,2011,Jan,3,0,Monday,1,Clear,0.04,0.0303,0.45,0.2537,0,1,1,707,1,1
529,2011-01-24,Spring,2011,Jan,4,0,Monday,1,Clear,0.02,0.0606,0.48,0.1343,0,1,1,707,1,1
530,2011-01-24,Spring,2011,Jan,5,0,Monday,1,Clear,0.02,0.0606,0.48,0.1343,0,5,5,707,5,5
531,2011-01-24,Spring,2011,Jan,6,0,Monday,1,Clear,0.02,0.0758,0.48,0.0896,0,15,15,707,15,15
532,2011-01-24,Spring,2011,Jan,7,0,Monday,1,Clear,0.02,0.1212,0.48,0.0,5,79,84,707,84,84
533,2011-01-24,Spring,2011,Jan,8,0,Monday,1,Clear,0.04,0.1364,0.49,0.0,6,171,177,707,177,177
534,2011-01-24,Spring,2011,Jan,9,0,Monday,1,Clear,0.06,0.1515,0.41,0.0,4,98,102,707,102,102
535,2011-01-24,Spring,2011,Jan,10,0,Monday,1,Clear,0.1,0.1364,0.42,0.0,6,34,40,707,40,40
536,2011-01-24,Spring,2011,Jan,11,0,Monday,1,Clear,0.1,0.1212,0.46,0.1343,3,43,46,707,46,46
537,2011-01-24,Spring,2011,Jan,12,0,Monday,1,Misty,0.12,0.1364,0.42,0.194,11,52,63,707,63,63
538,2011-01-24,Spring,2011,Jan,13,0,Monday,1,Misty,0.14,0.1364,0.43,0.2239,6,54,60,707,60,60
539,2011-01-24,Spring,2011,Jan,14,0,Monday,1,Misty,0.14,0.1364,0.46,0.2239,2,43,45,707,45,45
540,2011-01-24,Spring,2011,Jan,15,0,Monday,1,Clear,0.16,0.1667,0.4,0.1642,7,50,57,707,57,57
541,2011-01-24,Spring,2011,Jan,16,0,Monday,1,Clear,0.16,0.1515,0.47,0.2537,4,66,70,707,70,70
542,2011-01-24,Spring,2011,Jan,17,0,Monday,1,Clear,0.14,0.1212,0.5,0.2537,6,178,184,707,184,184
543,2011-01-24,Spring,2011,Jan,18,0,Monday,1,Clear,0.14,0.1364,0.59,0.194,8,145,153,707,153,153
544,2011-01-24,Spring,2011,Jan,19,0,Monday,1,Clear,0.14,0.1515,0.54,0.1642,5,101,106,707,106,106
545,2011-01-24,Spring,2011,Jan,20,0,Monday,1,Clear,0.14,0.1364,0.59,0.194,1,80,81,707,81,81
546,2011-01-24,Spring,2011,Jan,21,0,Monday,1,Clear,0.14,0.1515,0.63,0.1642,6,53,59,707,59,59
547,2011-01-24,Spring,2011,Jan,22,0,Monday,1,Misty,0.14,0.1364,0.63,0.2239,3,32,35,707,35,35
548,2011-01-24,Spring,2011,Jan,23,0,Monday,1,Misty,0.16,0.1515,0.64,0.2537,3,21,24,707,24,24
549,2011-01-25,Spring,2011,Jan,0,0,Tuesday,1,Misty,0.16,0.1364,0.69,0.2836,3,6,9,706,9,9
550,2011-01-25,Spring,2011,Jan,1,0,Tuesday,1,Misty,0.16,0.1667,0.69,0.1642,0,5,5,706,5,5
551,2011-01-25,Spring,2011,Jan,2,0,Tuesday,1,Clear,0.16,0.1515,0.69,0.2239,0,2,2,706,2,2
552,2011-01-25,Spring,2011,Jan,4,0,Tuesday,1,Clear,0.14,0.1667,0.74,0.1045,0,1,1,706,1,1
553,2011-01-25,Spring,2011,Jan,5,0,Tuesday,1,Clear,0.14,0.1364,0.74,0.2239,0,9,9,706,9,9
554,2011-01-25,Spring,2011,Jan,6,0,Tuesday,1,Clear,0.16,0.1818,0.74,0.1045,1,35,36,706,36,36
555,2011-01-25,Spring,2011,Jan,7,0,Tuesday,1,Clear,0.16,0.1515,0.74,0.2239,5,103,108,706,108,108
556,2011-01-25,Spring,2011,Jan,8,0,Tuesday,1,Misty,0.16,0.1818,0.74,0.1343,5,233,238,706,238,238
557,2011-01-25,Spring,2011,Jan,9,0,Tuesday,1,Misty,0.2,0.2273,0.64,0.0896,10,134,144,706,144,144
558,2011-01-25,Spring,2011,Jan,10,0,Tuesday,1,Misty,0.22,0.2424,0.6,0.1045,6,49,55,706,55,55
559,2011-01-25,Spring,2011,Jan,11,0,Tuesday,1,Misty,0.24,0.2424,0.6,0.1343,6,55,61,706,61,61
560,2011-01-25,Spring,2011,Jan,12,0,Tuesday,1,Misty,0.26,0.2879,0.56,0.0896,21,85,106,706,106,106
561,2011-01-25,Spring,2011,Jan,13,0,Tuesday,1,Misty,0.26,0.2727,0.56,0.1343,21,72,93,706,93,93
562,2011-01-25,Spring,2011,Jan,14,0,Tuesday,1,Misty,0.3,0.3333,0.45,0.0,11,57,68,706,68,68
563,2011-01-25,Spring,2011,Jan,15,0,Tuesday,1,Misty,0.32,0.3485,0.42,0.0,21,63,84,706,84,84
564,2011-01-25,Spring,2011,Jan,16,0,Tuesday,1,Misty,0.32,0.3485,0.42,0.0,14,102,116,706,116,116
565,2011-01-25,Spring,2011,Jan,17,0,Tuesday,1,Clear,0.3,0.3333,0.45,0.0,14,208,222,706,222,222
566,2011-01-25,Spring,2011,Jan,18,0,Tuesday,1,Misty,0.3,0.3182,0.49,0.0896,7,218,225,706,225,225
567,2011-01-25,Spring,2011,Jan,19,0,Tuesday,1,Misty,0.26,0.2576,0.65,0.1642,13,133,146,706,146,146
568,2011-01-25,Spring,2011,Jan,20,0,Tuesday,1,Clear,0.24,0.2273,0.65,0.194,16,103,119,706,119,119
569,2011-01-25,Spring,2011,Jan,21,0,Tuesday,1,Clear,0.24,0.2273,0.65,0.194,5,40,45,706,45,45
570,2011-01-25,Spring,2011,Jan,22,0,Tuesday,1,Clear,0.22,0.2273,0.64,0.1642,4,49,53,706,53,53
571,2011-01-25,Spring,2011,Jan,23,0,Tuesday,1,Misty,0.22,0.2273,0.64,0.1642,3,37,40,706,40,40
572,2011-01-26,Spring,2011,Jan,0,0,Wednesday,1,Misty,0.22,0.2273,0.69,0.1343,3,14,17,705,17,17
573,2011-01-26,Spring,2011,Jan,1,0,Wednesday,1,Misty,0.24,0.2424,0.65,0.1343,0,5,5,705,5,5
574,2011-01-26,Spring,2011,Jan,2,0,Wednesday,1,Light_rainsnow,0.22,0.2273,0.69,0.194,3,7,10,705,10,10
575,2011-01-26,Spring,2011,Jan,5,0,Wednesday,1,Light_rainsnow,0.2,0.1818,0.86,0.2836,0,1,1,705,1,1
576,2011-01-26,Spring,2011,Jan,6,0,Wednesday,1,Light_rainsnow,0.2,0.1818,0.86,0.2836,0,8,8,705,8,8
577,2011-01-26,Spring,2011,Jan,7,0,Wednesday,1,Light_rainsnow,0.22,0.2121,0.87,0.2985,1,29,30,705,30,30
578,2011-01-26,Spring,2011,Jan,8,0,Wednesday,1,Light_rainsnow,0.22,0.2121,0.87,0.2985,3,69,72,705,72,72
579,2011-01-26,Spring,2011,Jan,9,0,Wednesday,1,Light_rainsnow,0.22,0.2121,0.87,0.2985,3,55,58,705,58,58
580,2011-01-26,Spring,2011,Jan,10,0,Wednesday,1,Light_rainsnow,0.22,0.2121,0.93,0.2836,2,26,28,705,28,28
581,2011-01-26,Spring,2011,Jan,11,0,Wednesday,1,Light_rainsnow,0.22,0.197,0.93,0.3284,6,35,41,705,41,41
582,2011-01-26,Spring,2011,Jan,12,0,Wednesday,1,Light_rainsnow,0.22,0.197,0.93,0.3284,7,41,48,705,48,48
583,2011-01-26,Spring,2011,Jan,13,0,Wednesday,1,Light_rainsnow,0.22,0.197,0.93,0.3284,4,43,47,705,47,47
584,2011-01-26,Spring,2011,Jan,14,0,Wednesday,1,Light_rainsnow,0.22,0.197,0.93,0.3582,0,36,36,705,36,36
585,2011-01-26,Spring,2011,Jan,15,0,Wednesday,1,Light_rainsnow,0.22,0.1818,0.93,0.4627,1,42,43,705,43,43
586,2011-01-26,Spring,2011,Jan,16,0,Wednesday,1,Heavy_rainsnow,0.22,0.197,0.93,0.3284,1,35,36,705,36,36
587,2011-01-26,Spring,2011,Jan,17,0,Wednesday,1,Light_rainsnow,0.2,0.1818,0.93,0.3582,0,26,26,705,26,26
588,2011-01-27,Spring,2011,Jan,16,0,Thursday,1,Clear,0.22,0.2273,0.55,0.194,1,23,24,704,24,24
589,2011-01-27,Spring,2011,Jan,17,0,Thursday,1,Clear,0.22,0.2424,0.55,0.1045,2,82,84,704,84,84
590,2011-01-27,Spring,2011,Jan,18,0,Thursday,1,Clear,0.2,0.2273,0.69,0.0896,3,101,104,704,104,104
591,2011-01-27,Spring,2011,Jan,19,0,Thursday,1,Clear,0.2,0.2273,0.69,0.0896,3,76,79,704,79,79
592,2011-01-27,Spring,2011,Jan,20,0,Thursday,1,Clear,0.18,0.2121,0.74,0.0896,4,55,59,704,59,59
593,2011-01-27,Spring,2011,Jan,21,0,Thursday,1,Clear,0.18,0.2121,0.74,0.0896,2,36,38,704,38,38
594,2011-01-27,Spring,2011,Jan,22,0,Thursday,1,Clear,0.18,0.2121,0.74,0.0896,0,27,27,704,27,27
595,2011-01-27,Spring,2011,Jan,23,0,Thursday,1,Clear,0.18,0.197,0.8,0.1642,0,16,16,704,16,16
596,2011-01-28,Spring,2011,Jan,0,0,Friday,1,Misty,0.2,0.2121,0.75,0.1343,0,9,9,703,9,9
597,2011-01-28,Spring,2011,Jan,1,0,Friday,1,Misty,0.2,0.2121,0.75,0.1343,1,2,3,703,3,3
598,2011-01-28,Spring,2011,Jan,2,0,Friday,1,Misty,0.2,0.2121,0.75,0.1642,0,2,2,703,2,2
599,2011-01-28,Spring,2011,Jan,3,0,Friday,1,Misty,0.2,0.2273,0.75,0.1045,1,0,1,703,1,1
600,2011-01-28,Spring,2011,Jan,5,0,Friday,1,Misty,0.18,0.2121,0.8,0.1045,0,4,4,703,4,4
601,2011-01-28,Spring,2011,Jan,6,0,Friday,1,Misty,0.18,0.197,0.8,0.1343,0,16,16,703,16,16
602,2011-01-28,Spring,2011,Jan,7,0,Friday,1,Misty,0.16,0.197,0.86,0.0896,2,58,60,703,60,60
603,2011-01-28,Spring,2011,Jan,8,0,Friday,1,Misty,0.16,0.197,0.86,0.0896,2,155,157,703,157,157
604,2011-01-28,Spring,2011,Jan,9,0,Friday,1,Light_rainsnow,0.18,0.2121,0.86,0.0896,6,95,101,703,101,101
605,2011-01-28,Spring,2011,Jan,10,0,Friday,1,Light_rainsnow,0.18,0.2121,0.86,0.1045,0,49,49,703,49,49
606,2011-01-28,Spring,2011,Jan,11,0,Friday,1,Light_rainsnow,0.18,0.2121,0.93,0.1045,0,30,30,703,30,30
607,2011-01-28,Spring,2011,Jan,12,0,Friday,1,Light_rainsnow,0.18,0.2121,0.93,0.1045,1,28,29,703,29,29
608,2011-01-28,Spring,2011,Jan,13,0,Friday,1,Light_rainsnow,0.18,0.2121,0.93,0.1045,0,31,31,703,31,31
609,2011-01-28,Spring,2011,Jan,14,0,Friday,1,Light_rainsnow,0.22,0.2727,0.8,0.0,2,36,38,703,38,38
610,2011-01-28,Spring,2011,Jan,15,0,Friday,1,Misty,0.2,0.2576,0.86,0.0,1,40,41,703,41,41
611,2011-01-28,Spring,2011,Jan,16,0,Friday,1,Clear,0.22,0.2727,0.8,0.0,10,70,80,703,80,80
612,2011-01-28,Spring,2011,Jan,17,0,Friday,1,Clear,0.24,0.2424,0.75,0.1343,2,147,149,703,149,149
613,2011-01-28,Spring,2011,Jan,18,0,Friday,1,Clear,0.24,0.2273,0.75,0.194,2,107,109,703,109,109
614,2011-01-28,Spring,2011,Jan,19,0,Friday,1,Misty,0.24,0.2424,0.75,0.1343,5,84,89,703,89,89
615,2011-01-28,Spring,2011,Jan,20,0,Friday,1,Misty,0.24,0.2273,0.7,0.194,1,61,62,703,62,62
616,2011-01-28,Spring,2011,Jan,21,0,Friday,1,Misty,0.22,0.2273,0.75,0.1343,1,57,58,703,58,58
617,2011-01-28,Spring,2011,Jan,22,0,Friday,1,Clear,0.24,0.2121,0.65,0.3582,0,26,26,703,26,26
618,2011-01-28,Spring,2011,Jan,23,0,Friday,1,Clear,0.24,0.2273,0.6,0.2239,1,22,23,703,23,23
619,2011-01-29,Spring,2011,Jan,0,0,Saturday,0,Clear,0.22,0.197,0.64,0.3582,2,26,28,702,28,28
620,2011-01-29,Spring,2011,Jan,1,0,Saturday,0,Clear,0.22,0.2273,0.64,0.194,0,20,20,702,20,20
621,2011-01-29,Spring,2011,Jan,2,0,Saturday,0,Clear,0.22,0.2273,0.64,0.1642,0,15,15,702,15,15
622,2011-01-29,Spring,2011,Jan,3,0,Saturday,0,Clear,0.2,0.2121,0.64,0.1343,3,5,8,702,8,8
623,2011-01-29,Spring,2011,Jan,4,0,Saturday,0,Clear,0.16,0.1818,0.69,0.1045,1,2,3,702,3,3
624,2011-01-29,Spring,2011,Jan,6,0,Saturday,0,Clear,0.16,0.1818,0.64,0.1343,0,2,2,702,2,2
625,2011-01-29,Spring,2011,Jan,7,0,Saturday,0,Clear,0.16,0.1818,0.59,0.1045,1,4,5,702,5,5
626,2011-01-29,Spring,2011,Jan,8,0,Saturday,0,Clear,0.18,0.197,0.55,0.1642,3,31,34,702,34,34
627,2011-01-29,Spring,2011,Jan,9,0,Saturday,0,Clear,0.18,0.2121,0.59,0.0896,0,34,34,702,34,34
628,2011-01-29,Spring,2011,Jan,10,0,Saturday,0,Misty,0.18,0.2121,0.64,0.1045,4,51,55,702,55,55
629,2011-01-29,Spring,2011,Jan,11,0,Saturday,0,Misty,0.18,0.197,0.64,0.1343,4,60,64,702,64,64
630,2011-01-29,Spring,2011,Jan,12,0,Saturday,0,Misty,0.2,0.197,0.59,0.194,12,66,78,702,78,78
631,2011-01-29,Spring,2011,Jan,13,0,Saturday,0,Misty,0.22,0.2273,0.55,0.1642,9,56,65,702,65,65
632,2011-01-29,Spring,2011,Jan,14,0,Saturday,0,Misty,0.22,0.2273,0.6,0.1343,10,89,99,702,99,99
633,2011-01-29,Spring,2011,Jan,15,0,Saturday,0,Clear,0.22,0.2121,0.69,0.2537,22,98,120,702,120,120
634,2011-01-29,Spring,2011,Jan,16,0,Saturday,0,Clear,0.24,0.2424,0.6,0.1642,19,88,107,702,107,107
635,2011-01-29,Spring,2011,Jan,17,0,Saturday,0,Clear,0.24,0.2879,0.6,0.0,9,82,91,702,91,91
636,2011-01-29,Spring,2011,Jan,18,0,Saturday,0,Clear,0.22,0.2273,0.69,0.1343,9,59,68,702,68,68
637,2011-01-29,Spring,2011,Jan,19,0,Saturday,0,Misty,0.22,0.2121,0.69,0.2537,6,52,58,702,58,58
638,2011-01-29,Spring,2011,Jan,20,0,Saturday,0,Clear,0.18,0.2121,0.74,0.0896,1,42,43,702,43,43
639,2011-01-29,Spring,2011,Jan,21,0,Saturday,0,Clear,0.18,0.2121,0.74,0.0896,1,35,36,702,36,36
640,2011-01-29,Spring,2011,Jan,22,0,Saturday,0,Clear,0.16,0.197,0.8,0.0896,4,28,32,702,32,32
641,2011-01-29,Spring,2011,Jan,23,0,Saturday,0,Clear,0.16,0.197,0.8,0.0896,3,30,33,702,33,33
642,2011-01-30,Spring,2011,Jan,0,0,Sunday,0,Clear,0.16,0.1818,0.8,0.1045,0,33,33,701,33,33
643,2011-01-30,Spring,2011,Jan,1,0,Sunday,0,Clear,0.14,0.2121,0.8,0.0,7,22,29,701,29,29
644,2011-01-30,Spring,2011,Jan,2,0,Sunday,0,Clear,0.16,0.2273,0.8,0.0,1,10,11,701,11,11
645,2011-01-30,Spring,2011,Jan,3,0,Sunday,0,Clear,0.14,0.2121,0.93,0.0,1,7,8,701,8,8
646,2011-01-30,Spring,2011,Jan,4,0,Sunday,0,Clear,0.14,0.2121,0.93,0.0,0,1,1,701,1,1
647,2011-01-30,Spring,2011,Jan,5,0,Sunday,0,Clear,0.14,0.2121,0.86,0.0,0,3,3,701,3,3
648,2011-01-30,Spring,2011,Jan,7,0,Sunday,0,Clear,0.14,0.2121,0.86,0.0,0,3,3,701,3,3
649,2011-01-30,Spring,2011,Jan,8,0,Sunday,0,Misty,0.14,0.2121,0.86,0.0,1,11,12,701,12,12
650,2011-01-30,Spring,2011,Jan,9,0,Sunday,0,Misty,0.16,0.2273,0.8,0.0,4,34,38,701,38,38
651,2011-01-30,Spring,2011,Jan,10,0,Sunday,0,Misty,0.18,0.2424,0.8,0.0,7,57,64,701,64,64
652,2011-01-30,Spring,2011,Jan,11,0,Sunday,0,Clear,0.22,0.2727,0.75,0.0,9,50,59,701,59,59
653,2011-01-30,Spring,2011,Jan,12,0,Sunday,0,Clear,0.3,0.3182,0.52,0.1045,10,87,97,701,97,97
654,2011-01-30,Spring,2011,Jan,13,0,Sunday,0,Clear,0.28,0.2879,0.61,0.1045,13,71,84,701,84,84
655,2011-01-30,Spring,2011,Jan,14,0,Sunday,0,Clear,0.28,0.303,0.61,0.0896,18,104,122,701,122,122
656,2011-01-30,Spring,2011,Jan,15,0,Sunday,0,Clear,0.3,0.3333,0.56,0.0,14,95,109,701,109,109
657,2011-01-30,Spring,2011,Jan,16,0,Sunday,0,Clear,0.3,0.3333,0.56,0.0,19,104,123,701,123,123
658,2011-01-30,Spring,2011,Jan,17,0,Sunday,0,Clear,0.3,0.2879,0.56,0.194,6,71,77,701,77,77
659,2011-01-30,Spring,2011,Jan,18,0,Sunday,0,Clear,0.26,0.2576,0.65,0.1642,8,57,65,701,65,65
660,2011-01-30,Spring,2011,Jan,19,0,Sunday,0,Clear,0.26,0.2576,0.65,0.194,9,46,55,701,55,55
661,2011-01-30,Spring,2011,Jan,20,0,Sunday,0,Misty,0.26,0.2727,0.65,0.1045,3,30,33,701,33,33
662,2011-01-30,Spring,2011,Jan,21,0,Sunday,0,Misty,0.24,0.2424,0.7,0.1642,3,25,28,701,28,28
663,2011-01-30,Spring,2011,Jan,22,0,Sunday,0,Misty,0.24,0.2273,0.7,0.194,2,19,21,701,21,21
664,2011-01-30,Spring,2011,Jan,23,0,Sunday,0,Misty,0.24,0.2121,0.65,0.2836,5,16,21,701,21,21
665,2011-01-31,Spring,2011,Jan,0,0,Monday,1,Misty,0.24,0.2273,0.65,0.2239,1,6,7,700,7,7
666,2011-01-31,Spring,2011,Jan,1,0,Monday,1,Clear,0.22,0.2121,0.64,0.2537,2,5,7,700,7,7
667,2011-01-31,Spring,2011,Jan,2,0,Monday,1,Clear,0.22,0.2273,0.64,0.194,0,1,1,700,1,1
668,2011-01-31,Spring,2011,Jan,3,0,Monday,1,Clear,0.22,0.2273,0.64,0.194,0,2,2,700,2,2
669,2011-01-31,Spring,2011,Jan,4,0,Monday,1,Clear,0.2,0.197,0.59,0.2239,0,2,2,700,2,2
670,2011-01-31,Spring,2011,Jan,5,0,Monday,1,Clear,0.18,0.1667,0.64,0.2836,0,8,8,700,8,8
671,2011-01-31,Spring,2011,Jan,6,0,Monday,1,Clear,0.16,0.1364,0.69,0.3284,0,37,37,700,37,37
672,2011-01-31,Spring,2011,Jan,7,0,Monday,1,Misty,0.16,0.1364,0.64,0.2836,1,71,72,700,72,72
673,2011-01-31,Spring,2011,Jan,8,0,Monday,1,Misty,0.16,0.1364,0.59,0.2836,3,182,185,700,185,185
674,2011-01-31,Spring,2011,Jan,9,0,Monday,1,Misty,0.16,0.1364,0.59,0.2985,0,112,112,700,112,112
675,2011-01-31,Spring,2011,Jan,10,0,Monday,1,Misty,0.16,0.1515,0.59,0.194,1,68,69,700,69,69
676,2011-01-31,Spring,2011,Jan,11,0,Monday,1,Misty,0.16,0.1515,0.59,0.194,2,46,48,700,48,48
677,2011-01-31,Spring,2011,Jan,12,0,Monday,1,Misty,0.18,0.2121,0.55,0.1045,6,62,68,700,68,68
678,2011-01-31,Spring,2011,Jan,13,0,Monday,1,Misty,0.16,0.2273,0.59,0.0,2,52,54,700,54,54
679,2011-01-31,Spring,2011,Jan,14,0,Monday,1,Misty,0.18,0.197,0.55,0.1343,1,85,86,700,86,86
680,2011-01-31,Spring,2011,Jan,15,0,Monday,1,Misty,0.16,0.1818,0.59,0.1343,3,41,44,700,44,44
681,2011-01-31,Spring,2011,Jan,16,0,Monday,1,Misty,0.16,0.1818,0.56,0.194,3,83,86,700,86,86
682,2011-01-31,Spring,2011,Jan,17,0,Monday,1,Misty,0.16,0.1515,0.59,0.194,6,155,161,700,161,161
683,2011-01-31,Spring,2011,Jan,18,0,Monday,1,Misty,0.16,0.1515,0.55,0.2239,3,153,156,700,156,156
684,2011-01-31,Spring,2011,Jan,19,0,Monday,1,Clear,0.3,0.3182,0.61,0.1045,3,108,111,700,111,111
685,2011-01-31,Spring,2011,Jan,20,0,Monday,1,Light_rainsnow,0.16,0.1667,0.59,0.1642,0,78,78,700,78,78
686,2011-01-31,Spring,2011,Jan,21,0,Monday,1,Light_rainsnow,0.16,0.197,0.59,0.0896,3,53,56,700,56,56
687,2011-01-31,Spring,2011,Jan,22,0,Monday,1,Misty,0.16,0.1818,0.59,0.1045,0,34,34,700,34,34
688,2011-01-31,Spring,2011,Jan,23,0,Monday,1,Misty,0.16,0.197,0.64,0.0896,2,15,17,700,17,17
689,2011-02-01,Spring,2011,Feb,0,0,Tuesday,1,Misty,0.16,0.1818,0.64,0.1045,2,6,8,699,8,8
690,2011-02-01,Spring,2011,Feb,1,0,Tuesday,1,Misty,0.16,0.1818,0.69,0.1045,0,3,3,699,3,3
691,2011-02-01,Spring,2011,Feb,2,0,Tuesday,1,Misty,0.16,0.2273,0.69,0.0,0,2,2,699,2,2
692,2011-02-01,Spring,2011,Feb,3,0,Tuesday,1,Misty,0.16,0.2273,0.69,0.0,0,2,2,699,2,2
693,2011-02-01,Spring,2011,Feb,5,0,Tuesday,1,Light_rainsnow,0.14,0.2121,0.93,0.0,0,3,3,699,3,3
694,2011-02-01,Spring,2011,Feb,6,0,Tuesday,1,Light_rainsnow,0.14,0.2121,0.93,0.0,0,22,22,699,22,22
695,2011-02-01,Spring,2011,Feb,7,0,Tuesday,1,Light_rainsnow,0.16,0.2273,0.93,0.0,0,52,52,699,52,52
696,2011-02-01,Spring,2011,Feb,8,0,Tuesday,1,Light_rainsnow,0.16,0.2273,0.93,0.0,3,132,135,699,135,135
697,2011-02-01,Spring,2011,Feb,9,0,Tuesday,1,Misty,0.16,0.2273,0.93,0.0,2,114,116,699,116,116
698,2011-02-01,Spring,2011,Feb,10,0,Tuesday,1,Misty,0.16,0.2273,0.93,0.0,0,47,47,699,47,47
699,2011-02-01,Spring,2011,Feb,11,0,Tuesday,1,Misty,0.18,0.2424,0.86,0.0,2,49,51,699,51,51
700,2011-02-01,Spring,2011,Feb,12,0,Tuesday,1,Misty,0.2,0.2576,0.86,0.0,2,53,55,699,55,55
701,2011-02-01,Spring,2011,Feb,13,0,Tuesday,1,Misty,0.2,0.2576,0.86,0.0,3,49,52,699,52,52
702,2011-02-01,Spring,2011,Feb,14,0,Tuesday,1,Misty,0.22,0.2576,0.8,0.0896,5,49,54,699,54,54
703,2011-02-01,Spring,2011,Feb,15,0,Tuesday,1,Misty,0.24,0.2879,0.75,0.0,7,45,52,699,52,52
704,2011-02-01,Spring,2011,Feb,16,0,Tuesday,1,Misty,0.24,0.2424,0.75,0.1343,3,61,64,699,64,64
705,2011-02-01,Spring,2011,Feb,17,0,Tuesday,1,Misty,0.24,0.2879,0.75,0.0,4,172,176,699,176,176
706,2011-02-01,Spring,2011,Feb,18,0,Tuesday,1,Misty,0.24,0.2576,0.81,0.1045,3,165,168,699,168,168
707,2011-02-01,Spring,2011,Feb,19,0,Tuesday,1,Misty,0.24,0.2424,0.81,0.1343,3,105,108,699,108,108
708,2011-02-01,Spring,2011,Feb,20,0,Tuesday,1,Misty,0.22,0.2273,0.87,0.1343,5,69,74,699,74,74
709,2011-02-01,Spring,2011,Feb,21,0,Tuesday,1,Misty,0.22,0.2273,0.87,0.1343,0,64,64,699,64,64
710,2011-02-01,Spring,2011,Feb,22,0,Tuesday,1,Misty,0.22,0.2576,0.87,0.0896,2,34,36,699,36,36
711,2011-02-01,Spring,2011,Feb,23,0,Tuesday,1,Light_rainsnow,0.2,0.197,0.93,0.194,1,15,16,699,16,16
712,2011-02-02,Spring,2011,Feb,0,0,Wednesday,1,Light_rainsnow,0.22,0.2424,0.93,0.1045,0,2,2,698,2,2
713,2011-02-02,Spring,2011,Feb,1,0,Wednesday,1,Light_rainsnow,0.22,0.2273,0.93,0.194,0,3,3,698,3,3
714,2011-02-02,Spring,2011,Feb,2,0,Wednesday,1,Light_rainsnow,0.22,0.2273,0.93,0.1343,4,0,4,698,4,4
715,2011-02-02,Spring,2011,Feb,3,0,Wednesday,1,Light_rainsnow,0.22,0.2273,0.93,0.1343,0,1,1,698,1,1
716,2011-02-02,Spring,2011,Feb,4,0,Wednesday,1,Light_rainsnow,0.22,0.2121,0.93,0.2836,0,1,1,698,1,1
717,2011-02-02,Spring,2011,Feb,5,0,Wednesday,1,Light_rainsnow,0.22,0.2424,0.93,0.1045,0,3,3,698,3,3
718,2011-02-02,Spring,2011,Feb,6,0,Wednesday,1,Light_rainsnow,0.22,0.2424,0.93,0.1045,1,17,18,698,18,18
719,2011-02-02,Spring,2011,Feb,7,0,Wednesday,1,Light_rainsnow,0.22,0.2121,0.93,0.2239,1,48,49,698,49,49
720,2011-02-02,Spring,2011,Feb,8,0,Wednesday,1,Light_rainsnow,0.22,0.2121,0.93,0.2239,1,154,155,698,155,155
721,2011-02-02,Spring,2011,Feb,9,0,Wednesday,1,Misty,0.24,0.2576,0.93,0.0896,4,119,123,698,123,123
722,2011-02-02,Spring,2011,Feb,10,0,Wednesday,1,Misty,0.22,0.2727,1.0,0.0,2,59,61,698,61,61
723,2011-02-02,Spring,2011,Feb,11,0,Wednesday,1,Misty,0.24,0.2273,0.93,0.194,5,47,52,698,52,52
724,2011-02-02,Spring,2011,Feb,12,0,Wednesday,1,Misty,0.24,0.2273,0.93,0.2239,3,61,64,698,64,64
725,2011-02-02,Spring,2011,Feb,13,0,Wednesday,1,Clear,0.34,0.3333,0.93,0.1642,1,74,75,698,75,75
726,2011-02-02,Spring,2011,Feb,14,0,Wednesday,1,Clear,0.38,0.3939,0.82,0.3881,2,61,63,698,63,63
727,2011-02-02,Spring,2011,Feb,15,0,Wednesday,1,Clear,0.38,0.3939,0.76,0.3284,10,66,76,698,76,76
728,2011-02-02,Spring,2011,Feb,16,0,Wednesday,1,Clear,0.36,0.3333,0.71,0.2985,8,95,103,698,103,103
729,2011-02-02,Spring,2011,Feb,17,0,Wednesday,1,Clear,0.36,0.3182,0.53,0.5224,7,183,190,698,190,190
730,2011-02-02,Spring,2011,Feb,18,0,Wednesday,1,Clear,0.34,0.2879,0.42,0.5522,7,175,182,698,182,182
731,2011-02-02,Spring,2011,Feb,19,0,Wednesday,1,Clear,0.28,0.2424,0.45,0.4925,3,88,91,698,91,91
732,2011-02-02,Spring,2011,Feb,20,0,Wednesday,1,Clear,0.24,0.197,0.48,0.5522,4,71,75,698,75,75
733,2011-02-02,Spring,2011,Feb,21,0,Wednesday,1,Clear,0.22,0.197,0.47,0.3284,1,62,63,698,63,63
734,2011-02-02,Spring,2011,Feb,22,0,Wednesday,1,Clear,0.22,0.2121,0.44,0.2537,5,35,40,698,40,40
735,2011-02-02,Spring,2011,Feb,23,0,Wednesday,1,Clear,0.2,0.1667,0.44,0.4478,3,29,32,698,32,32
736,2011-02-03,Spring,2011,Feb,0,0,Thursday,1,Clear,0.2,0.1667,0.4,0.4478,1,11,12,697,12,12
737,2011-02-03,Spring,2011,Feb,1,0,Thursday,1,Clear,0.2,0.1515,0.44,0.5224,0,5,5,697,5,5
738,2011-02-03,Spring,2011,Feb,2,0,Thursday,1,Clear,0.18,0.1667,0.43,0.2537,0,2,2,697,2,2
739,2011-02-03,Spring,2011,Feb,3,0,Thursday,1,Clear,0.18,0.1667,0.43,0.2537,0,1,1,697,1,1
740,2011-02-03,Spring,2011,Feb,5,0,Thursday,1,Clear,0.16,0.1364,0.5,0.2985,0,2,2,697,2,2
741,2011-02-03,Spring,2011,Feb,6,0,Thursday,1,Clear,0.16,0.1364,0.43,0.3582,0,39,39,697,39,39
742,2011-02-03,Spring,2011,Feb,7,0,Thursday,1,Clear,0.14,0.1212,0.5,0.3284,1,86,87,697,87,87
743,2011-02-03,Spring,2011,Feb,8,0,Thursday,1,Clear,0.14,0.1212,0.5,0.3582,4,184,188,697,188,188
744,2011-02-03,Spring,2011,Feb,9,0,Thursday,1,Clear,0.16,0.1364,0.47,0.2985,6,127,133,697,133,133
745,2011-02-03,Spring,2011,Feb,10,0,Thursday,1,Clear,0.18,0.1515,0.43,0.3284,2,50,52,697,52,52
746,2011-02-03,Spring,2011,Feb,11,0,Thursday,1,Clear,0.18,0.1364,0.43,0.4478,9,55,64,697,64,64
747,2011-02-03,Spring,2011,Feb,12,0,Thursday,1,Clear,0.2,0.1818,0.4,0.3582,2,67,69,697,69,69
748,2011-02-03,Spring,2011,Feb,13,0,Thursday,1,Clear,0.2,0.1667,0.4,0.4179,4,47,51,697,51,51
749,2011-02-03,Spring,2011,Feb,14,0,Thursday,1,Clear,0.22,0.197,0.37,0.3881,4,43,47,697,47,47
750,2011-02-03,Spring,2011,Feb,15,0,Thursday,1,Clear,0.22,0.197,0.37,0.3284,4,56,60,697,60,60
751,2011-02-03,Spring,2011,Feb,16,0,Thursday,1,Clear,0.22,0.2121,0.37,0.2537,5,73,78,697,78,78
752,2011-02-03,Spring,2011,Feb,17,0,Thursday,1,Clear,0.2,0.197,0.4,0.194,5,170,175,697,175,175
753,2011-02-03,Spring,2011,Feb,18,0,Thursday,1,Clear,0.2,0.2121,0.4,0.1642,2,145,147,697,147,147
754,2011-02-03,Spring,2011,Feb,19,0,Thursday,1,Clear,0.2,0.2576,0.4,0.0,4,92,96,697,96,96
755,2011-02-03,Spring,2011,Feb,20,0,Thursday,1,Clear,0.2,0.2273,0.47,0.0896,1,108,109,697,109,109
756,2011-02-03,Spring,2011,Feb,21,0,Thursday,1,Clear,0.18,0.2121,0.55,0.1045,1,53,54,697,54,54
757,2011-02-03,Spring,2011,Feb,22,0,Thursday,1,Clear,0.18,0.2121,0.51,0.0896,2,39,41,697,41,41
758,2011-02-03,Spring,2011,Feb,23,0,Thursday,1,Clear,0.2,0.2273,0.47,0.1045,4,34,38,697,38,38
759,2011-02-04,Spring,2011,Feb,0,0,Friday,1,Misty,0.2,0.2576,0.44,0.0,3,10,13,696,13,13
760,2011-02-04,Spring,2011,Feb,1,0,Friday,1,Misty,0.16,0.2273,0.59,0.0,0,7,7,696,7,7
761,2011-02-04,Spring,2011,Feb,2,0,Friday,1,Misty,0.14,0.1667,0.63,0.1045,0,1,1,696,1,1
762,2011-02-04,Spring,2011,Feb,3,0,Friday,1,Misty,0.14,0.1667,0.63,0.1045,0,1,1,696,1,1
763,2011-02-04,Spring,2011,Feb,5,0,Friday,1,Misty,0.14,0.1515,0.63,0.1343,0,7,7,696,7,7
764,2011-02-04,Spring,2011,Feb,6,0,Friday,1,Misty,0.16,0.2273,0.55,0.0,2,26,28,696,28,28
765,2011-02-04,Spring,2011,Feb,7,0,Friday,1,Clear,0.14,0.2121,0.59,0.0,0,87,87,696,87,87
766,2011-02-04,Spring,2011,Feb,8,0,Friday,1,Clear,0.14,0.1515,0.74,0.1343,3,217,220,696,220,220
767,2011-02-04,Spring,2011,Feb,9,0,Friday,1,Misty,0.16,0.1818,0.8,0.1343,3,124,127,696,127,127
768,2011-02-04,Spring,2011,Feb,10,0,Friday,1,Misty,0.2,0.2121,0.51,0.1343,5,46,51,696,51,51
769,2011-02-04,Spring,2011,Feb,11,0,Friday,1,Clear,0.22,0.2273,0.51,0.1642,3,61,64,696,64,64
770,2011-02-04,Spring,2011,Feb,12,0,Friday,1,Misty,0.24,0.2424,0.48,0.1642,8,78,86,696,86,86
771,2011-02-04,Spring,2011,Feb,13,0,Friday,1,Misty,0.26,0.2576,0.5,0.2239,9,73,82,696,82,82
772,2011-02-04,Spring,2011,Feb,14,0,Friday,1,Misty,0.28,0.2727,0.45,0.1642,15,76,91,696,91,91
773,2011-02-04,Spring,2011,Feb,15,0,Friday,1,Misty,0.28,0.2727,0.48,0.2537,9,81,90,696,90,90
774,2011-02-04,Spring,2011,Feb,16,0,Friday,1,Misty,0.3,0.2879,0.42,0.2239,8,91,99,696,99,99
775,2011-02-04,Spring,2011,Feb,17,0,Friday,1,Misty,0.26,0.2727,0.56,0.1343,10,195,205,696,205,205
776,2011-02-04,Spring,2011,Feb,18,0,Friday,1,Misty,0.24,0.2576,0.6,0.1045,3,152,155,696,155,155
777,2011-02-04,Spring,2011,Feb,19,0,Friday,1,Misty,0.24,0.2424,0.65,0.1343,1,102,103,696,103,103
778,2011-02-04,Spring,2011,Feb,20,0,Friday,1,Misty,0.24,0.2424,0.65,0.1642,2,69,71,696,71,71
779,2011-02-04,Spring,2011,Feb,21,0,Friday,1,Misty,0.24,0.2424,0.7,0.1642,2,41,43,696,43,43
780,2011-02-04,Spring,2011,Feb,22,0,Friday,1,Misty,0.24,0.2424,0.65,0.1642,1,45,46,696,46,46
781,2011-02-04,Spring,2011,Feb,23,0,Friday,1,Misty,0.24,0.2424,0.7,0.1343,1,30,31,696,31,31
782,2011-02-05,Spring,2011,Feb,0,0,Saturday,0,Misty,0.24,0.2424,0.7,0.1642,3,36,39,695,39,39
783,2011-02-05,Spring,2011,Feb,1,0,Saturday,0,Misty,0.24,0.2424,0.65,0.1642,1,17,18,695,18,18
784,2011-02-05,Spring,2011,Feb,2,0,Saturday,0,Misty,0.24,0.2424,0.75,0.1642,5,12,17,695,17,17
785,2011-02-05,Spring,2011,Feb,3,0,Saturday,0,Misty,0.24,0.2424,0.75,0.1642,1,10,11,695,11,11
786,2011-02-05,Spring,2011,Feb,4,0,Saturday,0,Light_rainsnow,0.22,0.2273,0.93,0.1343,0,8,8,695,8,8
787,2011-02-05,Spring,2011,Feb,5,0,Saturday,0,Light_rainsnow,0.2,0.2273,1.0,0.0896,0,9,9,695,9,9
788,2011-02-05,Spring,2011,Feb,6,0,Saturday,0,Light_rainsnow,0.2,0.2576,1.0,0.0,0,4,4,695,4,4
789,2011-02-05,Spring,2011,Feb,7,0,Saturday,0,Light_rainsnow,0.22,0.2576,0.93,0.0896,0,4,4,695,4,4
790,2011-02-05,Spring,2011,Feb,8,0,Saturday,0,Light_rainsnow,0.2,0.2273,1.0,0.0896,0,10,10,695,10,10
791,2011-02-05,Spring,2011,Feb,9,0,Saturday,0,Light_rainsnow,0.2,0.2273,1.0,0.0896,3,17,20,695,20,20
792,2011-02-05,Spring,2011,Feb,10,0,Saturday,0,Light_rainsnow,0.2,0.2121,1.0,0.1343,3,31,34,695,34,34
793,2011-02-05,Spring,2011,Feb,11,0,Saturday,0,Light_rainsnow,0.22,0.2273,1.0,0.1343,1,46,47,695,47,47
794,2011-02-05,Spring,2011,Feb,12,0,Saturday,0,Light_rainsnow,0.22,0.2273,1.0,0.1642,10,42,52,695,52,52
795,2011-02-05,Spring,2011,Feb,13,0,Saturday,0,Light_rainsnow,0.22,0.2273,1.0,0.1642,10,62,72,695,72,72
796,2011-02-05,Spring,2011,Feb,14,0,Saturday,0,Light_rainsnow,0.22,0.2727,1.0,0.0,5,50,55,695,55,55
797,2011-02-05,Spring,2011,Feb,15,0,Saturday,0,Light_rainsnow,0.22,0.2727,1.0,0.0,11,49,60,695,60,60
798,2011-02-05,Spring,2011,Feb,16,0,Saturday,0,Light_rainsnow,0.22,0.2273,1.0,0.1343,8,63,71,695,71,71
799,2011-02-05,Spring,2011,Feb,17,0,Saturday,0,Misty,0.24,0.2121,1.0,0.2836,14,64,78,695,78,78
800,2011-02-05,Spring,2011,Feb,18,0,Saturday,0,Misty,0.28,0.2424,0.93,0.4478,2,81,83,695,83,83
801,2011-02-05,Spring,2011,Feb,19,0,Saturday,0,Misty,0.28,0.2424,0.93,0.4478,6,78,84,695,84,84
802,2011-02-05,Spring,2011,Feb,20,0,Saturday,0,Clear,0.3,0.2879,0.87,0.2537,5,64,69,695,69,69
803,2011-02-05,Spring,2011,Feb,21,0,Saturday,0,Clear,0.26,0.2576,1.0,0.194,3,53,56,695,56,56
804,2011-02-05,Spring,2011,Feb,22,0,Saturday,0,Clear,0.26,0.2727,0.93,0.1343,2,43,45,695,45,45
805,2011-02-05,Spring,2011,Feb,23,0,Saturday,0,Clear,0.26,0.2576,0.93,0.2239,7,52,59,695,59,59
806,2011-02-06,Spring,2011,Feb,0,0,Sunday,0,Clear,0.26,0.2576,0.7,0.194,2,37,39,694,39,39
807,2011-02-06,Spring,2011,Feb,1,0,Sunday,0,Clear,0.26,0.2273,0.65,0.4179,4,40,44,694,44,44
808,2011-02-06,Spring,2011,Feb,2,0,Sunday,0,Clear,0.26,0.2273,0.6,0.3284,0,20,20,694,20,20
809,2011-02-06,Spring,2011,Feb,3,0,Sunday,0,Clear,0.26,0.2879,0.6,0.0896,3,10,13,694,13,13
810,2011-02-06,Spring,2011,Feb,4,0,Sunday,0,Clear,0.26,0.2273,0.6,0.3582,0,2,2,694,2,2
811,2011-02-06,Spring,2011,Feb,5,0,Sunday,0,Clear,0.26,0.2576,0.6,0.2239,0,1,1,694,1,1
812,2011-02-06,Spring,2011,Feb,6,0,Sunday,0,Clear,0.26,0.2576,0.6,0.2239,0,1,1,694,1,1
813,2011-02-06,Spring,2011,Feb,7,0,Sunday,0,Clear,0.24,0.2424,0.65,0.1642,0,8,8,694,8,8
814,2011-02-06,Spring,2011,Feb,8,0,Sunday,0,Clear,0.24,0.2576,0.65,0.1045,2,21,23,694,23,23
815,2011-02-06,Spring,2011,Feb,9,0,Sunday,0,Clear,0.28,0.2879,0.56,0.1045,7,38,45,694,45,45
816,2011-02-06,Spring,2011,Feb,10,0,Sunday,0,Clear,0.3,0.2879,0.52,0.2537,15,74,89,694,89,89
817,2011-02-06,Spring,2011,Feb,11,0,Sunday,0,Clear,0.32,0.303,0.49,0.2537,28,89,117,694,117,117
818,2011-02-06,Spring,2011,Feb,12,0,Sunday,0,Clear,0.34,0.3333,0.46,0.0,48,126,174,694,174,174
819,2011-02-06,Spring,2011,Feb,13,0,Sunday,0,Clear,0.34,0.3636,0.46,0.0,47,135,182,694,182,182
820,2011-02-06,Spring,2011,Feb,14,0,Sunday,0,Clear,0.34,0.3485,0.46,0.0896,47,114,161,694,161,161
821,2011-02-06,Spring,2011,Feb,15,0,Sunday,0,Clear,0.34,0.3485,0.46,0.0896,52,130,182,694,182,182
822,2011-02-06,Spring,2011,Feb,16,0,Sunday,0,Clear,0.34,0.3485,0.49,0.1045,42,115,157,694,157,157
823,2011-02-06,Spring,2011,Feb,17,0,Sunday,0,Clear,0.34,0.3636,0.46,0.0,24,97,121,694,121,121
824,2011-02-06,Spring,2011,Feb,18,0,Sunday,0,Clear,0.3,0.303,0.56,0.1642,13,65,78,694,78,78
825,2011-02-06,Spring,2011,Feb,19,0,Sunday,0,Clear,0.28,0.2879,0.61,0.1343,1,20,21,694,21,21
826,2011-02-06,Spring,2011,Feb,20,0,Sunday,0,Clear,0.28,0.2879,0.61,0.1045,5,21,26,694,26,26
827,2011-02-06,Spring,2011,Feb,21,0,Sunday,0,Clear,0.26,0.303,0.6,0.0,5,22,27,694,27,27
828,2011-02-06,Spring,2011,Feb,22,0,Sunday,0,Clear,0.26,0.303,0.6,0.0,5,57,62,694,62,62
829,2011-02-06,Spring,2011,Feb,23,0,Sunday,0,Clear,0.24,0.2879,0.65,0.0,4,26,30,694,30,30
830,2011-02-07,Spring,2011,Feb,0,0,Monday,1,Clear,0.24,0.2879,0.65,0.0,1,14,15,693,15,15
831,2011-02-07,Spring,2011,Feb,1,0,Monday,1,Clear,0.22,0.2727,0.75,0.0,1,4,5,693,5,5
832,2011-02-07,Spring,2011,Feb,2,0,Monday,1,Clear,0.2,0.2576,0.8,0.0,0,3,3,693,3,3
833,2011-02-07,Spring,2011,Feb,3,0,Monday,1,Clear,0.2,0.2576,0.86,0.0,0,1,1,693,1,1
834,2011-02-07,Spring,2011,Feb,4,0,Monday,1,Clear,0.2,0.2576,0.86,0.0,1,1,2,693,2,2
835,2011-02-07,Spring,2011,Feb,5,0,Monday,1,Clear,0.2,0.2576,0.86,0.0,1,9,10,693,10,10
836,2011-02-07,Spring,2011,Feb,6,0,Monday,1,Clear,0.18,0.2424,0.93,0.0,1,29,30,693,30,30
837,2011-02-07,Spring,2011,Feb,7,0,Monday,1,Clear,0.18,0.2424,0.86,0.0,6,89,95,693,95,95
838,2011-02-07,Spring,2011,Feb,8,0,Monday,1,Misty,0.16,0.2273,1.0,0.0,7,223,230,693,230,230
839,2011-02-07,Spring,2011,Feb,9,0,Monday,1,Clear,0.22,0.2727,0.8,0.0,3,115,118,693,118,118
840,2011-02-07,Spring,2011,Feb,10,0,Monday,1,Clear,0.24,0.2576,0.75,0.1045,6,49,55,693,55,55
841,2011-02-07,Spring,2011,Feb,11,0,Monday,1,Clear,0.3,0.3182,0.65,0.0896,11,36,47,693,47,47
842,2011-02-07,Spring,2011,Feb,12,0,Monday,1,Misty,0.32,0.3485,0.62,0.0,7,59,66,693,66,66
843,2011-02-07,Spring,2011,Feb,13,0,Monday,1,Misty,0.36,0.3636,0.57,0.0896,10,54,64,693,64,64
844,2011-02-07,Spring,2011,Feb,14,0,Monday,1,Misty,0.36,0.3636,0.57,0.0896,8,52,60,693,60,60
845,2011-02-07,Spring,2011,Feb,15,0,Monday,1,Misty,0.38,0.3939,0.54,0.0896,4,46,50,693,50,50
846,2011-02-07,Spring,2011,Feb,16,0,Monday,1,Misty,0.36,0.3485,0.57,0.1343,16,98,114,693,114,114
847,2011-02-07,Spring,2011,Feb,17,0,Monday,1,Misty,0.32,0.3182,0.7,0.1642,9,207,216,693,216,216
848,2011-02-07,Spring,2011,Feb,18,0,Monday,1,Misty,0.34,0.3333,0.66,0.1343,5,170,175,693,175,175
849,2011-02-07,Spring,2011,Feb,19,0,Monday,1,Misty,0.32,0.3485,0.7,0.0,5,123,128,693,128,128
850,2011-02-07,Spring,2011,Feb,20,0,Monday,1,Misty,0.32,0.3333,0.7,0.1045,6,82,88,693,88,88
851,2011-02-07,Spring,2011,Feb,21,0,Monday,1,Clear,0.32,0.3485,0.7,0.0,3,75,78,693,78,78
852,2011-02-07,Spring,2011,Feb,22,0,Monday,1,Clear,0.28,0.303,0.81,0.0896,3,34,37,693,37,37
853,2011-02-07,Spring,2011,Feb,23,0,Monday,1,Misty,0.3,0.3333,0.81,0.0,6,19,25,693,25,25
854,2011-02-08,Spring,2011,Feb,0,0,Tuesday,1,Misty,0.28,0.3182,0.87,0.0,4,6,10,692,10,10
855,2011-02-08,Spring,2011,Feb,1,0,Tuesday,1,Misty,0.28,0.3182,0.87,0.0,0,4,4,692,4,4
856,2011-02-08,Spring,2011,Feb,2,0,Tuesday,1,Misty,0.26,0.2727,0.93,0.1045,1,1,2,692,2,2
857,2011-02-08,Spring,2011,Feb,3,0,Tuesday,1,Light_rainsnow,0.28,0.2727,0.93,0.1642,0,1,1,692,1,1
858,2011-02-08,Spring,2011,Feb,4,0,Tuesday,1,Clear,0.26,0.2576,0.93,0.1642,0,3,3,692,3,3
859,2011-02-08,Spring,2011,Feb,5,0,Tuesday,1,Clear,0.26,0.2273,0.81,0.3284,0,2,2,692,2,2
860,2011-02-08,Spring,2011,Feb,6,0,Tuesday,1,Clear,0.26,0.2273,0.7,0.3284,0,39,39,692,39,39
861,2011-02-08,Spring,2011,Feb,7,0,Tuesday,1,Clear,0.24,0.197,0.65,0.4179,3,97,100,692,100,100
862,2011-02-08,Spring,2011,Feb,8,0,Tuesday,1,Clear,0.24,0.197,0.56,0.4925,7,236,243,692,243,243
863,2011-02-08,Spring,2011,Feb,9,0,Tuesday,1,Clear,0.24,0.197,0.52,0.4925,7,128,135,692,135,135
864,2011-02-08,Spring,2011,Feb,10,0,Tuesday,1,Clear,0.22,0.1818,0.47,0.5522,4,44,48,692,48,48
865,2011-02-08,Spring,2011,Feb,11,0,Tuesday,1,Clear,0.22,0.1818,0.47,0.4627,1,49,50,692,50,50
866,2011-02-08,Spring,2011,Feb,12,0,Tuesday,1,Clear,0.24,0.197,0.38,0.4925,2,63,65,692,65,65
867,2011-02-08,Spring,2011,Feb,13,0,Tuesday,1,Misty,0.24,0.197,0.32,0.4478,2,48,50,692,50,50
868,2011-02-08,Spring,2011,Feb,14,0,Tuesday,1,Clear,0.22,0.197,0.37,0.4179,3,61,64,692,64,64
869,2011-02-08,Spring,2011,Feb,15,0,Tuesday,1,Clear,0.22,0.197,0.35,0.3881,6,45,51,692,51,51
870,2011-02-08,Spring,2011,Feb,16,0,Tuesday,1,Clear,0.22,0.1818,0.35,0.5224,4,79,83,692,83,83
871,2011-02-08,Spring,2011,Feb,17,0,Tuesday,1,Clear,0.22,0.1818,0.32,0.5821,4,172,176,692,176,176
872,2011-02-08,Spring,2011,Feb,18,0,Tuesday,1,Clear,0.2,0.1818,0.32,0.3881,1,151,152,692,152,152
873,2011-02-08,Spring,2011,Feb,19,0,Tuesday,1,Clear,0.16,0.1212,0.4,0.4627,1,100,101,692,101,101
874,2011-02-08,Spring,2011,Feb,20,0,Tuesday,1,Clear,0.16,0.1364,0.4,0.3284,3,53,56,692,56,56
875,2011-02-08,Spring,2011,Feb,21,0,Tuesday,1,Clear,0.14,0.1061,0.33,0.4627,8,46,54,692,54,54
876,2011-02-08,Spring,2011,Feb,22,0,Tuesday,1,Clear,0.12,0.1061,0.33,0.3582,0,29,29,692,29,29
877,2011-02-08,Spring,2011,Feb,23,0,Tuesday,1,Clear,0.12,0.1061,0.33,0.3284,3,9,12,692,12,12
878,2011-02-09,Spring,2011,Feb,0,0,Wednesday,1,Clear,0.1,0.0758,0.36,0.3582,0,17,17,691,17,17
879,2011-02-09,Spring,2011,Feb,1,0,Wednesday,1,Clear,0.1,0.1061,0.36,0.2239,0,7,7,691,7,7
880,2011-02-09,Spring,2011,Feb,2,0,Wednesday,1,Clear,0.08,0.0758,0.38,0.2836,1,2,3,691,3,3
881,2011-02-09,Spring,2011,Feb,3,0,Wednesday,1,Clear,0.06,0.0758,0.45,0.1343,0,2,2,691,2,2
882,2011-02-09,Spring,2011,Feb,5,0,Wednesday,1,Clear,0.06,0.1061,0.45,0.1045,0,7,7,691,7,7
883,2011-02-09,Spring,2011,Feb,6,0,Wednesday,1,Clear,0.06,0.1515,0.45,0.0,0,43,43,691,43,43
884,2011-02-09,Spring,2011,Feb,7,0,Wednesday,1,Clear,0.06,0.1061,0.49,0.1045,4,95,99,691,99,99
885,2011-02-09,Spring,2011,Feb,8,0,Wednesday,1,Clear,0.1,0.1364,0.42,0.0,1,198,199,691,199,199
886,2011-02-09,Spring,2011,Feb,9,0,Wednesday,1,Clear,0.12,0.1364,0.39,0.1642,4,119,123,691,123,123
887,2011-02-09,Spring,2011,Feb,10,0,Wednesday,1,Clear,0.14,0.1818,0.36,0.0,8,51,59,691,59,59
888,2011-02-09,Spring,2011,Feb,11,0,Wednesday,1,Misty,0.14,0.1515,0.43,0.1642,1,40,41,691,41,41
889,2011-02-09,Spring,2011,Feb,12,0,Wednesday,1,Misty,0.18,0.1818,0.4,0.2239,4,57,61,691,61,61
890,2011-02-09,Spring,2011,Feb,13,0,Wednesday,1,Clear,0.18,0.1667,0.4,0.2537,2,67,69,691,69,69
891,2011-02-09,Spring,2011,Feb,14,0,Wednesday,1,Clear,0.2,0.1818,0.34,0.2985,2,56,58,691,58,58
892,2011-02-09,Spring,2011,Feb,15,0,Wednesday,1,Misty,0.2,0.1818,0.34,0.2836,3,61,64,691,64,64
893,2011-02-09,Spring,2011,Feb,16,0,Wednesday,1,Misty,0.2,0.197,0.37,0.2537,7,72,79,691,79,79
894,2011-02-09,Spring,2011,Feb,17,0,Wednesday,1,Misty,0.2,0.197,0.34,0.2537,9,157,166,691,166,166
895,2011-02-09,Spring,2011,Feb,18,0,Wednesday,1,Misty,0.18,0.1667,0.47,0.2985,2,168,170,691,170,170
896,2011-02-09,Spring,2011,Feb,19,0,Wednesday,1,Light_rainsnow,0.14,0.1212,0.86,0.2537,1,87,88,691,88,88
897,2011-02-09,Spring,2011,Feb,20,0,Wednesday,1,Light_rainsnow,0.14,0.1515,0.86,0.1642,0,84,84,691,84,84
898,2011-02-09,Spring,2011,Feb,21,0,Wednesday,1,Misty,0.14,0.1515,0.86,0.1642,0,83,83,691,83,83
899,2011-02-09,Spring,2011,Feb,22,0,Wednesday,1,Light_rainsnow,0.16,0.1667,0.8,0.1642,4,42,46,691,46,46
900,2011-02-09,Spring,2011,Feb,23,0,Wednesday,1,Light_rainsnow,0.16,0.1515,0.8,0.194,0,37,37,691,37,37
901,2011-02-10,Spring,2011,Feb,0,0,Thursday,1,Light_rainsnow,0.14,0.1364,0.86,0.194,0,16,16,690,16,16
902,2011-02-10,Spring,2011,Feb,1,0,Thursday,1,Light_rainsnow,0.14,0.1515,0.8,0.1343,0,7,7,690,7,7
903,2011-02-10,Spring,2011,Feb,2,0,Thursday,1,Light_rainsnow,0.14,0.1515,0.8,0.1343,0,3,3,690,3,3
904,2011-02-10,Spring,2011,Feb,4,0,Thursday,1,Misty,0.14,0.1364,0.59,0.2239,0,1,1,690,1,1
905,2011-02-10,Spring,2011,Feb,5,0,Thursday,1,Misty,0.12,0.1212,0.5,0.2239,0,6,6,690,6,6
906,2011-02-10,Spring,2011,Feb,6,0,Thursday,1,Misty,0.12,0.1212,0.54,0.2836,0,26,26,690,26,26
907,2011-02-10,Spring,2011,Feb,7,0,Thursday,1,Clear,0.1,0.0758,0.5,0.4179,0,99,99,690,99,99
908,2011-02-10,Spring,2011,Feb,8,0,Thursday,1,Clear,0.1,0.0758,0.49,0.3284,5,173,178,690,178,178
909,2011-02-10,Spring,2011,Feb,9,0,Thursday,1,Clear,0.12,0.1061,0.42,0.3582,1,121,122,690,122,122
910,2011-02-10,Spring,2011,Feb,10,0,Thursday,1,Clear,0.12,0.1061,0.42,0.2985,1,34,35,690,35,35
911,2011-02-10,Spring,2011,Feb,11,0,Thursday,1,Clear,0.14,0.1212,0.39,0.3582,1,44,45,690,45,45
912,2011-02-10,Spring,2011,Feb,12,0,Thursday,1,Clear,0.16,0.1364,0.34,0.3881,4,65,69,690,69,69
913,2011-02-10,Spring,2011,Feb,13,0,Thursday,1,Clear,0.18,0.1667,0.29,0.2985,3,59,62,690,62,62
914,2011-02-10,Spring,2011,Feb,14,0,Thursday,1,Clear,0.2,0.1818,0.27,0.2836,6,42,48,690,48,48
915,2011-02-10,Spring,2011,Feb,15,0,Thursday,1,Clear,0.2,0.197,0.25,0.2537,0,50,50,690,50,50
916,2011-02-10,Spring,2011,Feb,16,0,Thursday,1,Clear,0.2,0.1818,0.27,0.2985,4,76,80,690,80,80
917,2011-02-10,Spring,2011,Feb,17,0,Thursday,1,Clear,0.18,0.1818,0.26,0.194,6,159,165,690,165,165
918,2011-02-10,Spring,2011,Feb,18,0,Thursday,1,Clear,0.16,0.1818,0.28,0.1343,3,157,160,690,160,160
919,2011-02-10,Spring,2011,Feb,19,0,Thursday,1,Clear,0.14,0.1667,0.28,0.1045,2,110,112,690,112,112
920,2011-02-10,Spring,2011,Feb,20,0,Thursday,1,Clear,0.14,0.1818,0.31,0.0896,4,93,97,690,97,97
921,2011-02-10,Spring,2011,Feb,21,0,Thursday,1,Clear,0.14,0.2121,0.39,0.0,2,70,72,690,72,72
922,2011-02-10,Spring,2011,Feb,22,0,Thursday,1,Clear,0.12,0.197,0.39,0.0,4,47,51,690,51,51
923,2011-02-10,Spring,2011,Feb,23,0,Thursday,1,Clear,0.12,0.1515,0.42,0.1045,1,33,34,690,34,34
924,2011-02-11,Spring,2011,Feb,0,0,Friday,1,Clear,0.1,0.1364,0.49,0.1045,2,12,14,689,14,14
925,2011-02-11,Spring,2011,Feb,1,0,Friday,1,Clear,0.1,0.1364,0.54,0.0896,1,6,7,689,7,7
926,2011-02-11,Spring,2011,Feb,2,0,Friday,1,Clear,0.1,0.1364,0.54,0.0896,0,3,3,689,3,3
927,2011-02-11,Spring,2011,Feb,5,0,Friday,1,Clear,0.08,0.1212,0.63,0.0896,0,4,4,689,4,4
928,2011-02-11,Spring,2011,Feb,6,0,Friday,1,Clear,0.1,0.1818,0.68,0.0,1,23,24,689,24,24
929,2011-02-11,Spring,2011,Feb,7,0,Friday,1,Clear,0.08,0.1667,0.73,0.0,1,73,74,689,74,74
930,2011-02-11,Spring,2011,Feb,8,0,Friday,1,Clear,0.1,0.1212,0.74,0.1642,4,212,216,689,216,216
931,2011-02-11,Spring,2011,Feb,9,0,Friday,1,Clear,0.12,0.1212,0.74,0.2239,8,132,140,689,140,140
932,2011-02-11,Spring,2011,Feb,10,0,Friday,1,Clear,0.14,0.1364,0.69,0.194,5,39,44,689,44,44
933,2011-02-11,Spring,2011,Feb,11,0,Friday,1,Clear,0.22,0.2273,0.47,0.1343,12,52,64,689,64,64
934,2011-02-11,Spring,2011,Feb,12,0,Friday,1,Clear,0.22,0.2273,0.47,0.1343,7,64,71,689,71,71
935,2011-02-11,Spring,2011,Feb,13,0,Friday,1,Clear,0.24,0.2273,0.35,0.194,21,89,110,689,110,110
936,2011-02-11,Spring,2011,Feb,14,0,Friday,1,Clear,0.3,0.2879,0.26,0.2537,17,67,84,689,84,84
937,2011-02-11,Spring,2011,Feb,15,0,Friday,1,Clear,0.32,0.3182,0.21,0.1642,12,62,74,689,74,74
938,2011-02-11,Spring,2011,Feb,16,0,Friday,1,Clear,0.3,0.2879,0.28,0.194,14,111,125,689,125,125
939,2011-02-11,Spring,2011,Feb,17,0,Friday,1,Clear,0.3,0.3333,0.24,0.0,18,193,211,689,211,211
940,2011-02-11,Spring,2011,Feb,18,0,Friday,1,Clear,0.28,0.3182,0.28,0.0,9,165,174,689,174,174
941,2011-02-11,Spring,2011,Feb,19,0,Friday,1,Clear,0.26,0.303,0.33,0.0,7,94,101,689,101,101
942,2011-02-11,Spring,2011,Feb,20,0,Friday,1,Clear,0.22,0.2273,0.55,0.1343,2,61,63,689,63,63
943,2011-02-11,Spring,2011,Feb,21,0,Friday,1,Clear,0.2,0.2121,0.59,0.1343,1,46,47,689,47,47
944,2011-02-11,Spring,2011,Feb,22,0,Friday,1,Clear,0.2,0.2273,0.64,0.0896,2,41,43,689,43,43
945,2011-02-11,Spring,2011,Feb,23,0,Friday,1,Clear,0.18,0.2424,0.69,0.0,5,48,53,689,53,53
946,2011-02-12,Spring,2011,Feb,0,0,Saturday,0,Clear,0.16,0.197,0.69,0.0896,3,27,30,688,30,30
947,2011-02-12,Spring,2011,Feb,1,0,Saturday,0,Clear,0.14,0.2121,0.86,0.0,2,22,24,688,24,24
948,2011-02-12,Spring,2011,Feb,2,0,Saturday,0,Clear,0.14,0.2121,0.8,0.0,2,13,15,688,15,15
949,2011-02-12,Spring,2011,Feb,3,0,Saturday,0,Clear,0.12,0.197,0.8,0.0,3,7,10,688,10,10
950,2011-02-12,Spring,2011,Feb,4,0,Saturday,0,Clear,0.12,0.1667,0.74,0.0896,0,4,4,688,4,4
951,2011-02-12,Spring,2011,Feb,5,0,Saturday,0,Clear,0.12,0.1667,0.74,0.0896,0,1,1,688,1,1
952,2011-02-12,Spring,2011,Feb,6,0,Saturday,0,Clear,0.12,0.1364,0.93,0.194,1,1,2,688,2,2
953,2011-02-12,Spring,2011,Feb,7,0,Saturday,0,Clear,0.12,0.1515,0.8,0.1045,2,9,11,688,11,11
954,2011-02-12,Spring,2011,Feb,8,0,Saturday,0,Clear,0.14,0.1515,0.86,0.1343,2,28,30,688,30,30
955,2011-02-12,Spring,2011,Feb,9,0,Saturday,0,Clear,0.16,0.1818,0.64,0.1343,5,38,43,688,43,43
956,2011-02-12,Spring,2011,Feb,10,0,Saturday,0,Clear,0.22,0.2121,0.41,0.2537,13,71,84,688,84,84
957,2011-02-12,Spring,2011,Feb,11,0,Saturday,0,Clear,0.3,0.2727,0.28,0.3284,30,84,114,688,114,114
958,2011-02-12,Spring,2011,Feb,12,0,Saturday,0,Clear,0.3,0.2727,0.39,0.4627,27,93,120,688,120,120
959,2011-02-12,Spring,2011,Feb,13,0,Saturday,0,Clear,0.3,0.2727,0.39,0.4179,32,103,135,688,135,135
960,2011-02-12,Spring,2011,Feb,14,0,Saturday,0,Clear,0.34,0.3182,0.31,0.2836,30,90,120,688,120,120
961,2011-02-12,Spring,2011,Feb,15,0,Saturday,0,Clear,0.34,0.303,0.29,0.4179,47,127,174,688,174,174
962,2011-02-12,Spring,2011,Feb,16,0,Saturday,0,Clear,0.34,0.303,0.29,0.4179,42,103,145,688,145,145
963,2011-02-12,Spring,2011,Feb,17,0,Saturday,0,Clear,0.32,0.2879,0.31,0.5224,24,113,137,688,137,137
964,2011-02-12,Spring,2011,Feb,18,0,Saturday,0,Clear,0.28,0.2576,0.38,0.3284,4,60,64,688,64,64
965,2011-02-12,Spring,2011,Feb,19,0,Saturday,0,Clear,0.28,0.2727,0.38,0.1642,2,39,41,688,41,41
966,2011-02-12,Spring,2011,Feb,20,0,Saturday,0,Clear,0.26,0.2576,0.41,0.2239,1,39,40,688,40,40
967,2011-02-12,Spring,2011,Feb,21,0,Saturday,0,Clear,0.26,0.303,0.41,0.0,9,42,51,688,51,51
968,2011-02-12,Spring,2011,Feb,22,0,Saturday,0,Clear,0.24,0.2576,0.44,0.0896,6,39,45,688,45,45
969,2011-02-12,Spring,2011,Feb,23,0,Saturday,0,Clear,0.22,0.2273,0.51,0.1343,1,31,32,688,32,32
970,2011-02-13,Spring,2011,Feb,0,0,Sunday,0,Clear,0.2,0.2273,0.64,0.1045,5,34,39,687,39,39
971,2011-02-13,Spring,2011,Feb,1,0,Sunday,0,Clear,0.2,0.2273,0.59,0.0896,1,23,24,687,24,24
972,2011-02-13,Spring,2011,Feb,2,0,Sunday,0,Misty,0.2,0.2273,0.75,0.0896,1,19,20,687,20,20
973,2011-02-13,Spring,2011,Feb,3,0,Sunday,0,Misty,0.2,0.2273,0.69,0.1045,4,8,12,687,12,12
974,2011-02-13,Spring,2011,Feb,4,0,Sunday,0,Misty,0.2,0.2121,0.69,0.1642,0,2,2,687,2,2
975,2011-02-13,Spring,2011,Feb,6,0,Sunday,0,Misty,0.2,0.2121,0.69,0.1343,2,3,5,687,5,5
976,2011-02-13,Spring,2011,Feb,7,0,Sunday,0,Misty,0.22,0.2727,0.55,0.0,0,3,3,687,3,3
977,2011-02-13,Spring,2011,Feb,8,0,Sunday,0,Misty,0.22,0.2273,0.64,0.194,1,11,12,687,12,12
978,2011-02-13,Spring,2011,Feb,9,0,Sunday,0,Misty,0.24,0.2273,0.6,0.2239,12,35,47,687,47,47
979,2011-02-13,Spring,2011,Feb,10,0,Sunday,0,Clear,0.3,0.2727,0.45,0.3284,19,86,105,687,105,105
980,2011-02-13,Spring,2011,Feb,11,0,Sunday,0,Clear,0.32,0.2879,0.39,0.4478,26,86,112,687,112,112
981,2011-02-13,Spring,2011,Feb,12,0,Sunday,0,Clear,0.36,0.3182,0.32,0.4627,58,94,152,687,152,152
982,2011-02-13,Spring,2011,Feb,13,0,Sunday,0,Clear,0.38,0.3939,0.29,0.3582,62,92,154,687,154,154
983,2011-02-13,Spring,2011,Feb,14,0,Sunday,0,Misty,0.4,0.4091,0.3,0.4179,51,110,161,687,161,161
984,2011-02-13,Spring,2011,Feb,15,0,Sunday,0,Misty,0.4,0.4091,0.3,0.2985,40,122,162,687,162,162
985,2011-02-13,Spring,2011,Feb,16,0,Sunday,0,Misty,0.42,0.4242,0.28,0.3284,28,106,134,687,134,134
986,2011-02-13,Spring,2011,Feb,17,0,Sunday,0,Clear,0.42,0.4242,0.28,0.3284,30,95,125,687,125,125
987,2011-02-13,Spring,2011,Feb,18,0,Sunday,0,Clear,0.4,0.4091,0.32,0.2985,17,78,95,687,95,95
988,2011-02-13,Spring,2011,Feb,19,0,Sunday,0,Clear,0.4,0.4091,0.35,0.2836,11,50,61,687,61,61
989,2011-02-13,Spring,2011,Feb,20,0,Sunday,0,Clear,0.4,0.4091,0.35,0.3284,15,32,47,687,47,47
990,2011-02-13,Spring,2011,Feb,21,0,Sunday,0,Clear,0.4,0.4091,0.35,0.3582,6,45,51,687,51,51
991,2011-02-13,Spring,2011,Feb,22,0,Sunday,0,Clear,0.4,0.4091,0.35,0.2985,5,31,36,687,36,36
992,2011-02-13,Spring,2011,Feb,23,0,Sunday,0,Clear,0.4,0.4091,0.35,0.3582,3,27,30,687,30,30
993,2011-02-14,Spring,2011,Feb,0,0,Monday,1,Clear,0.38,0.3939,0.37,0.3582,3,8,11,686,11,11
994,2011-02-14,Spring,2011,Feb,1,0,Monday,1,Clear,0.38,0.3939,0.37,0.3582,1,6,7,686,7,7
995,2011-02-14,Spring,2011,Feb,2,0,Monday,1,Clear,0.36,0.3333,0.4,0.2985,0,2,2,686,2,2
996,2011-02-14,Spring,2011,Feb,3,0,Monday,1,Clear,0.34,0.3182,0.46,0.2239,1,1,2,686,2,2
997,2011-02-14,Spring,2011,Feb,4,0,Monday,1,Clear,0.32,0.303,0.53,0.2836,0,2,2,686,2,2
998,2011-02-14,Spring,2011,Feb,5,0,Monday,1,Clear,0.32,0.303,0.53,0.2836,0,3,3,686,3,3
999,2011-02-14,Spring,2011,Feb,6,0,Monday,1,Clear,0.34,0.303,0.46,0.2985,1,25,26,686,26,26
1000,2011-02-14,Spring,2011,Feb,7,0,Monday,1,Clear,0.34,0.303,0.46,0.2985,2,96,98,686,98,98
1001,2011-02-14,Spring,2011,Feb,8,0,Monday,1,Clear,0.38,0.3939,0.4,0.4627,7,249,256,686,256,256
1002,2011-02-14,Spring,2011,Feb,9,0,Monday,1,Clear,0.4,0.4091,0.37,0.3881,8,122,130,686,130,130
1003,2011-02-14,Spring,2011,Feb,10,0,Monday,1,Clear,0.44,0.4394,0.33,0.2239,9,46,55,686,55,55
1004,2011-02-14,Spring,2011,Feb,11,0,Monday,1,Clear,0.52,0.5,0.23,0.2537,10,43,53,686,53,53
1005,2011-02-14,Spring,2011,Feb,12,0,Monday,1,Clear,0.56,0.5303,0.22,0.4478,27,99,126,686,126,126
1006,2011-02-14,Spring,2011,Feb,13,0,Monday,1,Clear,0.58,0.5455,0.19,0.3881,27,93,120,686,120,120
1007,2011-02-14,Spring,2011,Feb,14,0,Monday,1,Clear,0.6,0.5909,0.15,0.4925,14,76,90,686,90,90
1008,2011-02-14,Spring,2011,Feb,15,0,Monday,1,Clear,0.56,0.5303,0.21,0.6567,19,71,90,686,90,90
1009,2011-02-14,Spring,2011,Feb,16,0,Monday,1,Clear,0.52,0.5,0.27,0.4627,16,102,118,686,118,118
1010,2011-02-14,Spring,2011,Feb,17,0,Monday,1,Clear,0.46,0.4545,0.33,0.6119,25,218,243,686,243,243
1011,2011-02-14,Spring,2011,Feb,18,0,Monday,1,Clear,0.4,0.4091,0.4,0.6119,11,194,205,686,205,205
1012,2011-02-14,Spring,2011,Feb,19,0,Monday,1,Clear,0.38,0.3939,0.43,0.4925,12,86,98,686,98,98
1013,2011-02-14,Spring,2011,Feb,20,0,Monday,1,Clear,0.36,0.3182,0.46,0.4627,5,65,70,686,70,70
1014,2011-02-14,Spring,2011,Feb,21,0,Monday,1,Clear,0.36,0.3182,0.5,0.5224,8,35,43,686,43,43
1015,2011-02-14,Spring,2011,Feb,22,0,Monday,1,Clear,0.34,0.2879,0.46,0.6567,1,44,45,686,45,45
1016,2011-02-14,Spring,2011,Feb,23,0,Monday,1,Clear,0.32,0.2879,0.49,0.4925,1,19,20,686,20,20
1017,2011-02-15,Spring,2011,Feb,0,0,Tuesday,1,Clear,0.3,0.2727,0.49,0.4179,7,12,19,685,19,19
1018,2011-02-15,Spring,2011,Feb,1,0,Tuesday,1,Clear,0.3,0.2424,0.42,0.7761,0,5,5,685,5,5
1019,2011-02-15,Spring,2011,Feb,2,0,Tuesday,1,Clear,0.28,0.2273,0.41,0.6866,1,2,3,685,3,3
1020,2011-02-15,Spring,2011,Feb,4,0,Tuesday,1,Clear,0.22,0.1818,0.37,0.5224,0,1,1,685,1,1
1021,2011-02-15,Spring,2011,Feb,5,0,Tuesday,1,Clear,0.22,0.1818,0.32,0.4627,0,4,4,685,4,4
1022,2011-02-15,Spring,2011,Feb,6,0,Tuesday,1,Clear,0.2,0.1818,0.32,0.3284,0,30,30,685,30,30
1023,2011-02-15,Spring,2011,Feb,7,0,Tuesday,1,Clear,0.2,0.1818,0.32,0.3582,2,103,105,685,105,105
1024,2011-02-15,Spring,2011,Feb,8,0,Tuesday,1,Clear,0.2,0.1818,0.32,0.3582,10,213,223,685,223,223
1025,2011-02-15,Spring,2011,Feb,9,0,Tuesday,1,Clear,0.22,0.197,0.29,0.4478,2,108,110,685,110,110
1026,2011-02-15,Spring,2011,Feb,10,0,Tuesday,1,Clear,0.24,0.2121,0.27,0.2836,5,47,52,685,52,52
1027,2011-02-15,Spring,2011,Feb,11,0,Tuesday,1,Clear,0.26,0.2424,0.25,0.2537,11,46,57,685,57,57
1028,2011-02-15,Spring,2011,Feb,12,0,Tuesday,1,Clear,0.28,0.2727,0.24,0.2537,6,65,71,685,71,71
1029,2011-02-15,Spring,2011,Feb,13,0,Tuesday,1,Clear,0.32,0.303,0.21,0.2239,14,68,82,685,82,82
1030,2011-02-15,Spring,2011,Feb,14,0,Tuesday,1,Clear,0.34,0.3182,0.19,0.2239,10,69,79,685,79,79
1031,2011-02-15,Spring,2011,Feb,15,0,Tuesday,1,Clear,0.34,0.3333,0.19,0.1642,11,74,85,685,85,85
1032,2011-02-15,Spring,2011,Feb,16,0,Tuesday,1,Clear,0.34,0.3182,0.19,0.2537,21,77,98,685,98,98
1033,2011-02-15,Spring,2011,Feb,17,0,Tuesday,1,Clear,0.32,0.303,0.22,0.2239,15,191,206,685,206,206
1034,2011-02-15,Spring,2011,Feb,18,0,Tuesday,1,Clear,0.3,0.303,0.22,0.1343,14,198,212,685,212,212
1035,2011-02-15,Spring,2011,Feb,19,0,Tuesday,1,Clear,0.28,0.2879,0.26,0.1343,3,142,145,685,145,145
1036,2011-02-15,Spring,2011,Feb,20,0,Tuesday,1,Clear,0.26,0.2727,0.33,0.1045,3,98,101,685,101,101
1037,2011-02-15,Spring,2011,Feb,21,0,Tuesday,1,Clear,0.24,0.2879,0.52,0.0,5,61,66,685,66,66
1038,2011-02-15,Spring,2011,Feb,22,0,Tuesday,1,Clear,0.24,0.2879,0.44,0.0,0,41,41,685,41,41
1039,2011-02-15,Spring,2011,Feb,23,0,Tuesday,1,Misty,0.22,0.2576,0.44,0.0896,0,20,20,685,20,20
1040,2011-02-16,Spring,2011,Feb,0,0,Wednesday,1,Clear,0.22,0.2576,0.41,0.0896,0,15,15,684,15,15
1041,2011-02-16,Spring,2011,Feb,1,0,Wednesday,1,Clear,0.2,0.2273,0.44,0.0896,0,9,9,684,9,9
1042,2011-02-16,Spring,2011,Feb,3,0,Wednesday,1,Misty,0.2,0.197,0.47,0.194,0,1,1,684,1,1
1043,2011-02-16,Spring,2011,Feb,4,0,Wednesday,1,Clear,0.2,0.197,0.51,0.194,0,1,1,684,1,1
1044,2011-02-16,Spring,2011,Feb,5,0,Wednesday,1,Clear,0.2,0.197,0.47,0.194,0,5,5,684,5,5
1045,2011-02-16,Spring,2011,Feb,6,0,Wednesday,1,Clear,0.2,0.197,0.55,0.2239,1,32,33,684,33,33
1046,2011-02-16,Spring,2011,Feb,7,0,Wednesday,1,Misty,0.2,0.197,0.55,0.2239,5,103,108,684,108,108
1047,2011-02-16,Spring,2011,Feb,8,0,Wednesday,1,Misty,0.22,0.2273,0.55,0.1642,6,224,230,684,230,230
1048,2011-02-16,Spring,2011,Feb,9,0,Wednesday,1,Clear,0.24,0.2121,0.52,0.2836,2,122,124,684,124,124
1049,2011-02-16,Spring,2011,Feb,10,0,Wednesday,1,Clear,0.26,0.2273,0.41,0.3881,14,55,69,684,69,69
1050,2011-02-16,Spring,2011,Feb,11,0,Wednesday,1,Clear,0.34,0.303,0.34,0.2985,7,59,66,684,66,66
1051,2011-02-16,Spring,2011,Feb,12,0,Wednesday,1,Clear,0.38,0.3939,0.32,0.3284,14,72,86,684,86,86
1052,2011-02-16,Spring,2011,Feb,13,0,Wednesday,1,Clear,0.42,0.4242,0.3,0.3582,13,80,93,684,93,93
1053,2011-02-16,Spring,2011,Feb,14,0,Wednesday,1,Clear,0.46,0.4545,0.28,0.4179,17,65,82,684,82,82
1054,2011-02-16,Spring,2011,Feb,15,0,Wednesday,1,Clear,0.46,0.4545,0.28,0.4179,35,82,117,684,117,117
1055,2011-02-16,Spring,2011,Feb,16,0,Wednesday,1,Clear,0.46,0.4545,0.31,0.3881,26,96,122,684,122,122
1056,2011-02-16,Spring,2011,Feb,17,0,Wednesday,1,Clear,0.46,0.4545,0.28,0.2836,11,244,255,684,255,255
1057,2011-02-16,Spring,2011,Feb,18,0,Wednesday,1,Clear,0.4,0.4091,0.4,0.2239,20,202,222,684,222,222
1058,2011-02-16,Spring,2011,Feb,19,0,Wednesday,1,Clear,0.34,0.3182,0.53,0.2239,18,143,161,684,161,161
1059,2011-02-16,Spring,2011,Feb,20,0,Wednesday,1,Clear,0.38,0.3939,0.43,0.194,10,108,118,684,118,118
1060,2011-02-16,Spring,2011,Feb,21,0,Wednesday,1,Clear,0.36,0.3485,0.46,0.194,5,87,92,684,92,92
1061,2011-02-16,Spring,2011,Feb,22,0,Wednesday,1,Clear,0.34,0.3333,0.53,0.194,12,61,73,684,73,73
1062,2011-02-16,Spring,2011,Feb,23,0,Wednesday,1,Clear,0.38,0.3939,0.4,0.2239,2,31,33,684,33,33
1063,2011-02-17,Spring,2011,Feb,0,0,Thursday,1,Clear,0.34,0.3333,0.53,0.194,1,16,17,683,17,17
1064,2011-02-17,Spring,2011,Feb,1,0,Thursday,1,Clear,0.34,0.3182,0.53,0.2239,0,6,6,683,6,6
1065,2011-02-17,Spring,2011,Feb,2,0,Thursday,1,Misty,0.34,0.3182,0.53,0.2239,2,4,6,683,6,6
1066,2011-02-17,Spring,2011,Feb,3,0,Thursday,1,Clear,0.34,0.3333,0.53,0.194,3,1,4,683,4,4
1067,2011-02-17,Spring,2011,Feb,4,0,Thursday,1,Clear,0.32,0.3182,0.57,0.194,3,1,4,683,4,4
1068,2011-02-17,Spring,2011,Feb,5,0,Thursday,1,Clear,0.32,0.3333,0.66,0.0896,1,11,12,683,12,12
1069,2011-02-17,Spring,2011,Feb,6,0,Thursday,1,Clear,0.3,0.303,0.7,0.1343,3,44,47,683,47,47
1070,2011-02-17,Spring,2011,Feb,7,0,Thursday,1,Clear,0.32,0.3333,0.57,0.1045,7,119,126,683,126,126
1071,2011-02-17,Spring,2011,Feb,8,0,Thursday,1,Clear,0.32,0.3333,0.57,0.0896,18,267,285,683,285,285
1072,2011-02-17,Spring,2011,Feb,9,0,Thursday,1,Clear,0.36,0.3485,0.57,0.194,16,163,179,683,179,179
1073,2011-02-17,Spring,2011,Feb,10,0,Thursday,1,Clear,0.38,0.3939,0.54,0.194,18,70,88,683,88,88
1074,2011-02-17,Spring,2011,Feb,11,0,Thursday,1,Misty,0.44,0.4394,0.44,0.2537,19,71,90,683,90,90
1075,2011-02-17,Spring,2011,Feb,12,0,Thursday,1,Clear,0.48,0.4697,0.41,0.2239,15,86,101,683,101,101
1076,2011-02-17,Spring,2011,Feb,13,0,Thursday,1,Clear,0.54,0.5152,0.34,0.2239,15,108,123,683,123,123
1077,2011-02-17,Spring,2011,Feb,14,0,Thursday,1,Clear,0.6,0.6212,0.31,0.2239,26,55,81,683,81,81
1078,2011-02-17,Spring,2011,Feb,15,0,Thursday,1,Clear,0.6,0.6061,0.28,0.2537,15,91,106,683,106,106
1079,2011-02-17,Spring,2011,Feb,16,0,Thursday,1,Misty,0.56,0.5303,0.35,0.2985,29,117,146,683,146,146
1080,2011-02-17,Spring,2011,Feb,17,0,Thursday,1,Misty,0.58,0.5455,0.32,0.2985,18,256,274,683,274,274
1081,2011-02-17,Spring,2011,Feb,18,0,Thursday,1,Misty,0.54,0.5152,0.42,0.2836,11,211,222,683,222,222
1082,2011-02-17,Spring,2011,Feb,19,0,Thursday,1,Clear,0.48,0.4697,0.55,0.3284,14,161,175,683,175,175
1083,2011-02-17,Spring,2011,Feb,20,0,Thursday,1,Clear,0.48,0.4697,0.59,0.3284,8,131,139,683,139,139
1084,2011-02-17,Spring,2011,Feb,21,0,Thursday,1,Clear,0.52,0.5,0.55,0.3881,5,119,124,683,124,124
1085,2011-02-17,Spring,2011,Feb,22,0,Thursday,1,Clear,0.5,0.4848,0.59,0.2836,8,68,76,683,76,76
1086,2011-02-17,Spring,2011,Feb,23,0,Thursday,1,Clear,0.46,0.4545,0.67,0.2985,4,40,44,683,44,44
1087,2011-02-18,Spring,2011,Feb,0,0,Friday,1,Clear,0.44,0.4394,0.72,0.2836,12,20,32,682,32,32
1088,2011-02-18,Spring,2011,Feb,1,0,Friday,1,Clear,0.44,0.4394,0.72,0.2239,1,7,8,682,8,8
1089,2011-02-18,Spring,2011,Feb,2,0,Friday,1,Clear,0.44,0.4394,0.72,0.2836,2,5,7,682,7,7
1090,2011-02-18,Spring,2011,Feb,3,0,Friday,1,Clear,0.46,0.4545,0.67,0.2537,2,6,8,682,8,8
1091,2011-02-18,Spring,2011,Feb,4,0,Friday,1,Clear,0.46,0.4545,0.67,0.2537,0,1,1,682,1,1
1092,2011-02-18,Spring,2011,Feb,5,0,Friday,1,Misty,0.46,0.4545,0.67,0.1045,1,6,7,682,7,7
1093,2011-02-18,Spring,2011,Feb,6,0,Friday,1,Misty,0.44,0.4394,0.72,0.1642,2,48,50,682,50,50
1094,2011-02-18,Spring,2011,Feb,7,0,Friday,1,Misty,0.42,0.4242,0.77,0.2239,8,108,116,682,116,116
1095,2011-02-18,Spring,2011,Feb,8,0,Friday,1,Misty,0.42,0.4242,0.77,0.194,26,246,272,682,272,272
1096,2011-02-18,Spring,2011,Feb,9,0,Friday,1,Misty,0.42,0.4242,0.77,0.194,15,154,169,682,169,169
1097,2011-02-18,Spring,2011,Feb,10,0,Friday,1,Misty,0.44,0.4394,0.72,0.2239,17,78,95,682,95,95
1098,2011-02-18,Spring,2011,Feb,11,0,Friday,1,Clear,0.44,0.4394,0.72,0.1642,31,82,113,682,113,113
1099,2011-02-18,Spring,2011,Feb,12,0,Friday,1,Clear,0.5,0.4848,0.59,0.194,59,126,185,682,185,185
1100,2011-02-18,Spring,2011,Feb,13,0,Friday,1,Clear,0.6,0.6212,0.43,0.194,45,131,176,682,176,176
1101,2011-02-18,Spring,2011,Feb,14,0,Friday,1,Clear,0.66,0.6212,0.36,0.2985,73,118,191,682,191,191
1102,2011-02-18,Spring,2011,Feb,15,0,Friday,1,Clear,0.66,0.6212,0.36,0.3284,55,117,172,682,172,172
1103,2011-02-18,Spring,2011,Feb,16,0,Friday,1,Clear,0.66,0.6212,0.36,0.2836,68,164,232,682,232,232
1104,2011-02-18,Spring,2011,Feb,17,0,Friday,1,Clear,0.66,0.6212,0.34,0.3582,52,275,327,682,327,327
1105,2011-02-18,Spring,2011,Feb,18,0,Friday,1,Clear,0.64,0.6212,0.33,0.3284,29,195,224,682,224,224
1106,2011-02-18,Spring,2011,Feb,19,0,Friday,1,Clear,0.62,0.6212,0.29,0.5821,16,146,162,682,162,162
1107,2011-02-18,Spring,2011,Feb,20,0,Friday,1,Clear,0.6,0.6212,0.31,0.194,19,105,124,682,124,124
1108,2011-02-18,Spring,2011,Feb,21,0,Friday,1,Clear,0.58,0.5455,0.21,0.4925,11,61,72,682,72,72
1109,2011-02-18,Spring,2011,Feb,22,0,Friday,1,Clear,0.54,0.5152,0.1,0.2537,19,88,107,682,107,107
1110,2011-02-18,Spring,2011,Feb,23,0,Friday,1,Clear,0.52,0.5,0.08,0.2836,16,61,77,682,77,77
1111,2011-02-19,Spring,2011,Feb,0,0,Saturday,0,Clear,0.48,0.4697,0.12,0.4925,6,23,29,681,29,29
1112,2011-02-19,Spring,2011,Feb,1,0,Saturday,0,Clear,0.46,0.4545,0.14,0.4179,10,21,31,681,31,31
1113,2011-02-19,Spring,2011,Feb,2,0,Saturday,0,Clear,0.44,0.4394,0.13,0.3881,3,14,17,681,17,17
1114,2011-02-19,Spring,2011,Feb,3,0,Saturday,0,Clear,0.42,0.4242,0.14,0.2985,0,7,7,681,7,7
1115,2011-02-19,Spring,2011,Feb,4,0,Saturday,0,Clear,0.4,0.4091,0.15,0.3284,0,3,3,681,3,3
1116,2011-02-19,Spring,2011,Feb,5,0,Saturday,0,Clear,0.4,0.4091,0.15,0.3284,0,3,3,681,3,3
1117,2011-02-19,Spring,2011,Feb,6,0,Saturday,0,Clear,0.4,0.4091,0.17,0.4179,3,3,6,681,6,6
1118,2011-02-19,Spring,2011,Feb,7,0,Saturday,0,Clear,0.38,0.3939,0.17,0.5224,6,16,22,681,22,22
1119,2011-02-19,Spring,2011,Feb,8,0,Saturday,0,Clear,0.38,0.3939,0.17,0.5821,9,36,45,681,45,45
1120,2011-02-19,Spring,2011,Feb,9,0,Saturday,0,Clear,0.4,0.4091,0.16,0.6567,18,37,55,681,55,55
1121,2011-02-19,Spring,2011,Feb,10,0,Saturday,0,Clear,0.42,0.4242,0.16,0.5821,34,72,106,681,106,106
1122,2011-02-19,Spring,2011,Feb,11,0,Saturday,0,Clear,0.44,0.4394,0.16,0.5821,47,76,123,681,123,123
1123,2011-02-19,Spring,2011,Feb,12,0,Saturday,0,Clear,0.44,0.4394,0.18,0.4925,38,81,119,681,119,119
1124,2011-02-19,Spring,2011,Feb,13,0,Saturday,0,Clear,0.44,0.4394,0.16,0.6119,52,103,155,681,155,155
1125,2011-02-19,Spring,2011,Feb,14,0,Saturday,0,Clear,0.46,0.4545,0.15,0.6567,102,94,196,681,196,196
1126,2011-02-19,Spring,2011,Feb,15,0,Saturday,0,Clear,0.44,0.4394,0.16,0.7463,84,87,171,681,171,171
1127,2011-02-19,Spring,2011,Feb,16,0,Saturday,0,Clear,0.44,0.4394,0.16,0.6418,39,81,120,681,120,120
1128,2011-02-19,Spring,2011,Feb,17,0,Saturday,0,Clear,0.42,0.4242,0.19,0.6119,36,91,127,681,127,127
1129,2011-02-19,Spring,2011,Feb,18,0,Saturday,0,Clear,0.36,0.3182,0.25,0.4478,21,67,88,681,88,88
1130,2011-02-19,Spring,2011,Feb,19,0,Saturday,0,Clear,0.34,0.303,0.29,0.3582,5,54,59,681,59,59
1131,2011-02-19,Spring,2011,Feb,20,0,Saturday,0,Clear,0.32,0.2879,0.28,0.5224,9,38,47,681,47,47
1132,2011-02-19,Spring,2011,Feb,21,0,Saturday,0,Clear,0.32,0.2727,0.26,0.5522,4,29,33,681,33,33
1133,2011-02-19,Spring,2011,Feb,22,0,Saturday,0,Clear,0.3,0.2576,0.28,0.4925,2,42,44,681,44,44
1134,2011-02-19,Spring,2011,Feb,23,0,Saturday,0,Clear,0.28,0.2424,0.33,0.4478,4,25,29,681,29,29
1135,2011-02-20,Spring,2011,Feb,0,0,Sunday,0,Clear,0.26,0.2121,0.35,0.4478,3,14,17,680,17,17
1136,2011-02-20,Spring,2011,Feb,1,0,Sunday,0,Clear,0.24,0.197,0.41,0.4627,5,11,16,680,16,16
1137,2011-02-20,Spring,2011,Feb,2,0,Sunday,0,Clear,0.24,0.197,0.41,0.5522,0,17,17,680,17,17
1138,2011-02-20,Spring,2011,Feb,3,0,Sunday,0,Clear,0.22,0.1818,0.44,0.5522,9,9,18,680,18,18
1139,2011-02-20,Spring,2011,Feb,4,0,Sunday,0,Clear,0.22,0.1818,0.44,0.5522,0,1,1,680,1,1
1140,2011-02-20,Spring,2011,Feb,6,0,Sunday,0,Clear,0.2,0.1818,0.47,0.2985,1,1,2,680,2,2
1141,2011-02-20,Spring,2011,Feb,7,0,Sunday,0,Clear,0.18,0.1667,0.51,0.2537,0,2,2,680,2,2
1142,2011-02-20,Spring,2011,Feb,8,0,Sunday,0,Clear,0.2,0.2273,0.51,0.1045,2,22,24,680,24,24
1143,2011-02-20,Spring,2011,Feb,9,0,Sunday,0,Clear,0.22,0.2121,0.47,0.2836,7,48,55,680,55,55
1144,2011-02-20,Spring,2011,Feb,10,0,Sunday,0,Misty,0.26,0.2576,0.41,0.194,34,70,104,680,104,104
1145,2011-02-20,Spring,2011,Feb,11,0,Sunday,0,Misty,0.3,0.303,0.33,0.1642,72,89,161,680,161,161
1146,2011-02-20,Spring,2011,Feb,12,0,Sunday,0,Clear,0.3,0.3182,0.33,0.1045,62,120,182,680,182,182
1147,2011-02-20,Spring,2011,Feb,13,0,Sunday,0,Clear,0.34,0.3333,0.29,0.0,76,122,198,680,198,198
1148,2011-02-20,Spring,2011,Feb,14,0,Sunday,0,Clear,0.36,0.3485,0.27,0.1642,108,104,212,680,212,212
1149,2011-02-20,Spring,2011,Feb,15,0,Sunday,0,Clear,0.36,0.3636,0.27,0.0896,66,102,168,680,168,168
1150,2011-02-20,Spring,2011,Feb,16,0,Sunday,0,Clear,0.36,0.3636,0.29,0.0896,59,88,147,680,147,147
1151,2011-02-20,Spring,2011,Feb,17,0,Sunday,0,Clear,0.34,0.3485,0.33,0.1642,60,86,146,680,146,146
1152,2011-02-20,Spring,2011,Feb,18,0,Sunday,0,Misty,0.34,0.3333,0.36,0.1343,30,71,101,680,101,101
1153,2011-02-20,Spring,2011,Feb,19,0,Sunday,0,Misty,0.34,0.3333,0.36,0.1343,3,39,42,680,42,42
1154,2011-02-20,Spring,2011,Feb,20,0,Sunday,0,Misty,0.34,0.3636,0.42,0.0,12,30,42,680,42,42
1155,2011-02-20,Spring,2011,Feb,21,0,Sunday,0,Misty,0.32,0.3485,0.53,0.0,17,39,56,680,56,56
1156,2011-02-20,Spring,2011,Feb,22,0,Sunday,0,Misty,0.32,0.303,0.57,0.2239,4,43,47,680,47,47
1157,2011-02-20,Spring,2011,Feb,23,0,Sunday,0,Misty,0.3,0.303,0.61,0.1642,9,45,54,680,54,54
1158,2011-02-21,Spring,2011,Feb,0,1,Monday,0,Misty,0.34,0.303,0.42,0.3284,7,30,37,679,37,37
1159,2011-02-21,Spring,2011,Feb,1,1,Monday,0,Misty,0.34,0.303,0.42,0.3284,2,11,13,679,13,13
1160,2011-02-21,Spring,2011,Feb,2,1,Monday,0,Misty,0.34,0.303,0.42,0.3284,1,3,4,679,4,4
1161,2011-02-21,Spring,2011,Feb,3,1,Monday,0,Misty,0.34,0.303,0.42,0.2985,2,3,5,679,5,5
1162,2011-02-21,Spring,2011,Feb,4,1,Monday,0,Clear,0.32,0.3182,0.45,0.1642,1,0,1,679,1,1
1163,2011-02-21,Spring,2011,Feb,5,1,Monday,0,Misty,0.34,0.3636,0.36,0.0,1,2,3,679,3,3
1164,2011-02-21,Spring,2011,Feb,6,1,Monday,0,Misty,0.42,0.4242,0.26,0.2985,2,6,8,679,8,8
1165,2011-02-21,Spring,2011,Feb,7,1,Monday,0,Misty,0.42,0.4242,0.26,0.2836,3,16,19,679,19,19
1166,2011-02-21,Spring,2011,Feb,8,1,Monday,0,Misty,0.32,0.303,0.57,0.2985,7,56,63,679,63,63
1167,2011-02-21,Spring,2011,Feb,9,1,Monday,0,Misty,0.32,0.303,0.57,0.2836,11,46,57,679,57,57
1168,2011-02-21,Spring,2011,Feb,10,1,Monday,0,Misty,0.32,0.303,0.57,0.2537,29,52,81,679,81,81
1169,2011-02-21,Spring,2011,Feb,11,1,Monday,0,Misty,0.32,0.3333,0.57,0.1045,20,70,90,679,90,90
1170,2011-02-21,Spring,2011,Feb,12,1,Monday,0,Misty,0.32,0.3182,0.66,0.194,26,67,93,679,93,93
1171,2011-02-21,Spring,2011,Feb,13,1,Monday,0,Light_rainsnow,0.3,0.2727,0.81,0.3284,28,75,103,679,103,103
1172,2011-02-21,Spring,2011,Feb,14,1,Monday,0,Misty,0.32,0.303,0.76,0.2537,15,101,116,679,116,116
1173,2011-02-21,Spring,2011,Feb,15,1,Monday,0,Misty,0.3,0.2727,0.7,0.4478,11,76,87,679,87,87
1174,2011-02-21,Spring,2011,Feb,16,1,Monday,0,Light_rainsnow,0.28,0.2424,0.75,0.4179,8,48,56,679,56,56
1175,2011-02-21,Spring,2011,Feb,17,1,Monday,0,Misty,0.28,0.2576,0.75,0.3881,18,62,80,679,80,80
1176,2011-02-21,Spring,2011,Feb,18,1,Monday,0,Misty,0.24,0.2121,0.87,0.3582,2,64,66,679,66,66
1177,2011-02-21,Spring,2011,Feb,19,1,Monday,0,Misty,0.24,0.2121,0.87,0.3582,0,49,49,679,49,49
1178,2011-02-21,Spring,2011,Feb,20,1,Monday,0,Light_rainsnow,0.24,0.2121,0.81,0.3881,0,29,29,679,29,29
1179,2011-02-21,Spring,2011,Feb,21,1,Monday,0,Light_rainsnow,0.22,0.197,0.75,0.4478,1,33,34,679,34,34
1180,2011-02-21,Spring,2011,Feb,22,1,Monday,0,Light_rainsnow,0.2,0.1667,0.75,0.4179,0,11,11,679,11,11
1181,2011-02-21,Spring,2011,Feb,23,1,Monday,0,Light_rainsnow,0.2,0.1667,0.75,0.4179,0,2,2,679,2,2
1182,2011-02-22,Spring,2011,Feb,6,0,Tuesday,1,Misty,0.12,0.1212,0.8,0.2836,0,7,7,678,7,7
1183,2011-02-22,Spring,2011,Feb,7,0,Tuesday,1,Misty,0.12,0.1212,0.8,0.2836,0,40,40,678,40,40
1184,2011-02-22,Spring,2011,Feb,8,0,Tuesday,1,Misty,0.12,0.1212,0.8,0.2537,7,107,114,678,114,114
1185,2011-02-22,Spring,2011,Feb,9,0,Tuesday,1,Misty,0.14,0.1212,0.74,0.2537,5,101,106,678,106,106
1186,2011-02-22,Spring,2011,Feb,10,0,Tuesday,1,Clear,0.16,0.1818,0.69,0.0,0,44,44,678,44,44
1187,2011-02-22,Spring,2011,Feb,11,0,Tuesday,1,Clear,0.16,0.2273,0.64,0.0,7,43,50,678,50,50
1188,2011-02-22,Spring,2011,Feb,12,0,Tuesday,1,Clear,0.2,0.2273,0.59,0.1045,7,48,55,678,55,55
1189,2011-02-22,Spring,2011,Feb,13,0,Tuesday,1,Clear,0.22,0.2273,0.55,0.1642,3,52,55,678,55,55
1190,2011-02-22,Spring,2011,Feb,14,0,Tuesday,1,Clear,0.22,0.2273,0.55,0.194,9,49,58,678,58,58
1191,2011-02-22,Spring,2011,Feb,15,0,Tuesday,1,Clear,0.24,0.2273,0.48,0.194,2,67,69,678,69,69
1192,2011-02-22,Spring,2011,Feb,16,0,Tuesday,1,Clear,0.22,0.2273,0.51,0.1642,7,79,86,678,86,86
1193,2011-02-22,Spring,2011,Feb,17,0,Tuesday,1,Clear,0.22,0.2121,0.51,0.2239,8,188,196,678,196,196
1194,2011-02-22,Spring,2011,Feb,18,0,Tuesday,1,Clear,0.22,0.2273,0.47,0.1343,6,161,167,678,167,167
1195,2011-02-22,Spring,2011,Feb,19,0,Tuesday,1,Clear,0.2,0.1818,0.47,0.2836,4,114,118,678,118,118
1196,2011-02-22,Spring,2011,Feb,20,0,Tuesday,1,Clear,0.2,0.197,0.47,0.2239,3,102,105,678,105,105
1197,2011-02-22,Spring,2011,Feb,21,0,Tuesday,1,Clear,0.2,0.197,0.47,0.2537,2,80,82,678,82,82
1198,2011-02-22,Spring,2011,Feb,22,0,Tuesday,1,Clear,0.16,0.1515,0.43,0.2537,1,76,77,678,77,77
1199,2011-02-22,Spring,2011,Feb,23,0,Tuesday,1,Clear,0.16,0.1515,0.43,0.2537,3,18,21,678,21,21
1200,2011-02-23,Spring,2011,Feb,0,0,Wednesday,1,Clear,0.14,0.1364,0.5,0.194,0,6,6,677,6,6
1201,2011-02-23,Spring,2011,Feb,1,0,Wednesday,1,Clear,0.14,0.1515,0.46,0.1642,0,4,4,677,4,4
1202,2011-02-23,Spring,2011,Feb,2,0,Wednesday,1,Clear,0.12,0.1515,0.5,0.1343,0,1,1,677,1,1
1203,2011-02-23,Spring,2011,Feb,3,0,Wednesday,1,Clear,0.12,0.1364,0.5,0.1642,0,2,2,677,2,2
1204,2011-02-23,Spring,2011,Feb,5,0,Wednesday,1,Clear,0.12,0.1515,0.5,0.1045,0,8,8,677,8,8
1205,2011-02-23,Spring,2011,Feb,6,0,Wednesday,1,Clear,0.12,0.1515,0.5,0.1045,0,36,36,677,36,36
1206,2011-02-23,Spring,2011,Feb,7,0,Wednesday,1,Clear,0.12,0.1515,0.54,0.1343,2,94,96,677,96,96
1207,2011-02-23,Spring,2011,Feb,8,0,Wednesday,1,Clear,0.14,0.1515,0.54,0.1642,8,227,235,677,235,235
1208,2011-02-23,Spring,2011,Feb,9,0,Wednesday,1,Clear,0.18,0.2121,0.51,0.0896,9,130,139,677,139,139
1209,2011-02-23,Spring,2011,Feb,10,0,Wednesday,1,Clear,0.2,0.2576,0.4,0.0,4,47,51,677,51,51
1210,2011-02-23,Spring,2011,Feb,11,0,Wednesday,1,Clear,0.24,0.2576,0.41,0.1045,16,53,69,677,69,69
1211,2011-02-23,Spring,2011,Feb,12,0,Wednesday,1,Clear,0.26,0.2879,0.35,0.0896,11,56,67,677,67,67
1212,2011-02-23,Spring,2011,Feb,13,0,Wednesday,1,Clear,0.3,0.3182,0.28,0.0896,9,78,87,677,87,87
1213,2011-02-23,Spring,2011,Feb,14,0,Wednesday,1,Clear,0.32,0.3333,0.29,0.1045,17,61,78,677,78,78
1214,2011-02-23,Spring,2011,Feb,15,0,Wednesday,1,Clear,0.34,0.3485,0.25,0.0896,18,54,72,677,72,72
1215,2011-02-23,Spring,2011,Feb,16,0,Wednesday,1,Clear,0.34,0.3636,0.25,0.0,15,79,94,677,94,94
1216,2011-02-23,Spring,2011,Feb,17,0,Wednesday,1,Clear,0.34,0.3485,0.25,0.0896,15,207,222,677,222,222
1217,2011-02-23,Spring,2011,Feb,18,0,Wednesday,1,Clear,0.32,0.3333,0.26,0.0896,3,206,209,677,209,209
1218,2011-02-23,Spring,2011,Feb,19,0,Wednesday,1,Clear,0.3,0.3333,0.33,0.0,6,135,141,677,141,141
1219,2011-02-23,Spring,2011,Feb,20,0,Wednesday,1,Clear,0.24,0.2424,0.6,0.1642,2,107,109,677,109,109
1220,2011-02-23,Spring,2011,Feb,21,0,Wednesday,1,Clear,0.24,0.2879,0.48,0.0,2,89,91,677,91,91
1221,2011-02-23,Spring,2011,Feb,22,0,Wednesday,1,Clear,0.24,0.2879,0.48,0.0,1,60,61,677,61,61
1222,2011-02-23,Spring,2011,Feb,23,0,Wednesday,1,Clear,0.22,0.2576,0.55,0.0896,1,38,39,677,39,39
1223,2011-02-24,Spring,2011,Feb,0,0,Thursday,1,Clear,0.22,0.2576,0.55,0.0896,0,11,11,676,11,11
1224,2011-02-24,Spring,2011,Feb,1,0,Thursday,1,Clear,0.22,0.2576,0.6,0.0896,0,7,7,676,7,7
1225,2011-02-24,Spring,2011,Feb,2,0,Thursday,1,Clear,0.2,0.2273,0.64,0.0896,0,4,4,676,4,4
1226,2011-02-24,Spring,2011,Feb,3,0,Thursday,1,Clear,0.2,0.2121,0.64,0.1343,0,2,2,676,2,2
1227,2011-02-24,Spring,2011,Feb,5,0,Thursday,1,Clear,0.2,0.2121,0.69,0.1343,1,3,4,676,4,4
1228,2011-02-24,Spring,2011,Feb,6,0,Thursday,1,Clear,0.2,0.197,0.69,0.194,0,58,58,676,58,58
1229,2011-02-24,Spring,2011,Feb,7,0,Thursday,1,Clear,0.2,0.197,0.72,0.194,0,104,104,676,104,104
1230,2011-02-24,Spring,2011,Feb,8,0,Thursday,1,Clear,0.24,0.2273,0.7,0.2239,8,244,252,676,252,252
1231,2011-02-24,Spring,2011,Feb,9,0,Thursday,1,Misty,0.24,0.2121,0.75,0.2985,4,133,137,676,137,137
1232,2011-02-24,Spring,2011,Feb,10,0,Thursday,1,Misty,0.26,0.2424,0.7,0.2836,8,49,57,676,57,57
1233,2011-02-24,Spring,2011,Feb,11,0,Thursday,1,Misty,0.32,0.2879,0.57,0.3881,8,71,79,676,79,79
1234,2011-02-24,Spring,2011,Feb,12,0,Thursday,1,Misty,0.36,0.3333,0.53,0.3582,10,85,95,676,95,95
1235,2011-02-24,Spring,2011,Feb,13,0,Thursday,1,Misty,0.38,0.3939,0.54,0.2985,16,72,88,676,88,88
1236,2011-02-24,Spring,2011,Feb,14,0,Thursday,1,Misty,0.4,0.4091,0.5,0.2985,2,67,69,676,69,69
1237,2011-02-24,Spring,2011,Feb,15,0,Thursday,1,Light_rainsnow,0.4,0.4091,0.54,0.3881,5,58,63,676,63,63
1238,2011-02-24,Spring,2011,Feb,16,0,Thursday,1,Light_rainsnow,0.38,0.3939,0.62,0.2836,4,67,71,676,71,71
1239,2011-02-24,Spring,2011,Feb,17,0,Thursday,1,Light_rainsnow,0.36,0.3485,0.66,0.194,9,168,177,676,177,177
1240,2011-02-24,Spring,2011,Feb,18,0,Thursday,1,Misty,0.34,0.303,0.87,0.3284,5,132,137,676,137,137
1241,2011-02-24,Spring,2011,Feb,19,0,Thursday,1,Light_rainsnow,0.34,0.303,0.93,0.2985,3,112,115,676,115,115
1242,2011-02-24,Spring,2011,Feb,20,0,Thursday,1,Misty,0.34,0.303,0.93,0.3582,2,87,89,676,89,89
1243,2011-02-24,Spring,2011,Feb,21,0,Thursday,1,Misty,0.34,0.303,0.87,0.3284,7,76,83,676,83,83
1244,2011-02-24,Spring,2011,Feb,22,0,Thursday,1,Light_rainsnow,0.34,0.3182,0.87,0.2836,5,50,55,676,55,55
1245,2011-02-24,Spring,2011,Feb,23,0,Thursday,1,Misty,0.32,0.303,0.93,0.2239,3,47,50,676,50,50
1246,2011-02-25,Spring,2011,Feb,0,0,Friday,1,Light_rainsnow,0.32,0.3485,0.93,0.0,1,8,9,675,9,9
1247,2011-02-25,Spring,2011,Feb,1,0,Friday,1,Misty,0.32,0.3485,1.0,0.0,1,9,10,675,10,10
1248,2011-02-25,Spring,2011,Feb,2,0,Friday,1,Misty,0.32,0.3485,1.0,0.0,0,3,3,675,3,3
1249,2011-02-25,Spring,2011,Feb,3,0,Friday,1,Misty,0.32,0.3333,0.93,0.1045,1,1,2,675,2,2
1250,2011-02-25,Spring,2011,Feb,5,0,Friday,1,Misty,0.32,0.3333,0.93,0.1045,1,5,6,675,6,6
1251,2011-02-25,Spring,2011,Feb,6,0,Friday,1,Light_rainsnow,0.34,0.3485,0.93,0.0896,0,11,11,675,11,11
1252,2011-02-25,Spring,2011,Feb,7,0,Friday,1,Light_rainsnow,0.34,0.3333,1.0,0.1343,1,34,35,675,35,35
1253,2011-02-25,Spring,2011,Feb,8,0,Friday,1,Light_rainsnow,0.36,0.3485,0.93,0.1343,3,70,73,675,73,73
1254,2011-02-25,Spring,2011,Feb,9,0,Friday,1,Light_rainsnow,0.34,0.303,0.93,0.3582,3,111,114,675,114,114
1255,2011-02-25,Spring,2011,Feb,10,0,Friday,1,Light_rainsnow,0.42,0.4242,0.94,0.3284,7,42,49,675,49,49
1256,2011-02-25,Spring,2011,Feb,11,0,Friday,1,Clear,0.52,0.5,0.77,0.4478,9,50,59,675,59,59
1257,2011-02-25,Spring,2011,Feb,12,0,Friday,1,Light_rainsnow,0.54,0.5152,0.6,0.4627,20,95,115,675,115,115
1258,2011-02-25,Spring,2011,Feb,13,0,Friday,1,Light_rainsnow,0.54,0.5152,0.6,0.4627,6,77,83,675,83,83
1259,2011-02-25,Spring,2011,Feb,14,0,Friday,1,Light_rainsnow,0.56,0.5303,0.56,0.6119,14,71,85,675,85,85
1260,2011-02-25,Spring,2011,Feb,15,0,Friday,1,Clear,0.46,0.4545,0.41,0.806,5,50,55,675,55,55
1261,2011-02-25,Spring,2011,Feb,16,0,Friday,1,Clear,0.32,0.2879,0.49,0.4627,11,91,102,675,102,102
1262,2011-02-25,Spring,2011,Feb,17,0,Friday,1,Clear,0.32,0.2727,0.49,0.7463,8,181,189,675,189,189
1263,2011-02-25,Spring,2011,Feb,18,0,Friday,1,Clear,0.32,0.2879,0.49,0.4925,7,150,157,675,157,157
1264,2011-02-25,Spring,2011,Feb,19,0,Friday,1,Clear,0.3,0.2727,0.52,0.4478,4,86,90,675,90,90
1265,2011-02-25,Spring,2011,Feb,20,0,Friday,1,Clear,0.3,0.2576,0.49,0.6119,2,60,62,675,62,62
1266,2011-02-25,Spring,2011,Feb,21,0,Friday,1,Clear,0.28,0.2576,0.48,0.3881,7,56,63,675,63,63
1267,2011-02-25,Spring,2011,Feb,22,0,Friday,1,Clear,0.26,0.2121,0.48,0.4478,7,43,50,675,50,50
1268,2011-02-25,Spring,2011,Feb,23,0,Friday,1,Clear,0.26,0.2273,0.48,0.3284,2,37,39,675,39,39
1269,2011-02-26,Spring,2011,Feb,0,0,Saturday,0,Clear,0.24,0.2273,0.52,0.194,3,25,28,674,28,28
1270,2011-02-26,Spring,2011,Feb,1,0,Saturday,0,Clear,0.24,0.2121,0.52,0.2985,2,25,27,674,27,27
1271,2011-02-26,Spring,2011,Feb,2,0,Saturday,0,Clear,0.22,0.197,0.6,0.3582,3,9,12,674,12,12
1272,2011-02-26,Spring,2011,Feb,3,0,Saturday,0,Clear,0.22,0.2273,0.55,0.1343,1,7,8,674,8,8
1273,2011-02-26,Spring,2011,Feb,4,0,Saturday,0,Misty,0.22,0.2576,0.6,0.0896,1,1,2,674,2,2
1274,2011-02-26,Spring,2011,Feb,5,0,Saturday,0,Misty,0.22,0.2424,0.64,0.1045,1,9,10,674,10,10
1275,2011-02-26,Spring,2011,Feb,6,0,Saturday,0,Clear,0.22,0.2727,0.6,0.0,1,6,7,674,7,7
1276,2011-02-26,Spring,2011,Feb,7,0,Saturday,0,Clear,0.22,0.2576,0.6,0.0896,1,21,22,674,22,22
1277,2011-02-26,Spring,2011,Feb,8,0,Saturday,0,Misty,0.24,0.2879,0.6,0.0,2,55,57,674,57,57
1278,2011-02-26,Spring,2011,Feb,9,0,Saturday,0,Misty,0.26,0.2576,0.56,0.1642,9,65,74,674,74,74
1279,2011-02-26,Spring,2011,Feb,10,0,Saturday,0,Misty,0.3,0.303,0.49,0.1343,14,71,85,674,85,85
1280,2011-02-26,Spring,2011,Feb,11,0,Saturday,0,Clear,0.3,0.3333,0.45,0.0,26,100,126,674,126,126
1281,2011-02-26,Spring,2011,Feb,12,0,Saturday,0,Misty,0.32,0.3182,0.45,0.1642,45,115,160,674,160,160
1282,2011-02-26,Spring,2011,Feb,13,0,Saturday,0,Misty,0.34,0.3182,0.42,0.2537,38,136,174,674,174,174
1283,2011-02-26,Spring,2011,Feb,14,0,Saturday,0,Misty,0.34,0.303,0.36,0.3284,57,154,211,674,211,211
1284,2011-02-26,Spring,2011,Feb,15,0,Saturday,0,Misty,0.36,0.3333,0.4,0.2836,40,125,165,674,165,165
1285,2011-02-26,Spring,2011,Feb,16,0,Saturday,0,Clear,0.36,0.3333,0.46,0.2836,41,130,171,674,171,171
1286,2011-02-26,Spring,2011,Feb,17,0,Saturday,0,Clear,0.36,0.3485,0.43,0.2239,53,130,183,674,183,183
1287,2011-02-26,Spring,2011,Feb,18,0,Saturday,0,Clear,0.34,0.3333,0.46,0.194,26,111,137,674,137,137
1288,2011-02-26,Spring,2011,Feb,19,0,Saturday,0,Clear,0.32,0.303,0.49,0.2537,30,64,94,674,94,94
1289,2011-02-26,Spring,2011,Feb,20,0,Saturday,0,Clear,0.3,0.303,0.56,0.1642,8,60,68,674,68,68
1290,2011-02-26,Spring,2011,Feb,21,0,Saturday,0,Clear,0.28,0.2727,0.65,0.2537,9,59,68,674,68,68
1291,2011-02-26,Spring,2011,Feb,22,0,Saturday,0,Clear,0.28,0.2727,0.75,0.2239,8,38,46,674,46,46
1292,2011-02-26,Spring,2011,Feb,23,0,Saturday,0,Clear,0.28,0.2576,0.75,0.2836,5,29,34,674,34,34
1293,2011-02-27,Spring,2011,Feb,0,0,Sunday,0,Clear,0.26,0.2424,0.87,0.2836,8,26,34,673,34,34
1294,2011-02-27,Spring,2011,Feb,1,0,Sunday,0,Clear,0.26,0.2576,0.87,0.194,7,30,37,673,37,37
1295,2011-02-27,Spring,2011,Feb,2,0,Sunday,0,Clear,0.26,0.2727,0.87,0.1343,2,20,22,673,22,22
1296,2011-02-27,Spring,2011,Feb,3,0,Sunday,0,Clear,0.26,0.2879,0.87,0.0896,3,8,11,673,11,11
1297,2011-02-27,Spring,2011,Feb,4,0,Sunday,0,Clear,0.24,0.2424,0.87,0.1343,0,2,2,673,2,2
1298,2011-02-27,Spring,2011,Feb,6,0,Sunday,0,Clear,0.24,0.2879,0.87,0.0,2,1,3,673,3,3
1299,2011-02-27,Spring,2011,Feb,7,0,Sunday,0,Clear,0.24,0.2424,0.87,0.1343,6,8,14,673,14,14
1300,2011-02-27,Spring,2011,Feb,8,0,Sunday,0,Clear,0.26,0.303,0.87,0.0,9,26,35,673,35,35
1301,2011-02-27,Spring,2011,Feb,9,0,Sunday,0,Clear,0.28,0.303,0.87,0.0896,17,42,59,673,59,59
1302,2011-02-27,Spring,2011,Feb,10,0,Sunday,0,Clear,0.3,0.303,0.81,0.1642,24,79,103,673,103,103
1303,2011-02-27,Spring,2011,Feb,11,0,Sunday,0,Clear,0.36,0.3485,0.62,0.1343,33,92,125,673,125,125
1304,2011-02-27,Spring,2011,Feb,12,0,Sunday,0,Clear,0.4,0.4091,0.54,0.0896,61,132,193,673,193,193
1305,2011-02-27,Spring,2011,Feb,13,0,Sunday,0,Clear,0.42,0.4242,0.47,0.0,90,169,259,673,259,259
1306,2011-02-27,Spring,2011,Feb,14,0,Sunday,0,Clear,0.44,0.4394,0.47,0.0896,105,177,282,673,282,282
1307,2011-02-27,Spring,2011,Feb,15,0,Sunday,0,Clear,0.46,0.4545,0.44,0.1343,98,163,261,673,261,261
1308,2011-02-27,Spring,2011,Feb,16,0,Sunday,0,Clear,0.48,0.4697,0.44,0.1642,98,170,268,673,268,268
1309,2011-02-27,Spring,2011,Feb,17,0,Sunday,0,Clear,0.42,0.4242,0.54,0.194,66,121,187,673,187,187
1310,2011-02-27,Spring,2011,Feb,18,0,Sunday,0,Clear,0.4,0.4091,0.54,0.194,24,103,127,673,127,127
1311,2011-02-27,Spring,2011,Feb,19,0,Sunday,0,Clear,0.4,0.4091,0.54,0.1343,16,86,102,673,102,102
1312,2011-02-27,Spring,2011,Feb,20,0,Sunday,0,Clear,0.4,0.4091,0.54,0.0896,9,72,81,673,81,81
1313,2011-02-27,Spring,2011,Feb,21,0,Sunday,0,Clear,0.38,0.3939,0.62,0.1642,8,61,69,673,69,69
1314,2011-02-27,Spring,2011,Feb,22,0,Sunday,0,Misty,0.38,0.3939,0.62,0.1045,2,67,69,673,69,69
1315,2011-02-27,Spring,2011,Feb,23,0,Sunday,0,Misty,0.36,0.3485,0.62,0.1642,6,53,59,673,59,59
1316,2011-02-28,Spring,2011,Feb,0,0,Monday,1,Misty,0.36,0.3636,0.66,0.1045,5,25,30,672,30,30
1317,2011-02-28,Spring,2011,Feb,1,0,Monday,1,Light_rainsnow,0.34,0.303,0.87,0.3582,1,7,8,672,8,8
1318,2011-02-28,Spring,2011,Feb,3,0,Monday,1,Light_rainsnow,0.32,0.3182,0.93,0.1642,0,1,1,672,1,1
1319,2011-02-28,Spring,2011,Feb,5,0,Monday,1,Misty,0.34,0.3636,0.93,0.0,1,4,5,672,5,5
1320,2011-02-28,Spring,2011,Feb,6,0,Monday,1,Misty,0.34,0.3485,0.96,0.1045,1,27,28,672,28,28
1321,2011-02-28,Spring,2011,Feb,7,0,Monday,1,Misty,0.36,0.3636,0.93,0.1045,2,90,92,672,92,92
1322,2011-02-28,Spring,2011,Feb,8,0,Monday,1,Misty,0.34,0.303,0.93,0.2985,13,242,255,672,255,255
1323,2011-02-28,Spring,2011,Feb,9,0,Monday,1,Clear,0.42,0.4242,0.82,0.2836,15,127,142,672,142,142
1324,2011-02-28,Spring,2011,Feb,10,0,Monday,1,Misty,0.52,0.5,0.72,0.4925,13,79,92,672,92,92
1325,2011-02-28,Spring,2011,Feb,11,0,Monday,1,Misty,0.56,0.5303,0.64,0.2985,13,74,87,672,87,87
1326,2011-02-28,Spring,2011,Feb,12,0,Monday,1,Misty,0.56,0.5303,0.64,0.2985,0,36,36,672,36,36
1327,2011-02-28,Spring,2011,Feb,13,0,Monday,1,Light_rainsnow,0.46,0.4545,0.94,0.2239,1,31,32,672,32,32
1328,2011-02-28,Spring,2011,Feb,14,0,Monday,1,Light_rainsnow,0.42,0.4242,1.0,0.2985,1,24,25,672,25,25
1329,2011-02-28,Spring,2011,Feb,15,0,Monday,1,Light_rainsnow,0.42,0.4242,1.0,0.2985,0,35,35,672,35,35
1330,2011-02-28,Spring,2011,Feb,16,0,Monday,1,Light_rainsnow,0.42,0.4242,1.0,0.1343,2,40,42,672,42,42
1331,2011-02-28,Spring,2011,Feb,17,0,Monday,1,Light_rainsnow,0.4,0.4091,1.0,0.2985,2,77,79,672,79,79
1332,2011-02-28,Spring,2011,Feb,18,0,Monday,1,Light_rainsnow,0.46,0.4545,0.94,0.194,4,127,131,672,131,131
1333,2011-02-28,Spring,2011,Feb,19,0,Monday,1,Light_rainsnow,0.44,0.4394,0.88,0.6119,1,79,80,672,80,80
1334,2011-02-28,Spring,2011,Feb,20,0,Monday,1,Light_rainsnow,0.44,0.4394,0.88,0.6119,0,45,45,672,45,45
1335,2011-02-28,Spring,2011,Feb,21,0,Monday,1,Misty,0.38,0.3939,0.87,0.3881,2,78,80,672,80,80
1336,2011-02-28,Spring,2011,Feb,22,0,Monday,1,Light_rainsnow,0.34,0.303,0.93,0.4179,4,72,76,672,76,76
1337,2011-02-28,Spring,2011,Feb,23,0,Monday,1,Misty,0.32,0.2879,0.81,0.3881,0,45,45,672,45,45
1338,2011-03-01,Spring,2011,Mar,0,0,Tuesday,1,Clear,0.3,0.2727,0.7,0.4627,0,7,7,671,7,7
1339,2011-03-01,Spring,2011,Mar,1,0,Tuesday,1,Clear,0.26,0.2273,0.7,0.3582,0,3,3,671,3,3
1340,2011-03-01,Spring,2011,Mar,2,0,Tuesday,1,Clear,0.24,0.2121,0.65,0.3881,0,4,4,671,4,4
1341,2011-03-01,Spring,2011,Mar,3,0,Tuesday,1,Clear,0.22,0.2121,0.69,0.2836,0,2,2,671,2,2
1342,2011-03-01,Spring,2011,Mar,4,0,Tuesday,1,Clear,0.22,0.2121,0.69,0.2537,0,1,1,671,1,1
1343,2011-03-01,Spring,2011,Mar,5,0,Tuesday,1,Clear,0.2,0.1818,0.64,0.2836,1,1,2,671,2,2
1344,2011-03-01,Spring,2011,Mar,6,0,Tuesday,1,Clear,0.2,0.1818,0.59,0.2985,0,46,46,671,46,46
1345,2011-03-01,Spring,2011,Mar,7,0,Tuesday,1,Clear,0.2,0.1818,0.59,0.3284,2,105,107,671,107,107
1346,2011-03-01,Spring,2011,Mar,8,0,Tuesday,1,Clear,0.2,0.1818,0.59,0.3881,10,204,214,671,214,214
1347,2011-03-01,Spring,2011,Mar,9,0,Tuesday,1,Clear,0.22,0.197,0.55,0.4179,8,116,124,671,124,124
1348,2011-03-01,Spring,2011,Mar,10,0,Tuesday,1,Clear,0.24,0.2121,0.52,0.2836,13,55,68,671,68,68
1349,2011-03-01,Spring,2011,Mar,11,0,Tuesday,1,Clear,0.28,0.2727,0.45,0.2537,8,48,56,671,56,56
1350,2011-03-01,Spring,2011,Mar,12,0,Tuesday,1,Clear,0.3,0.303,0.39,0.1343,6,80,86,671,86,86
1351,2011-03-01,Spring,2011,Mar,13,0,Tuesday,1,Clear,0.32,0.3485,0.39,0.0,13,65,78,671,78,78
1352,2011-03-01,Spring,2011,Mar,14,0,Tuesday,1,Clear,0.32,0.3333,0.36,0.1343,18,61,79,671,79,79
1353,2011-03-01,Spring,2011,Mar,15,0,Tuesday,1,Clear,0.34,0.3636,0.34,0.0,7,57,64,671,64,64
1354,2011-03-01,Spring,2011,Mar,16,0,Tuesday,1,Clear,0.34,0.3485,0.34,0.0896,10,92,102,671,102,102
1355,2011-03-01,Spring,2011,Mar,17,0,Tuesday,1,Clear,0.34,0.3485,0.34,0.0896,12,230,242,671,242,242
1356,2011-03-01,Spring,2011,Mar,18,0,Tuesday,1,Clear,0.32,0.3182,0.39,0.194,10,214,224,671,224,224
1357,2011-03-01,Spring,2011,Mar,19,0,Tuesday,1,Clear,0.3,0.303,0.49,0.1343,4,115,119,671,119,119
1358,2011-03-01,Spring,2011,Mar,20,0,Tuesday,1,Clear,0.3,0.3182,0.61,0.0896,2,86,88,671,88,88
1359,2011-03-01,Spring,2011,Mar,21,0,Tuesday,1,Clear,0.26,0.303,0.56,0.0,8,55,63,671,63,63
1360,2011-03-01,Spring,2011,Mar,22,0,Tuesday,1,Clear,0.24,0.2727,0.62,0.1045,3,44,47,671,47,47
1361,2011-03-01,Spring,2011,Mar,23,0,Tuesday,1,Clear,0.24,0.2273,0.65,0.2239,2,23,25,671,25,25
1362,2011-03-02,Spring,2011,Mar,0,0,Wednesday,1,Clear,0.22,0.2273,0.69,0.1642,3,5,8,670,8,8
1363,2011-03-02,Spring,2011,Mar,1,0,Wednesday,1,Clear,0.22,0.2273,0.69,0.194,0,4,4,670,4,4
1364,2011-03-02,Spring,2011,Mar,2,0,Wednesday,1,Clear,0.22,0.2273,0.69,0.194,0,2,2,670,2,2
1365,2011-03-02,Spring,2011,Mar,3,0,Wednesday,1,Clear,0.22,0.2121,0.69,0.2836,3,1,4,670,4,4
1366,2011-03-02,Spring,2011,Mar,4,0,Wednesday,1,Clear,0.2,0.2121,0.75,0.1343,1,0,1,670,1,1
1367,2011-03-02,Spring,2011,Mar,5,0,Wednesday,1,Clear,0.22,0.2121,0.69,0.2239,0,5,5,670,5,5
1368,2011-03-02,Spring,2011,Mar,6,0,Wednesday,1,Clear,0.22,0.2121,0.55,0.2537,1,39,40,670,40,40
1369,2011-03-02,Spring,2011,Mar,7,0,Wednesday,1,Clear,0.22,0.2121,0.64,0.2537,2,108,110,670,110,110
1370,2011-03-02,Spring,2011,Mar,8,0,Wednesday,1,Clear,0.24,0.2121,0.65,0.2836,13,243,256,670,256,256
1371,2011-03-02,Spring,2011,Mar,9,0,Wednesday,1,Clear,0.28,0.2576,0.56,0.2985,7,141,148,670,148,148
1372,2011-03-02,Spring,2011,Mar,10,0,Wednesday,1,Clear,0.32,0.303,0.49,0.2836,11,65,76,670,76,76
1373,2011-03-02,Spring,2011,Mar,11,0,Wednesday,1,Clear,0.34,0.303,0.53,0.3284,8,65,73,670,73,73
1374,2011-03-02,Spring,2011,Mar,12,0,Wednesday,1,Clear,0.4,0.4091,0.43,0.194,20,62,82,670,82,82
1375,2011-03-02,Spring,2011,Mar,13,0,Wednesday,1,Clear,0.5,0.4848,0.25,0.0,35,90,125,670,125,125
1376,2011-03-02,Spring,2011,Mar,14,0,Wednesday,1,Clear,0.52,0.5,0.23,0.2985,21,75,96,670,96,96
1377,2011-03-02,Spring,2011,Mar,15,0,Wednesday,1,Clear,0.54,0.5152,0.19,0.4179,19,91,110,670,110,110
1378,2011-03-02,Spring,2011,Mar,16,0,Wednesday,1,Clear,0.54,0.5152,0.19,0.3284,27,112,139,670,139,139
1379,2011-03-02,Spring,2011,Mar,17,0,Wednesday,1,Clear,0.5,0.4848,0.23,0.2836,30,238,268,670,268,268
1380,2011-03-02,Spring,2011,Mar,18,0,Wednesday,1,Clear,0.46,0.4545,0.23,0.4925,8,193,201,670,201,201
1381,2011-03-02,Spring,2011,Mar,19,0,Wednesday,1,Clear,0.4,0.4091,0.28,0.5224,6,144,150,670,150,150
1382,2011-03-02,Spring,2011,Mar,20,0,Wednesday,1,Clear,0.36,0.3333,0.29,0.4179,9,86,95,670,95,95
1383,2011-03-02,Spring,2011,Mar,21,0,Wednesday,1,Clear,0.34,0.2879,0.29,0.4627,3,68,71,670,71,71
1384,2011-03-02,Spring,2011,Mar,22,0,Wednesday,1,Clear,0.3,0.2576,0.26,0.5522,4,44,48,670,48,48
1385,2011-03-02,Spring,2011,Mar,23,0,Wednesday,1,Clear,0.26,0.2121,0.3,0.5224,0,22,22,670,22,22
1386,2011-03-03,Spring,2011,Mar,0,0,Thursday,1,Clear,0.24,0.197,0.3,0.4627,3,10,13,669,13,13
1387,2011-03-03,Spring,2011,Mar,1,0,Thursday,1,Clear,0.24,0.197,0.3,0.4627,0,1,1,669,1,1
1388,2011-03-03,Spring,2011,Mar,2,0,Thursday,1,Clear,0.2,0.1667,0.27,0.4627,1,2,3,669,3,3
1389,2011-03-03,Spring,2011,Mar,3,0,Thursday,1,Clear,0.2,0.1667,0.27,0.4627,0,1,1,669,1,1
1390,2011-03-03,Spring,2011,Mar,4,0,Thursday,1,Clear,0.16,0.1212,0.31,0.4925,0,1,1,669,1,1
1391,2011-03-03,Spring,2011,Mar,5,0,Thursday,1,Clear,0.14,0.1212,0.33,0.2985,1,7,8,669,8,8
1392,2011-03-03,Spring,2011,Mar,6,0,Thursday,1,Clear,0.14,0.1212,0.33,0.2985,1,34,35,669,35,35
1393,2011-03-03,Spring,2011,Mar,7,0,Thursday,1,Clear,0.12,0.0909,0.42,0.4179,1,110,111,669,111,111
1394,2011-03-03,Spring,2011,Mar,8,0,Thursday,1,Clear,0.14,0.1212,0.39,0.2985,4,216,220,669,220,220
1395,2011-03-03,Spring,2011,Mar,9,0,Thursday,1,Clear,0.16,0.1364,0.37,0.2836,10,135,145,669,145,145
1396,2011-03-03,Spring,2011,Mar,10,0,Thursday,1,Clear,0.18,0.1818,0.29,0.194,7,49,56,669,56,56
1397,2011-03-03,Spring,2011,Mar,11,0,Thursday,1,Clear,0.2,0.2273,0.29,0.0896,10,40,50,669,50,50
1398,2011-03-03,Spring,2011,Mar,12,0,Thursday,1,Clear,0.22,0.2273,0.25,0.1343,7,65,72,669,72,72
1399,2011-03-03,Spring,2011,Mar,13,0,Thursday,1,Clear,0.22,0.2576,0.25,0.0896,13,67,80,669,80,80
1400,2011-03-03,Spring,2011,Mar,14,0,Thursday,1,Clear,0.24,0.2576,0.21,0.1045,18,60,78,669,78,78
1401,2011-03-03,Spring,2011,Mar,15,0,Thursday,1,Clear,0.24,0.2879,0.23,0.0,6,62,68,669,68,68
1402,2011-03-03,Spring,2011,Mar,16,0,Thursday,1,Clear,0.26,0.303,0.23,0.0,6,65,71,669,71,71
1403,2011-03-03,Spring,2011,Mar,17,0,Thursday,1,Clear,0.26,0.303,0.22,0.0,17,185,202,669,202,202
1404,2011-03-03,Spring,2011,Mar,18,0,Thursday,1,Clear,0.24,0.2121,0.35,0.3284,6,161,167,669,167,167
1405,2011-03-03,Spring,2011,Mar,19,0,Thursday,1,Clear,0.2,0.197,0.4,0.2537,5,101,106,669,106,106
1406,2011-03-03,Spring,2011,Mar,20,0,Thursday,1,Clear,0.2,0.2273,0.4,0.0896,1,69,70,669,70,70
1407,2011-03-03,Spring,2011,Mar,21,0,Thursday,1,Clear,0.18,0.2121,0.4,0.1045,3,48,51,669,51,51
1408,2011-03-03,Spring,2011,Mar,22,0,Thursday,1,Clear,0.2,0.2576,0.4,0.0,3,50,53,669,53,53
1409,2011-03-03,Spring,2011,Mar,23,0,Thursday,1,Misty,0.18,0.2121,0.43,0.0896,0,23,23,669,23,23
1410,2011-03-04,Spring,2011,Mar,0,0,Friday,1,Misty,0.2,0.197,0.55,0.194,0,12,12,668,12,12
1411,2011-03-04,Spring,2011,Mar,1,0,Friday,1,Misty,0.18,0.1818,0.64,0.194,0,4,4,668,4,4
1412,2011-03-04,Spring,2011,Mar,2,0,Friday,1,Misty,0.18,0.1818,0.64,0.194,0,2,2,668,2,2
1413,2011-03-04,Spring,2011,Mar,3,0,Friday,1,Misty,0.18,0.1667,0.74,0.2537,0,1,1,668,1,1
1414,2011-03-04,Spring,2011,Mar,4,0,Friday,1,Misty,0.18,0.1818,0.74,0.194,1,0,1,668,1,1
1415,2011-03-04,Spring,2011,Mar,5,0,Friday,1,Misty,0.16,0.1818,0.74,0.1343,0,7,7,668,7,7
1416,2011-03-04,Spring,2011,Mar,6,0,Friday,1,Misty,0.16,0.197,0.74,0.0896,1,28,29,668,29,29
1417,2011-03-04,Spring,2011,Mar,7,0,Friday,1,Clear,0.16,0.1818,0.8,0.1343,0,83,83,668,83,83
1418,2011-03-04,Spring,2011,Mar,8,0,Friday,1,Clear,0.18,0.197,0.74,0.1343,6,222,228,668,228,228
1419,2011-03-04,Spring,2011,Mar,9,0,Friday,1,Clear,0.22,0.2273,0.6,0.1343,12,138,150,668,150,150
1420,2011-03-04,Spring,2011,Mar,10,0,Friday,1,Clear,0.24,0.2273,0.6,0.2537,10,56,66,668,66,66
1421,2011-03-04,Spring,2011,Mar,11,0,Friday,1,Clear,0.28,0.2727,0.52,0.2239,16,73,89,668,89,89
1422,2011-03-04,Spring,2011,Mar,12,0,Friday,1,Clear,0.32,0.303,0.43,0.1642,10,87,97,668,97,97
1423,2011-03-04,Spring,2011,Mar,13,0,Friday,1,Clear,0.34,0.3182,0.42,0.2239,13,74,87,668,87,87
1424,2011-03-04,Spring,2011,Mar,14,0,Friday,1,Clear,0.36,0.3333,0.4,0.2836,30,65,95,668,95,95
1425,2011-03-04,Spring,2011,Mar,15,0,Friday,1,Clear,0.36,0.3333,0.4,0.2985,31,75,106,668,106,106
1426,2011-03-04,Spring,2011,Mar,16,0,Friday,1,Clear,0.36,0.3485,0.46,0.194,17,101,118,668,118,118
1427,2011-03-04,Spring,2011,Mar,17,0,Friday,1,Misty,0.36,0.3333,0.5,0.2537,22,206,228,668,228,228
1428,2011-03-04,Spring,2011,Mar,18,0,Friday,1,Misty,0.34,0.303,0.53,0.2985,15,172,187,668,187,187
1429,2011-03-04,Spring,2011,Mar,19,0,Friday,1,Clear,0.32,0.303,0.61,0.2537,5,102,107,668,107,107
1430,2011-03-04,Spring,2011,Mar,20,0,Friday,1,Misty,0.3,0.2879,0.7,0.194,9,78,87,668,87,87
1431,2011-03-04,Spring,2011,Mar,21,0,Friday,1,Misty,0.3,0.2879,0.7,0.2239,6,64,70,668,70,70
1432,2011-03-04,Spring,2011,Mar,22,0,Friday,1,Clear,0.3,0.2879,0.7,0.194,4,40,44,668,44,44
1433,2011-03-04,Spring,2011,Mar,23,0,Friday,1,Misty,0.3,0.303,0.75,0.1642,6,40,46,668,46,46
1434,2011-03-05,Spring,2011,Mar,0,0,Saturday,0,Misty,0.28,0.2879,0.81,0.1045,4,15,19,667,19,19
1435,2011-03-05,Spring,2011,Mar,1,0,Saturday,0,Misty,0.3,0.3182,0.81,0.1045,5,20,25,667,25,25
1436,2011-03-05,Spring,2011,Mar,2,0,Saturday,0,Misty,0.3,0.2879,0.87,0.194,5,15,20,667,20,20
1437,2011-03-05,Spring,2011,Mar,3,0,Saturday,0,Misty,0.3,0.2879,0.87,0.194,0,2,2,667,2,2
1438,2011-03-05,Spring,2011,Mar,4,0,Saturday,0,Misty,0.3,0.303,0.93,0.1642,0,1,1,667,1,1
1439,2011-03-05,Spring,2011,Mar,5,0,Saturday,0,Misty,0.3,0.303,1.0,0.1343,0,3,3,667,3,3
1440,2011-03-05,Spring,2011,Mar,6,0,Saturday,0,Misty,0.3,0.2879,1.0,0.2239,1,3,4,667,4,4
1441,2011-03-05,Spring,2011,Mar,7,0,Saturday,0,Misty,0.3,0.2727,1.0,0.2985,5,10,15,667,15,15
1442,2011-03-05,Spring,2011,Mar,8,0,Saturday,0,Misty,0.3,0.2727,1.0,0.2985,11,34,45,667,45,45
1443,2011-03-05,Spring,2011,Mar,9,0,Saturday,0,Misty,0.32,0.303,0.93,0.2239,15,48,63,667,63,63
1444,2011-03-05,Spring,2011,Mar,10,0,Saturday,0,Misty,0.34,0.3333,0.93,0.194,34,69,103,667,103,103
1445,2011-03-05,Spring,2011,Mar,11,0,Saturday,0,Misty,0.4,0.4091,0.76,0.2239,43,116,159,667,159,159
1446,2011-03-05,Spring,2011,Mar,12,0,Saturday,0,Misty,0.44,0.4394,0.67,0.2537,46,121,167,667,167,167
1447,2011-03-05,Spring,2011,Mar,13,0,Saturday,0,Misty,0.46,0.4545,0.67,0.2836,60,130,190,667,190,190
1448,2011-03-05,Spring,2011,Mar,14,0,Saturday,0,Misty,0.48,0.4697,0.59,0.2836,80,118,198,667,198,198
1449,2011-03-05,Spring,2011,Mar,15,0,Saturday,0,Misty,0.46,0.4545,0.63,0.2985,83,122,205,667,205,205
1450,2011-03-05,Spring,2011,Mar,16,0,Saturday,0,Misty,0.48,0.4697,0.59,0.2985,74,130,204,667,204,204
1451,2011-03-05,Spring,2011,Mar,17,0,Saturday,0,Misty,0.48,0.4697,0.59,0.3582,60,104,164,667,164,164
1452,2011-03-05,Spring,2011,Mar,18,0,Saturday,0,Misty,0.48,0.4697,0.59,0.3284,37,115,152,667,152,152
1453,2011-03-05,Spring,2011,Mar,19,0,Saturday,0,Misty,0.46,0.4545,0.67,0.3284,27,62,89,667,89,89
1454,2011-03-05,Spring,2011,Mar,20,0,Saturday,0,Misty,0.44,0.4394,0.77,0.3284,12,58,70,667,70,70
1455,2011-03-05,Spring,2011,Mar,21,0,Saturday,0,Misty,0.44,0.4394,0.72,0.3284,12,60,72,667,72,72
1456,2011-03-05,Spring,2011,Mar,22,0,Saturday,0,Misty,0.42,0.4242,0.77,0.2985,16,47,63,667,63,63
1457,2011-03-05,Spring,2011,Mar,23,0,Saturday,0,Misty,0.44,0.4394,0.77,0.2985,10,34,44,667,44,44
1458,2011-03-06,Spring,2011,Mar,0,0,Sunday,0,Misty,0.42,0.4242,0.77,0.3582,11,41,52,666,52,52
1459,2011-03-06,Spring,2011,Mar,1,0,Sunday,0,Misty,0.42,0.4242,0.77,0.2836,12,27,39,666,39,39
1460,2011-03-06,Spring,2011,Mar,2,0,Sunday,0,Misty,0.4,0.4091,0.82,0.2836,5,27,32,666,32,32
1461,2011-03-06,Spring,2011,Mar,3,0,Sunday,0,Misty,0.42,0.4242,0.82,0.2985,2,9,11,666,11,11
1462,2011-03-06,Spring,2011,Mar,4,0,Sunday,0,Misty,0.42,0.4242,0.88,0.3582,0,3,3,666,3,3
1463,2011-03-06,Spring,2011,Mar,6,0,Sunday,0,Misty,0.42,0.4242,0.94,0.3582,1,1,2,666,2,2
1464,2011-03-06,Spring,2011,Mar,7,0,Sunday,0,Light_rainsnow,0.42,0.4242,1.0,0.4478,0,5,5,666,5,5
1465,2011-03-06,Spring,2011,Mar,8,0,Sunday,0,Misty,0.4,0.4091,1.0,0.2985,1,8,9,666,9,9
1466,2011-03-06,Spring,2011,Mar,9,0,Sunday,0,Misty,0.42,0.4242,1.0,0.2836,4,18,22,666,22,22
1467,2011-03-06,Spring,2011,Mar,10,0,Sunday,0,Misty,0.42,0.4242,1.0,0.2985,4,27,31,666,31,31
1468,2011-03-06,Spring,2011,Mar,11,0,Sunday,0,Misty,0.42,0.4242,1.0,0.2239,18,44,62,666,62,62
1469,2011-03-06,Spring,2011,Mar,12,0,Sunday,0,Misty,0.46,0.4545,0.94,0.3284,10,69,79,666,79,79
1470,2011-03-06,Spring,2011,Mar,13,0,Sunday,0,Misty,0.46,0.4545,0.94,0.3582,22,83,105,666,105,105
1471,2011-03-06,Spring,2011,Mar,14,0,Sunday,0,Light_rainsnow,0.44,0.4394,1.0,0.2239,12,27,39,666,39,39
1472,2011-03-06,Spring,2011,Mar,15,0,Sunday,0,Light_rainsnow,0.44,0.4394,1.0,0.2239,3,4,7,666,7,7
1473,2011-03-06,Spring,2011,Mar,16,0,Sunday,0,Light_rainsnow,0.36,0.3333,1.0,0.2836,3,8,11,666,11,11
1474,2011-03-06,Spring,2011,Mar,17,0,Sunday,0,Light_rainsnow,0.34,0.303,1.0,0.2985,2,23,25,666,25,25
1475,2011-03-06,Spring,2011,Mar,18,0,Sunday,0,Light_rainsnow,0.32,0.2879,1.0,0.3582,0,23,23,666,23,23
1476,2011-03-06,Spring,2011,Mar,19,0,Sunday,0,Light_rainsnow,0.3,0.2576,1.0,0.4925,0,11,11,666,11,11
1477,2011-03-06,Spring,2011,Mar,20,0,Sunday,0,Light_rainsnow,0.28,0.2424,1.0,0.4179,3,8,11,666,11,11
1478,2011-03-06,Spring,2011,Mar,21,0,Sunday,0,Light_rainsnow,0.24,0.1818,0.93,0.6119,1,6,7,666,7,7
1479,2011-03-06,Spring,2011,Mar,22,0,Sunday,0,Misty,0.22,0.197,1.0,0.3881,0,10,10,666,10,10
1480,2011-03-06,Spring,2011,Mar,23,0,Sunday,0,Misty,0.22,0.197,1.0,0.4179,0,9,9,666,9,9
1481,2011-03-07,Spring,2011,Mar,0,0,Monday,1,Light_rainsnow,0.2,0.1818,1.0,0.3284,0,4,4,665,4,4
1482,2011-03-07,Spring,2011,Mar,1,0,Monday,1,Light_rainsnow,0.2,0.1818,1.0,0.3284,0,2,2,665,2,2
1483,2011-03-07,Spring,2011,Mar,3,0,Monday,1,Clear,0.2,0.1515,0.8,0.5821,0,1,1,665,1,1
1484,2011-03-07,Spring,2011,Mar,4,0,Monday,1,Clear,0.2,0.1515,0.8,0.5224,1,0,1,665,1,1
1485,2011-03-07,Spring,2011,Mar,5,0,Monday,1,Clear,0.2,0.1818,0.75,0.3582,0,1,1,665,1,1
1486,2011-03-07,Spring,2011,Mar,6,0,Monday,1,Clear,0.2,0.1818,0.75,0.3881,3,31,34,665,34,34
1487,2011-03-07,Spring,2011,Mar,7,0,Monday,1,Clear,0.2,0.1667,0.75,0.4179,3,88,91,665,91,91
1488,2011-03-07,Spring,2011,Mar,8,0,Monday,1,Clear,0.2,0.1818,0.75,0.3881,11,200,211,665,211,211
1489,2011-03-07,Spring,2011,Mar,9,0,Monday,1,Clear,0.22,0.1818,0.64,0.4627,5,129,134,665,134,134
1490,2011-03-07,Spring,2011,Mar,10,0,Monday,1,Clear,0.24,0.2121,0.6,0.2985,15,43,58,665,58,58
1491,2011-03-07,Spring,2011,Mar,11,0,Monday,1,Clear,0.26,0.2121,0.48,0.4478,19,41,60,665,60,60
1492,2011-03-07,Spring,2011,Mar,12,0,Monday,1,Clear,0.3,0.2727,0.42,0.4179,28,68,96,665,96,96
1493,2011-03-07,Spring,2011,Mar,13,0,Monday,1,Clear,0.32,0.2879,0.36,0.3881,16,54,70,665,70,70
1494,2011-03-07,Spring,2011,Mar,14,0,Monday,1,Clear,0.32,0.2879,0.36,0.4179,21,56,77,665,77,77
1495,2011-03-07,Spring,2011,Mar,15,0,Monday,1,Clear,0.34,0.303,0.31,0.3881,32,64,96,665,96,96
1496,2011-03-07,Spring,2011,Mar,16,0,Monday,1,Clear,0.34,0.303,0.31,0.3582,26,96,122,665,122,122
1497,2011-03-07,Spring,2011,Mar,17,0,Monday,1,Clear,0.34,0.303,0.29,0.3582,27,206,233,665,233,233
1498,2011-03-07,Spring,2011,Mar,18,0,Monday,1,Clear,0.32,0.303,0.31,0.2239,19,214,233,665,233,233
1499,2011-03-07,Spring,2011,Mar,19,0,Monday,1,Clear,0.3,0.2879,0.33,0.2239,11,134,145,665,145,145
1500,2011-03-07,Spring,2011,Mar,20,0,Monday,1,Clear,0.3,0.303,0.33,0.1642,5,87,92,665,92,92
1501,2011-03-07,Spring,2011,Mar,21,0,Monday,1,Clear,0.28,0.2727,0.38,0.2239,1,53,54,665,54,54
1502,2011-03-07,Spring,2011,Mar,22,0,Monday,1,Clear,0.26,0.2576,0.48,0.1642,1,34,35,665,35,35
1503,2011-03-07,Spring,2011,Mar,23,0,Monday,1,Clear,0.28,0.3182,0.48,0.0,0,22,22,665,22,22
1504,2011-03-08,Spring,2011,Mar,0,0,Tuesday,1,Clear,0.26,0.2879,0.48,0.0896,1,9,10,664,10,10
1505,2011-03-08,Spring,2011,Mar,1,0,Tuesday,1,Clear,0.24,0.2424,0.52,0.1343,0,4,4,664,4,4
1506,2011-03-08,Spring,2011,Mar,2,0,Tuesday,1,Clear,0.24,0.2424,0.52,0.1343,1,0,1,664,1,1
1507,2011-03-08,Spring,2011,Mar,3,0,Tuesday,1,Clear,0.24,0.2576,0.52,0.0896,5,2,7,664,7,7
1508,2011-03-08,Spring,2011,Mar,4,0,Tuesday,1,Clear,0.22,0.2727,0.64,0.0,0,2,2,664,2,2
1509,2011-03-08,Spring,2011,Mar,5,0,Tuesday,1,Clear,0.2,0.2273,0.69,0.1045,2,8,10,664,10,10
1510,2011-03-08,Spring,2011,Mar,6,0,Tuesday,1,Clear,0.2,0.2576,0.59,0.0,3,42,45,664,45,45
1511,2011-03-08,Spring,2011,Mar,7,0,Tuesday,1,Clear,0.18,0.197,0.64,0.1343,9,119,128,664,128,128
1512,2011-03-08,Spring,2011,Mar,8,0,Tuesday,1,Clear,0.22,0.2273,0.55,0.194,10,247,257,664,257,257
1513,2011-03-08,Spring,2011,Mar,9,0,Tuesday,1,Clear,0.26,0.2576,0.41,0.1642,11,140,151,664,151,151
1514,2011-03-08,Spring,2011,Mar,10,0,Tuesday,1,Misty,0.3,0.2879,0.33,0.194,25,46,71,664,71,71
1515,2011-03-08,Spring,2011,Mar,11,0,Tuesday,1,Misty,0.36,0.3485,0.25,0.1642,26,52,78,664,78,78
1516,2011-03-08,Spring,2011,Mar,12,0,Tuesday,1,Misty,0.36,0.3788,0.23,0.0,29,70,99,664,99,99
1517,2011-03-08,Spring,2011,Mar,13,0,Tuesday,1,Misty,0.38,0.3939,0.25,0.1045,25,73,98,664,98,98
1518,2011-03-08,Spring,2011,Mar,14,0,Tuesday,1,Misty,0.38,0.3939,0.2,0.0,16,56,72,664,72,72
1519,2011-03-08,Spring,2011,Mar,15,0,Tuesday,1,Misty,0.36,0.3788,0.18,0.0,35,77,112,664,112,112
1520,2011-03-08,Spring,2011,Mar,16,0,Tuesday,1,Clear,0.38,0.3939,0.27,0.1642,26,82,108,664,108,108
1521,2011-03-08,Spring,2011,Mar,17,0,Tuesday,1,Clear,0.36,0.3485,0.27,0.2239,39,209,248,664,248,248
1522,2011-03-08,Spring,2011,Mar,18,0,Tuesday,1,Clear,0.34,0.3333,0.27,0.194,21,214,235,664,235,235
1523,2011-03-08,Spring,2011,Mar,19,0,Tuesday,1,Clear,0.34,0.3485,0.31,0.1045,9,141,150,664,150,150
1524,2011-03-08,Spring,2011,Mar,20,0,Tuesday,1,Clear,0.32,0.3333,0.39,0.0896,2,74,76,664,76,76
1525,2011-03-08,Spring,2011,Mar,21,0,Tuesday,1,Clear,0.3,0.2879,0.49,0.194,7,68,75,664,75,75
1526,2011-03-08,Spring,2011,Mar,22,0,Tuesday,1,Clear,0.3,0.2879,0.49,0.2239,11,44,55,664,55,55
1527,2011-03-08,Spring,2011,Mar,23,0,Tuesday,1,Clear,0.28,0.2727,0.61,0.194,3,38,41,664,41,41
1528,2011-03-09,Spring,2011,Mar,0,0,Wednesday,1,Clear,0.26,0.2879,0.65,0.0896,0,9,9,663,9,9
1529,2011-03-09,Spring,2011,Mar,1,0,Wednesday,1,Clear,0.26,0.2727,0.52,0.1343,0,4,4,663,4,4
1530,2011-03-09,Spring,2011,Mar,2,0,Wednesday,1,Clear,0.26,0.2727,0.52,0.1343,1,1,2,663,2,2
1531,2011-03-09,Spring,2011,Mar,3,0,Wednesday,1,Clear,0.24,0.2576,0.7,0.0896,1,2,3,663,3,3
1532,2011-03-09,Spring,2011,Mar,4,0,Wednesday,1,Clear,0.24,0.2576,0.75,0.1045,0,2,2,663,2,2
1533,2011-03-09,Spring,2011,Mar,5,0,Wednesday,1,Misty,0.24,0.2424,0.81,0.1343,1,7,8,663,8,8
1534,2011-03-09,Spring,2011,Mar,6,0,Wednesday,1,Misty,0.24,0.2576,0.85,0.1045,5,44,49,663,49,49
1535,2011-03-09,Spring,2011,Mar,7,0,Wednesday,1,Misty,0.24,0.2424,0.87,0.1642,18,123,141,663,141,141
1536,2011-03-09,Spring,2011,Mar,8,0,Wednesday,1,Misty,0.24,0.2424,0.87,0.1343,11,238,249,663,249,249
1537,2011-03-09,Spring,2011,Mar,9,0,Wednesday,1,Misty,0.26,0.2424,0.87,0.2537,5,136,141,663,141,141
1538,2011-03-09,Spring,2011,Mar,10,0,Wednesday,1,Misty,0.3,0.2879,0.75,0.2537,8,49,57,663,57,57
1539,2011-03-09,Spring,2011,Mar,11,0,Wednesday,1,Misty,0.32,0.2879,0.76,0.3881,15,44,59,663,59,59
1540,2011-03-09,Spring,2011,Mar,12,0,Wednesday,1,Misty,0.32,0.303,0.76,0.2537,14,84,98,663,98,98
1541,2011-03-09,Spring,2011,Mar,13,0,Wednesday,1,Misty,0.32,0.2879,0.76,0.3582,17,82,99,663,99,99
1542,2011-03-09,Spring,2011,Mar,14,0,Wednesday,1,Misty,0.34,0.303,0.76,0.2985,10,61,71,663,71,71
1543,2011-03-09,Spring,2011,Mar,15,0,Wednesday,1,Misty,0.36,0.3333,0.71,0.2985,15,64,79,663,79,79
1544,2011-03-09,Spring,2011,Mar,16,0,Wednesday,1,Misty,0.34,0.303,0.76,0.3284,10,102,112,663,112,112
1545,2011-03-09,Spring,2011,Mar,17,0,Wednesday,1,Misty,0.34,0.303,0.76,0.2985,18,176,194,663,194,194
1546,2011-03-09,Spring,2011,Mar,18,0,Wednesday,1,Misty,0.34,0.3182,0.76,0.2537,12,176,188,663,188,188
1547,2011-03-09,Spring,2011,Mar,19,0,Wednesday,1,Misty,0.34,0.303,0.76,0.3284,11,123,134,663,134,134
1548,2011-03-09,Spring,2011,Mar,20,0,Wednesday,1,Misty,0.32,0.3182,0.87,0.194,4,87,91,663,91,91
1549,2011-03-09,Spring,2011,Mar,21,0,Wednesday,1,Misty,0.32,0.303,0.93,0.3284,10,52,62,663,62,62
1550,2011-03-09,Spring,2011,Mar,22,0,Wednesday,1,Light_rainsnow,0.32,0.3182,0.93,0.1642,4,17,21,663,21,21
1551,2011-03-09,Spring,2011,Mar,23,0,Wednesday,1,Light_rainsnow,0.34,0.3333,0.93,0.194,1,17,18,663,18,18
1552,2011-03-10,Spring,2011,Mar,0,0,Thursday,1,Light_rainsnow,0.34,0.3182,0.0,0.2537,3,0,3,662,3,3
1553,2011-03-10,Spring,2011,Mar,1,0,Thursday,1,Light_rainsnow,0.34,0.3182,0.0,0.2537,0,2,2,662,2,2
1554,2011-03-10,Spring,2011,Mar,2,0,Thursday,1,Light_rainsnow,0.34,0.3182,0.0,0.2537,0,1,1,662,1,1
1555,2011-03-10,Spring,2011,Mar,5,0,Thursday,1,Light_rainsnow,0.36,0.3485,0.0,0.194,1,2,3,662,3,3
1556,2011-03-10,Spring,2011,Mar,6,0,Thursday,1,Light_rainsnow,0.36,0.3333,0.0,0.3284,0,12,12,662,12,12
1557,2011-03-10,Spring,2011,Mar,7,0,Thursday,1,Light_rainsnow,0.38,0.3939,0.0,0.2239,1,36,37,662,37,37
1558,2011-03-10,Spring,2011,Mar,8,0,Thursday,1,Light_rainsnow,0.38,0.3939,0.0,0.2836,1,43,44,662,44,44
1559,2011-03-10,Spring,2011,Mar,9,0,Thursday,1,Light_rainsnow,0.4,0.4091,0.0,0.2239,1,23,24,662,24,24
1560,2011-03-10,Spring,2011,Mar,10,0,Thursday,1,Light_rainsnow,0.4,0.4091,0.0,0.1642,0,17,17,662,17,17
1561,2011-03-10,Spring,2011,Mar,11,0,Thursday,1,Light_rainsnow,0.4,0.4091,0.0,0.2537,6,5,11,662,11,11
1562,2011-03-10,Spring,2011,Mar,12,0,Thursday,1,Light_rainsnow,0.42,0.4242,0.0,0.2239,4,30,34,662,34,34
1563,2011-03-10,Spring,2011,Mar,13,0,Thursday,1,Light_rainsnow,0.42,0.4242,0.0,0.2239,1,11,12,662,12,12
1564,2011-03-10,Spring,2011,Mar,14,0,Thursday,1,Light_rainsnow,0.44,0.4394,0.0,0.2985,0,12,12,662,12,12
1565,2011-03-10,Spring,2011,Mar,15,0,Thursday,1,Light_rainsnow,0.44,0.4394,0.0,0.2239,3,11,14,662,14,14
1566,2011-03-10,Spring,2011,Mar,16,0,Thursday,1,Light_rainsnow,0.42,0.4242,0.0,0.2537,1,20,21,662,21,21
1567,2011-03-10,Spring,2011,Mar,17,0,Thursday,1,Misty,0.44,0.4394,0.0,0.3881,2,109,111,662,111,111
1568,2011-03-10,Spring,2011,Mar,18,0,Thursday,1,Light_rainsnow,0.44,0.4394,0.0,0.3582,2,80,82,662,82,82
1569,2011-03-10,Spring,2011,Mar,19,0,Thursday,1,Light_rainsnow,0.44,0.4394,0.0,0.5821,5,51,56,662,56,56
1570,2011-03-10,Spring,2011,Mar,20,0,Thursday,1,Light_rainsnow,0.36,0.3333,0.0,0.3284,9,29,38,662,38,38
1571,2011-03-10,Spring,2011,Mar,21,0,Thursday,1,Light_rainsnow,0.36,0.3485,0.0,0.2239,1,27,28,662,28,28
1572,2011-03-10,Spring,2011,Mar,22,0,Thursday,1,Misty,0.34,0.3333,0.0,0.1343,4,30,34,662,34,34
1573,2011-03-10,Spring,2011,Mar,23,0,Thursday,1,Light_rainsnow,0.34,0.3485,0.0,0.0896,1,26,27,662,27,27
1574,2011-03-11,Spring,2011,Mar,0,0,Friday,1,Misty,0.34,0.3485,1.0,0.0896,0,6,6,661,6,6
1575,2011-03-11,Spring,2011,Mar,1,0,Friday,1,Light_rainsnow,0.34,0.3485,1.0,0.1045,0,8,8,661,8,8
1576,2011-03-11,Spring,2011,Mar,2,0,Friday,1,Light_rainsnow,0.34,0.3485,1.0,0.1045,2,3,5,661,5,5
1577,2011-03-11,Spring,2011,Mar,3,0,Friday,1,Misty,0.32,0.3333,0.93,0.0896,0,2,2,661,2,2
1578,2011-03-11,Spring,2011,Mar,5,0,Friday,1,Clear,0.3,0.2879,0.81,0.2239,1,6,7,661,7,7
1579,2011-03-11,Spring,2011,Mar,6,0,Friday,1,Clear,0.26,0.2424,0.81,0.2836,1,31,32,661,32,32
1580,2011-03-11,Spring,2011,Mar,7,0,Friday,1,Clear,0.26,0.2576,0.7,0.194,10,104,114,661,114,114
1581,2011-03-11,Spring,2011,Mar,8,0,Friday,1,Clear,0.28,0.2727,0.7,0.2537,15,244,259,661,259,259
1582,2011-03-11,Spring,2011,Mar,9,0,Friday,1,Misty,0.3,0.2879,0.61,0.2836,13,143,156,661,156,156
1583,2011-03-11,Spring,2011,Mar,10,0,Friday,1,Misty,0.32,0.303,0.57,0.2985,18,60,78,661,78,78
1584,2011-03-11,Spring,2011,Mar,11,0,Friday,1,Misty,0.32,0.303,0.57,0.2985,14,67,81,661,81,81
1585,2011-03-11,Spring,2011,Mar,12,0,Friday,1,Misty,0.34,0.3182,0.53,0.2537,15,96,111,661,111,111
1586,2011-03-11,Spring,2011,Mar,13,0,Friday,1,Clear,0.36,0.3333,0.53,0.2537,15,92,107,661,107,107
1587,2011-03-11,Spring,2011,Mar,14,0,Friday,1,Misty,0.36,0.3333,0.5,0.3582,25,64,89,661,89,89
1588,2011-03-11,Spring,2011,Mar,15,0,Friday,1,Misty,0.34,0.3182,0.53,0.2537,21,64,85,661,85,85
1589,2011-03-11,Spring,2011,Mar,16,0,Friday,1,Misty,0.34,0.303,0.49,0.2985,18,95,113,661,113,113
1590,2011-03-11,Spring,2011,Mar,17,0,Friday,1,Clear,0.34,0.3182,0.49,0.2239,23,200,223,661,223,223
1591,2011-03-11,Spring,2011,Mar,18,0,Friday,1,Clear,0.32,0.303,0.49,0.3284,19,134,153,661,153,153
1592,2011-03-11,Spring,2011,Mar,19,0,Friday,1,Clear,0.3,0.2727,0.56,0.3284,7,111,118,661,118,118
1593,2011-03-11,Spring,2011,Mar,20,0,Friday,1,Clear,0.3,0.303,0.56,0.1642,6,70,76,661,76,76
1594,2011-03-11,Spring,2011,Mar,21,0,Friday,1,Misty,0.3,0.2879,0.52,0.2537,10,43,53,661,53,53
1595,2011-03-11,Spring,2011,Mar,22,0,Friday,1,Clear,0.3,0.303,0.52,0.1642,11,53,64,661,64,64
1596,2011-03-11,Spring,2011,Mar,23,0,Friday,1,Clear,0.3,0.2879,0.52,0.2537,3,34,37,661,37,37
1597,2011-03-12,Spring,2011,Mar,0,0,Saturday,0,Clear,0.26,0.2727,0.6,0.1343,4,30,34,660,34,34
1598,2011-03-12,Spring,2011,Mar,1,0,Saturday,0,Clear,0.24,0.2273,0.65,0.194,3,15,18,660,18,18
1599,2011-03-12,Spring,2011,Mar,2,0,Saturday,0,Clear,0.24,0.2273,0.65,0.194,0,14,14,660,14,14
1600,2011-03-12,Spring,2011,Mar,3,0,Saturday,0,Clear,0.24,0.2273,0.65,0.2537,1,6,7,660,7,7
1601,2011-03-12,Spring,2011,Mar,4,0,Saturday,0,Clear,0.24,0.2273,0.65,0.2537,0,1,1,660,1,1
1602,2011-03-12,Spring,2011,Mar,5,0,Saturday,0,Clear,0.22,0.2273,0.69,0.194,0,2,2,660,2,2
1603,2011-03-12,Spring,2011,Mar,6,0,Saturday,0,Clear,0.22,0.2121,0.75,0.2537,2,2,4,660,4,4
1604,2011-03-12,Spring,2011,Mar,7,0,Saturday,0,Clear,0.24,0.2273,0.7,0.194,4,19,23,660,23,23
1605,2011-03-12,Spring,2011,Mar,8,0,Saturday,0,Clear,0.26,0.2576,0.65,0.1642,9,44,53,660,53,53
1606,2011-03-12,Spring,2011,Mar,9,0,Saturday,0,Clear,0.28,0.2879,0.65,0.1045,25,76,101,660,101,101
1607,2011-03-12,Spring,2011,Mar,10,0,Saturday,0,Clear,0.32,0.303,0.66,0.2239,21,78,99,660,99,99
1608,2011-03-12,Spring,2011,Mar,11,0,Saturday,0,Clear,0.34,0.303,0.49,0.3284,36,83,119,660,119,119
1609,2011-03-12,Spring,2011,Mar,12,0,Saturday,0,Clear,0.34,0.3182,0.53,0.2836,51,107,158,660,158,158
1610,2011-03-12,Spring,2011,Mar,13,0,Saturday,0,Clear,0.36,0.3333,0.51,0.3582,62,95,157,660,157,157
1611,2011-03-12,Spring,2011,Mar,14,0,Saturday,0,Clear,0.4,0.4091,0.5,0.4478,70,96,166,660,166,166
1612,2011-03-12,Spring,2011,Mar,15,0,Saturday,0,Clear,0.42,0.4242,0.44,0.4925,81,101,182,660,182,182
1613,2011-03-12,Spring,2011,Mar,16,0,Saturday,0,Clear,0.46,0.4545,0.41,0.4478,100,144,244,660,244,244
1614,2011-03-12,Spring,2011,Mar,17,0,Saturday,0,Clear,0.46,0.4545,0.44,0.3284,99,114,213,660,213,213
1615,2011-03-12,Spring,2011,Mar,18,0,Saturday,0,Clear,0.42,0.4242,0.54,0.1642,54,91,145,660,145,145
1616,2011-03-12,Spring,2011,Mar,19,0,Saturday,0,Clear,0.42,0.4242,0.54,0.0896,26,86,112,660,112,112
1617,2011-03-12,Spring,2011,Mar,20,0,Saturday,0,Clear,0.4,0.4091,0.58,0.1045,22,64,86,660,86,86
1618,2011-03-12,Spring,2011,Mar,21,0,Saturday,0,Clear,0.38,0.3939,0.62,0.0,36,46,82,660,82,82
1619,2011-03-12,Spring,2011,Mar,22,0,Saturday,0,Clear,0.36,0.3788,0.71,0.0,7,56,63,660,63,63
1620,2011-03-12,Spring,2011,Mar,23,0,Saturday,0,Clear,0.38,0.3939,0.66,0.0896,11,38,49,660,49,49
1621,2011-03-13,Spring,2011,Mar,0,0,Sunday,0,Clear,0.38,0.3939,0.62,0.1045,3,35,38,659,38,38
1622,2011-03-13,Spring,2011,Mar,1,0,Sunday,0,Clear,0.36,0.3485,0.66,0.1343,10,23,33,659,33,33
1623,2011-03-13,Spring,2011,Mar,3,0,Sunday,0,Clear,0.34,0.3333,0.76,0.1343,6,17,23,659,23,23
1624,2011-03-13,Spring,2011,Mar,4,0,Sunday,0,Clear,0.34,0.3333,0.66,0.1642,4,9,13,659,13,13
1625,2011-03-13,Spring,2011,Mar,5,0,Sunday,0,Clear,0.36,0.3485,0.62,0.1343,0,3,3,659,3,3
1626,2011-03-13,Spring,2011,Mar,6,0,Sunday,0,Clear,0.34,0.3636,0.66,0.0,0,2,2,659,2,2
1627,2011-03-13,Spring,2011,Mar,7,0,Sunday,0,Clear,0.36,0.3485,0.62,0.194,2,8,10,659,10,10
1628,2011-03-13,Spring,2011,Mar,8,0,Sunday,0,Clear,0.4,0.4091,0.5,0.2985,11,23,34,659,34,34
1629,2011-03-13,Spring,2011,Mar,9,0,Sunday,0,Clear,0.4,0.4091,0.5,0.4179,8,36,44,659,44,44
1630,2011-03-13,Spring,2011,Mar,10,0,Sunday,0,Clear,0.42,0.4242,0.47,0.2537,36,86,122,659,122,122
1631,2011-03-13,Spring,2011,Mar,11,0,Sunday,0,Clear,0.44,0.4394,0.41,0.4179,88,93,181,659,181,181
1632,2011-03-13,Spring,2011,Mar,12,0,Sunday,0,Clear,0.46,0.4545,0.38,0.3881,74,120,194,659,194,194
1633,2011-03-13,Spring,2011,Mar,13,0,Sunday,0,Clear,0.46,0.4545,0.38,0.3881,97,124,221,659,221,221
1634,2011-03-13,Spring,2011,Mar,14,0,Sunday,0,Clear,0.46,0.4545,0.41,0.2985,144,106,250,659,250,250
1635,2011-03-13,Spring,2011,Mar,15,0,Sunday,0,Clear,0.48,0.4697,0.39,0.3284,149,155,304,659,304,304
1636,2011-03-13,Spring,2011,Mar,16,0,Sunday,0,Clear,0.46,0.4545,0.41,0.3881,124,132,256,659,256,256
1637,2011-03-13,Spring,2011,Mar,17,0,Sunday,0,Clear,0.44,0.4394,0.41,0.3582,98,143,241,659,241,241
1638,2011-03-13,Spring,2011,Mar,18,0,Sunday,0,Clear,0.4,0.4091,0.43,0.3582,55,92,147,659,147,147
1639,2011-03-13,Spring,2011,Mar,19,0,Sunday,0,Clear,0.36,0.3333,0.5,0.3582,28,73,101,659,101,101
1640,2011-03-13,Spring,2011,Mar,20,0,Sunday,0,Clear,0.32,0.303,0.57,0.2985,23,54,77,659,77,77
1641,2011-03-13,Spring,2011,Mar,21,0,Sunday,0,Clear,0.3,0.2879,0.56,0.2537,9,49,58,659,58,58
1642,2011-03-13,Spring,2011,Mar,22,0,Sunday,0,Clear,0.3,0.2727,0.56,0.3284,8,29,37,659,37,37
1643,2011-03-13,Spring,2011,Mar,23,0,Sunday,0,Clear,0.26,0.2576,0.65,0.2239,5,23,28,659,28,28
1644,2011-03-14,Spring,2011,Mar,0,0,Monday,1,Clear,0.26,0.2727,0.65,0.1045,4,7,11,658,11,11
1645,2011-03-14,Spring,2011,Mar,1,0,Monday,1,Clear,0.26,0.2879,0.65,0.0896,0,1,1,658,1,1
1646,2011-03-14,Spring,2011,Mar,2,0,Monday,1,Clear,0.26,0.2879,0.65,0.0896,0,1,1,658,1,1
1647,2011-03-14,Spring,2011,Mar,3,0,Monday,1,Clear,0.26,0.2727,0.65,0.1343,0,3,3,658,3,3
1648,2011-03-14,Spring,2011,Mar,5,0,Monday,1,Clear,0.24,0.2424,0.7,0.1343,0,8,8,658,8,8
1649,2011-03-14,Spring,2011,Mar,6,0,Monday,1,Clear,0.26,0.2727,0.65,0.1343,1,27,28,658,28,28
1650,2011-03-14,Spring,2011,Mar,7,0,Monday,1,Misty,0.28,0.3182,0.61,0.0,4,84,88,658,88,88
1651,2011-03-14,Spring,2011,Mar,8,0,Monday,1,Misty,0.3,0.303,0.56,0.1343,24,217,241,658,241,241
1652,2011-03-14,Spring,2011,Mar,9,0,Monday,1,Clear,0.32,0.303,0.53,0.3284,13,127,140,658,140,140
1653,2011-03-14,Spring,2011,Mar,10,0,Monday,1,Clear,0.34,0.3182,0.42,0.2537,27,57,84,658,84,84
1654,2011-03-14,Spring,2011,Mar,11,0,Monday,1,Clear,0.36,0.3333,0.4,0.2537,26,45,71,658,71,71
1655,2011-03-14,Spring,2011,Mar,12,0,Monday,1,Clear,0.38,0.3939,0.37,0.0,40,54,94,658,94,94
1656,2011-03-14,Spring,2011,Mar,13,0,Monday,1,Clear,0.38,0.3939,0.36,0.3284,24,51,75,658,75,75
1657,2011-03-14,Spring,2011,Mar,14,0,Monday,1,Misty,0.38,0.3939,0.34,0.0,27,52,79,658,79,79
1658,2011-03-14,Spring,2011,Mar,15,0,Monday,1,Clear,0.38,0.3939,0.37,0.1642,24,77,101,658,101,101
1659,2011-03-14,Spring,2011,Mar,16,0,Monday,1,Clear,0.4,0.4091,0.35,0.1045,27,80,107,658,107,107
1660,2011-03-14,Spring,2011,Mar,17,0,Monday,1,Clear,0.38,0.3939,0.4,0.194,42,229,271,658,271,271
1661,2011-03-14,Spring,2011,Mar,18,0,Monday,1,Clear,0.36,0.3636,0.4,0.1045,25,210,235,658,235,235
1662,2011-03-14,Spring,2011,Mar,19,0,Monday,1,Clear,0.36,0.3485,0.43,0.1343,17,133,150,658,150,150
1663,2011-03-14,Spring,2011,Mar,20,0,Monday,1,Clear,0.34,0.3182,0.46,0.2239,23,106,129,658,129,129
1664,2011-03-14,Spring,2011,Mar,21,0,Monday,1,Clear,0.34,0.3333,0.46,0.1343,5,58,63,658,63,63
1665,2011-03-14,Spring,2011,Mar,22,0,Monday,1,Clear,0.32,0.3333,0.49,0.1045,4,43,47,658,47,47
1666,2011-03-14,Spring,2011,Mar,23,0,Monday,1,Clear,0.32,0.3485,0.53,0.0,2,17,19,658,19,19
1667,2011-03-15,Spring,2011,Mar,0,0,Tuesday,1,Clear,0.32,0.3485,0.53,0.0,7,7,14,657,14,14
1668,2011-03-15,Spring,2011,Mar,1,0,Tuesday,1,Clear,0.3,0.303,0.62,0.0896,4,6,10,657,10,10
1669,2011-03-15,Spring,2011,Mar,2,0,Tuesday,1,Clear,0.3,0.303,0.62,0.0896,1,2,3,657,3,3
1670,2011-03-15,Spring,2011,Mar,4,0,Tuesday,1,Clear,0.24,0.2576,0.75,0.0896,1,1,2,657,2,2
1671,2011-03-15,Spring,2011,Mar,5,0,Tuesday,1,Clear,0.24,0.2273,0.75,0.194,0,11,11,657,11,11
1672,2011-03-15,Spring,2011,Mar,6,0,Tuesday,1,Clear,0.22,0.2273,0.8,0.194,3,32,35,657,35,35
1673,2011-03-15,Spring,2011,Mar,7,0,Tuesday,1,Clear,0.24,0.2424,0.75,0.1642,10,109,119,657,119,119
1674,2011-03-15,Spring,2011,Mar,8,0,Tuesday,1,Clear,0.26,0.2879,0.7,0.0896,23,259,282,657,282,282
1675,2011-03-15,Spring,2011,Mar,9,0,Tuesday,1,Misty,0.3,0.3333,0.7,0.0,10,147,157,657,157,157
1676,2011-03-15,Spring,2011,Mar,10,0,Tuesday,1,Misty,0.32,0.3182,0.66,0.194,22,56,78,657,78,78
1677,2011-03-15,Spring,2011,Mar,11,0,Tuesday,1,Misty,0.34,0.3182,0.57,0.2239,27,51,78,657,78,78
1678,2011-03-15,Spring,2011,Mar,12,0,Tuesday,1,Misty,0.36,0.3485,0.5,0.2239,32,70,102,657,102,102
1679,2011-03-15,Spring,2011,Mar,13,0,Tuesday,1,Misty,0.36,0.3333,0.57,0.2836,23,74,97,657,97,97
1680,2011-03-15,Spring,2011,Mar,14,0,Tuesday,1,Misty,0.38,0.3939,0.46,0.2985,14,74,88,657,88,88
1681,2011-03-15,Spring,2011,Mar,15,0,Tuesday,1,Misty,0.38,0.3939,0.43,0.2836,24,66,90,657,90,90
1682,2011-03-15,Spring,2011,Mar,16,0,Tuesday,1,Misty,0.38,0.3939,0.46,0.3284,21,93,114,657,114,114
1683,2011-03-15,Spring,2011,Mar,17,0,Tuesday,1,Misty,0.36,0.3485,0.62,0.194,22,195,217,657,217,217
1684,2011-03-15,Spring,2011,Mar,18,0,Tuesday,1,Misty,0.36,0.3333,0.62,0.2985,18,207,225,657,225,225
1685,2011-03-15,Spring,2011,Mar,19,0,Tuesday,1,Misty,0.34,0.3182,0.71,0.2836,14,138,152,657,152,152
1686,2011-03-15,Spring,2011,Mar,20,0,Tuesday,1,Misty,0.34,0.3182,0.71,0.2836,9,79,88,657,88,88
1687,2011-03-15,Spring,2011,Mar,21,0,Tuesday,1,Light_rainsnow,0.32,0.3333,0.81,0.1045,2,53,55,657,55,55
1688,2011-03-15,Spring,2011,Mar,22,0,Tuesday,1,Misty,0.32,0.3182,0.87,0.1642,1,20,21,657,21,21
1689,2011-03-15,Spring,2011,Mar,23,0,Tuesday,1,Misty,0.32,0.3182,0.87,0.1642,1,17,18,657,18,18
1690,2011-03-16,Spring,2011,Mar,0,0,Wednesday,1,Light_rainsnow,0.3,0.2879,0.93,0.2537,0,8,8,656,8,8
1691,2011-03-16,Spring,2011,Mar,1,0,Wednesday,1,Light_rainsnow,0.3,0.2727,1.0,0.2985,1,2,3,656,3,3
1692,2011-03-16,Spring,2011,Mar,3,0,Wednesday,1,Misty,0.28,0.2727,1.0,0.2239,1,2,3,656,3,3
1693,2011-03-16,Spring,2011,Mar,4,0,Wednesday,1,Misty,0.3,0.303,0.93,0.1642,0,1,1,656,1,1
1694,2011-03-16,Spring,2011,Mar,5,0,Wednesday,1,Misty,0.3,0.3182,0.93,0.1045,0,3,3,656,3,3
1695,2011-03-16,Spring,2011,Mar,6,0,Wednesday,1,Misty,0.3,0.3182,0.93,0.1045,1,30,31,656,31,31
1696,2011-03-16,Spring,2011,Mar,7,0,Wednesday,1,Misty,0.3,0.2879,0.93,0.194,10,101,111,656,111,111
1697,2011-03-16,Spring,2011,Mar,8,0,Wednesday,1,Misty,0.32,0.3182,0.93,0.0,26,227,253,656,253,253
1698,2011-03-16,Spring,2011,Mar,9,0,Wednesday,1,Misty,0.32,0.3333,0.93,0.1343,10,144,154,656,154,154
1699,2011-03-16,Spring,2011,Mar,10,0,Wednesday,1,Misty,0.36,0.3485,0.81,0.1642,19,49,68,656,68,68
1700,2011-03-16,Spring,2011,Mar,11,0,Wednesday,1,Misty,0.36,0.3485,0.81,0.1343,13,62,75,656,75,75
1701,2011-03-16,Spring,2011,Mar,12,0,Wednesday,1,Misty,0.4,0.4091,0.71,0.1045,23,65,88,656,88,88
1702,2011-03-16,Spring,2011,Mar,13,0,Wednesday,1,Misty,0.4,0.4091,0.76,0.1343,18,81,99,656,99,99
1703,2011-03-16,Spring,2011,Mar,14,0,Wednesday,1,Misty,0.4,0.4091,0.76,0.2239,33,67,100,656,100,100
1704,2011-03-16,Spring,2011,Mar,15,0,Wednesday,1,Misty,0.4,0.4091,0.76,0.2537,22,79,101,656,101,101
1705,2011-03-16,Spring,2011,Mar,16,0,Wednesday,1,Misty,0.4,0.4091,0.76,0.1642,30,121,151,656,151,151
1706,2011-03-16,Spring,2011,Mar,17,0,Wednesday,1,Misty,0.44,0.4394,0.54,0.2985,37,216,253,656,253,253
1707,2011-03-16,Spring,2011,Mar,18,0,Wednesday,1,Misty,0.44,0.4394,0.54,0.2239,26,211,237,656,237,237
1708,2011-03-16,Spring,2011,Mar,19,0,Wednesday,1,Misty,0.44,0.4394,0.51,0.3284,18,150,168,656,168,168
1709,2011-03-16,Spring,2011,Mar,20,0,Wednesday,1,Misty,0.42,0.4242,0.54,0.2985,10,111,121,656,121,121
1710,2011-03-16,Spring,2011,Mar,21,0,Wednesday,1,Misty,0.42,0.4242,0.58,0.2836,3,75,78,656,78,78
1711,2011-03-16,Spring,2011,Mar,22,0,Wednesday,1,Misty,0.4,0.4091,0.62,0.3881,11,48,59,656,59,59
1712,2011-03-16,Spring,2011,Mar,23,0,Wednesday,1,Clear,0.4,0.4091,0.65,0.194,9,18,27,656,27,27
1713,2011-03-17,Spring,2011,Mar,0,0,Thursday,1,Clear,0.38,0.3939,0.66,0.2537,4,19,23,655,23,23
1714,2011-03-17,Spring,2011,Mar,1,0,Thursday,1,Clear,0.36,0.3485,0.71,0.2239,1,11,12,655,12,12
1715,2011-03-17,Spring,2011,Mar,2,0,Thursday,1,Clear,0.34,0.303,0.71,0.2985,3,5,8,655,8,8
1716,2011-03-17,Spring,2011,Mar,3,0,Thursday,1,Clear,0.34,0.3333,0.66,0.1642,1,1,2,655,2,2
1717,2011-03-17,Spring,2011,Mar,4,0,Thursday,1,Clear,0.34,0.3333,0.71,0.194,0,3,3,655,3,3
1718,2011-03-17,Spring,2011,Mar,5,0,Thursday,1,Clear,0.32,0.3333,0.76,0.1045,0,13,13,655,13,13
1719,2011-03-17,Spring,2011,Mar,6,0,Thursday,1,Clear,0.32,0.3182,0.76,0.194,4,47,51,655,51,51
1720,2011-03-17,Spring,2011,Mar,7,0,Thursday,1,Clear,0.32,0.3333,0.76,0.1343,12,128,140,655,140,140
1721,2011-03-17,Spring,2011,Mar,8,0,Thursday,1,Clear,0.36,0.3485,0.66,0.1343,17,282,299,655,299,299
1722,2011-03-17,Spring,2011,Mar,9,0,Thursday,1,Clear,0.4,0.4091,0.62,0.2537,23,162,185,655,185,185
1723,2011-03-17,Spring,2011,Mar,10,0,Thursday,1,Clear,0.44,0.4394,0.54,0.3284,9,69,78,655,78,78
1724,2011-03-17,Spring,2011,Mar,11,0,Thursday,1,Clear,0.44,0.4394,0.54,0.2836,20,66,86,655,86,86
1725,2011-03-17,Spring,2011,Mar,12,0,Thursday,1,Clear,0.5,0.4848,0.45,0.2239,24,81,105,655,105,105
1726,2011-03-17,Spring,2011,Mar,13,0,Thursday,1,Misty,0.52,0.5,0.42,0.0896,26,85,111,655,111,111
1727,2011-03-17,Spring,2011,Mar,14,0,Thursday,1,Clear,0.5,0.4848,0.45,0.1045,32,87,119,655,119,119
1728,2011-03-17,Spring,2011,Mar,15,0,Thursday,1,Clear,0.52,0.5,0.42,0.2537,30,95,125,655,125,125
1729,2011-03-17,Spring,2011,Mar,16,0,Thursday,1,Clear,0.5,0.4848,0.48,0.2836,34,108,142,655,142,142
1730,2011-03-17,Spring,2011,Mar,17,0,Thursday,1,Clear,0.5,0.4848,0.42,0.194,48,265,313,655,313,313
1731,2011-03-17,Spring,2011,Mar,18,0,Thursday,1,Misty,0.46,0.4545,0.59,0.1642,50,260,310,655,310,310
1732,2011-03-17,Spring,2011,Mar,19,0,Thursday,1,Clear,0.44,0.4394,0.58,0.194,18,189,207,655,207,207
1733,2011-03-17,Spring,2011,Mar,20,0,Thursday,1,Clear,0.42,0.4242,0.67,0.2239,25,112,137,655,137,137
1734,2011-03-17,Spring,2011,Mar,21,0,Thursday,1,Clear,0.42,0.4242,0.62,0.2239,19,119,138,655,138,138
1735,2011-03-17,Spring,2011,Mar,22,0,Thursday,1,Clear,0.4,0.4091,0.66,0.2239,17,70,87,655,87,87
1736,2011-03-17,Spring,2011,Mar,23,0,Thursday,1,Clear,0.42,0.4242,0.62,0.2836,7,43,50,655,50,50
1737,2011-03-18,Spring,2011,Mar,0,0,Friday,1,Clear,0.42,0.4242,0.58,0.2836,5,24,29,654,29,29
1738,2011-03-18,Spring,2011,Mar,1,0,Friday,1,Clear,0.4,0.4091,0.62,0.2537,4,12,16,654,16,16
1739,2011-03-18,Spring,2011,Mar,2,0,Friday,1,Clear,0.4,0.4091,0.62,0.194,5,9,14,654,14,14
1740,2011-03-18,Spring,2011,Mar,3,0,Friday,1,Clear,0.36,0.3485,0.71,0.194,1,4,5,654,5,5
1741,2011-03-18,Spring,2011,Mar,5,0,Friday,1,Clear,0.38,0.3939,0.66,0.1642,2,8,10,654,10,10
1742,2011-03-18,Spring,2011,Mar,6,0,Friday,1,Clear,0.4,0.4091,0.66,0.194,1,35,36,654,36,36
1743,2011-03-18,Spring,2011,Mar,7,0,Friday,1,Clear,0.4,0.4091,0.66,0.194,11,112,123,654,123,123
1744,2011-03-18,Spring,2011,Mar,8,0,Friday,1,Clear,0.42,0.4242,0.67,0.2537,24,256,280,654,280,280
1745,2011-03-18,Spring,2011,Mar,9,0,Friday,1,Clear,0.46,0.4545,0.63,0.2239,18,192,210,654,210,210
1746,2011-03-18,Spring,2011,Mar,10,0,Friday,1,Clear,0.52,0.5,0.53,0.2836,43,74,117,654,117,117
1747,2011-03-18,Spring,2011,Mar,11,0,Friday,1,Clear,0.54,0.5152,0.52,0.2836,55,104,159,654,159,159
1748,2011-03-18,Spring,2011,Mar,12,0,Friday,1,Misty,0.56,0.5303,0.49,0.3582,72,123,195,654,195,195
1749,2011-03-18,Spring,2011,Mar,13,0,Friday,1,Clear,0.64,0.6212,0.41,0.2836,57,118,175,654,175,175
1750,2011-03-18,Spring,2011,Mar,14,0,Friday,1,Clear,0.66,0.6212,0.39,0.2537,71,103,174,654,174,174
1751,2011-03-18,Spring,2011,Mar,15,0,Friday,1,Misty,0.68,0.6364,0.39,0.3582,62,111,173,654,173,173
1752,2011-03-18,Spring,2011,Mar,16,0,Friday,1,Clear,0.68,0.6364,0.39,0.2836,67,137,204,654,204,204
1753,2011-03-18,Spring,2011,Mar,17,0,Friday,1,Clear,0.7,0.6364,0.37,0.3284,95,237,332,654,332,332
1754,2011-03-18,Spring,2011,Mar,18,0,Friday,1,Clear,0.68,0.6364,0.39,0.1642,84,247,331,654,331,331
1755,2011-03-18,Spring,2011,Mar,19,0,Friday,1,Clear,0.66,0.6212,0.44,0.1343,58,132,190,654,190,190
1756,2011-03-18,Spring,2011,Mar,20,0,Friday,1,Clear,0.62,0.6212,0.46,0.1343,46,103,149,654,149,149
1757,2011-03-18,Spring,2011,Mar,21,0,Friday,1,Clear,0.62,0.6212,0.46,0.1045,22,91,113,654,113,113
1758,2011-03-18,Spring,2011,Mar,22,0,Friday,1,Clear,0.62,0.6212,0.5,0.1642,55,63,118,654,118,118
1759,2011-03-18,Spring,2011,Mar,23,0,Friday,1,Misty,0.6,0.6212,0.53,0.2239,26,60,86,654,86,86
1760,2011-03-19,Spring,2011,Mar,0,0,Saturday,0,Misty,0.6,0.6212,0.53,0.2537,26,50,76,653,76,76
1761,2011-03-19,Spring,2011,Mar,1,0,Saturday,0,Misty,0.58,0.5455,0.46,0.3582,16,35,51,653,51,51
1762,2011-03-19,Spring,2011,Mar,2,0,Saturday,0,Misty,0.56,0.5303,0.43,0.2239,5,20,25,653,25,25
1763,2011-03-19,Spring,2011,Mar,3,0,Saturday,0,Misty,0.54,0.5152,0.39,0.3284,1,7,8,653,8,8
1764,2011-03-19,Spring,2011,Mar,4,0,Saturday,0,Clear,0.52,0.5,0.34,0.4179,1,2,3,653,3,3
1765,2011-03-19,Spring,2011,Mar,5,0,Saturday,0,Clear,0.52,0.5,0.34,0.4179,0,2,2,653,2,2
1766,2011-03-19,Spring,2011,Mar,6,0,Saturday,0,Clear,0.44,0.4394,0.44,0.4179,0,10,10,653,10,10
1767,2011-03-19,Spring,2011,Mar,7,0,Saturday,0,Clear,0.4,0.4091,0.5,0.3284,4,9,13,653,13,13
1768,2011-03-19,Spring,2011,Mar,8,0,Saturday,0,Clear,0.42,0.4242,0.47,0.4925,11,37,48,653,48,48
1769,2011-03-19,Spring,2011,Mar,9,0,Saturday,0,Clear,0.42,0.4242,0.44,0.4627,35,41,76,653,76,76
1770,2011-03-19,Spring,2011,Mar,10,0,Saturday,0,Clear,0.44,0.4394,0.38,0.4179,55,85,140,653,140,140
1771,2011-03-19,Spring,2011,Mar,11,0,Saturday,0,Clear,0.46,0.4545,0.36,0.4478,90,106,196,653,196,196
1772,2011-03-19,Spring,2011,Mar,12,0,Saturday,0,Clear,0.46,0.4545,0.33,0.4179,126,141,267,653,267,267
1773,2011-03-19,Spring,2011,Mar,13,0,Saturday,0,Clear,0.5,0.4848,0.34,0.4627,174,127,301,653,301,301
1774,2011-03-19,Spring,2011,Mar,14,0,Saturday,0,Clear,0.5,0.4848,0.31,0.4925,168,144,312,653,312,312
1775,2011-03-19,Spring,2011,Mar,15,0,Saturday,0,Clear,0.5,0.4848,0.29,0.4179,170,143,313,653,313,313
1776,2011-03-19,Spring,2011,Mar,16,0,Saturday,0,Clear,0.5,0.4848,0.31,0.3881,175,129,304,653,304,304
1777,2011-03-19,Spring,2011,Mar,17,0,Saturday,0,Clear,0.48,0.4697,0.31,0.3284,138,140,278,653,278,278
1778,2011-03-19,Spring,2011,Mar,18,0,Saturday,0,Clear,0.46,0.4545,0.31,0.3284,92,125,217,653,217,217
1779,2011-03-19,Spring,2011,Mar,19,0,Saturday,0,Clear,0.44,0.4394,0.33,0.2836,38,116,154,653,154,154
1780,2011-03-19,Spring,2011,Mar,20,0,Saturday,0,Clear,0.42,0.4242,0.35,0.2239,39,69,108,653,108,108
1781,2011-03-19,Spring,2011,Mar,21,0,Saturday,0,Clear,0.4,0.4091,0.37,0.2985,20,73,93,653,93,93
1782,2011-03-19,Spring,2011,Mar,22,0,Saturday,0,Clear,0.4,0.4091,0.37,0.3284,27,45,72,653,72,72
1783,2011-03-19,Spring,2011,Mar,23,0,Saturday,0,Clear,0.38,0.3939,0.4,0.2985,13,37,50,653,50,50
1784,2011-03-20,Spring,2011,Mar,0,0,Sunday,0,Clear,0.34,0.303,0.49,0.4179,7,33,40,652,40,40
1785,2011-03-20,Spring,2011,Mar,1,0,Sunday,0,Clear,0.32,0.2879,0.53,0.3582,2,22,24,652,24,24
1786,2011-03-20,Spring,2011,Mar,2,0,Sunday,0,Clear,0.3,0.2879,0.52,0.2836,6,24,30,652,30,30
1787,2011-03-20,Spring,2011,Mar,3,0,Sunday,0,Clear,0.28,0.2727,0.56,0.2537,1,11,12,652,12,12
1788,2011-03-20,Spring,2011,Mar,4,0,Sunday,0,Clear,0.26,0.2576,0.56,0.2239,2,1,3,652,3,3
1789,2011-03-20,Spring,2011,Mar,5,0,Sunday,0,Clear,0.26,0.2576,0.6,0.194,3,6,9,652,9,9
1790,2011-03-20,Spring,2011,Mar,6,0,Sunday,0,Clear,0.26,0.2576,0.6,0.2239,1,3,4,652,4,4
1791,2011-03-20,Spring,2011,Mar,7,0,Sunday,0,Clear,0.24,0.2273,0.6,0.2239,5,9,14,652,14,14
1792,2011-03-20,Spring,2011,Mar,8,0,Sunday,0,Clear,0.28,0.2727,0.56,0.1642,7,30,37,652,37,37
1793,2011-03-20,Spring,2011,Mar,9,0,Sunday,0,Clear,0.3,0.303,0.52,0.1343,35,43,78,652,78,78
1794,2011-03-20,Spring,2011,Mar,10,0,Sunday,0,Misty,0.32,0.3485,0.45,0.0,55,81,136,652,136,136
1795,2011-03-20,Spring,2011,Mar,11,0,Sunday,0,Clear,0.34,0.3485,0.39,0.1045,92,111,203,652,203,203
1796,2011-03-20,Spring,2011,Mar,12,0,Sunday,0,Clear,0.36,0.3636,0.4,0.1045,120,108,228,652,228,228
1797,2011-03-20,Spring,2011,Mar,13,0,Sunday,0,Clear,0.38,0.3939,0.34,0.0,88,115,203,652,203,203
1798,2011-03-20,Spring,2011,Mar,14,0,Sunday,0,Clear,0.4,0.4091,0.3,0.0,145,134,279,652,279,279
1799,2011-03-20,Spring,2011,Mar,15,0,Sunday,0,Clear,0.4,0.4091,0.32,0.0896,172,136,308,652,308,308
1800,2011-03-20,Spring,2011,Mar,16,0,Sunday,0,Clear,0.42,0.4242,0.32,0.0,92,132,224,652,224,224
1801,2011-03-20,Spring,2011,Mar,17,0,Sunday,0,Clear,0.4,0.4091,0.35,0.2836,83,143,226,652,226,226
1802,2011-03-20,Spring,2011,Mar,18,0,Sunday,0,Clear,0.38,0.3939,0.4,0.3582,58,98,156,652,156,156
1803,2011-03-20,Spring,2011,Mar,19,0,Sunday,0,Clear,0.36,0.3333,0.43,0.2836,21,58,79,652,79,79
1804,2011-03-20,Spring,2011,Mar,20,0,Sunday,0,Clear,0.36,0.3333,0.46,0.2836,21,46,67,652,67,67
1805,2011-03-20,Spring,2011,Mar,21,0,Sunday,0,Misty,0.34,0.3182,0.53,0.2836,10,39,49,652,49,49
1806,2011-03-20,Spring,2011,Mar,22,0,Sunday,0,Misty,0.34,0.303,0.53,0.3284,8,30,38,652,38,38
1807,2011-03-20,Spring,2011,Mar,23,0,Sunday,0,Light_rainsnow,0.34,0.303,0.61,0.3881,13,11,24,652,24,24
1808,2011-03-21,Summer,2011,Mar,0,0,Monday,1,Light_rainsnow,0.34,0.303,0.66,0.3881,2,11,13,651,13,13
1809,2011-03-21,Summer,2011,Mar,1,0,Monday,1,Misty,0.34,0.303,0.71,0.3881,1,6,7,651,7,7
1810,2011-03-21,Summer,2011,Mar,2,0,Monday,1,Misty,0.34,0.303,0.71,0.3284,1,5,6,651,6,6
1811,2011-03-21,Summer,2011,Mar,3,0,Monday,1,Misty,0.34,0.303,0.71,0.3284,0,1,1,651,1,1
1812,2011-03-21,Summer,2011,Mar,5,0,Monday,1,Clear,0.32,0.303,0.81,0.2985,1,1,2,651,2,2
1813,2011-03-21,Summer,2011,Mar,6,0,Monday,1,Light_rainsnow,0.32,0.303,0.76,0.2537,2,30,32,651,32,32
1814,2011-03-21,Summer,2011,Mar,7,0,Monday,1,Light_rainsnow,0.3,0.2727,0.87,0.4179,3,15,18,651,18,18
1815,2011-03-21,Summer,2011,Mar,8,0,Monday,1,Misty,0.3,0.2727,0.87,0.4179,3,95,98,651,98,98
1816,2011-03-21,Summer,2011,Mar,9,0,Monday,1,Misty,0.34,0.303,0.81,0.3284,12,115,127,651,127,127
1817,2011-03-21,Summer,2011,Mar,10,0,Monday,1,Misty,0.38,0.3939,0.76,0.3881,17,45,62,651,62,62
1818,2011-03-21,Summer,2011,Mar,11,0,Monday,1,Misty,0.42,0.4242,0.71,0.2985,32,47,79,651,79,79
1819,2011-03-21,Summer,2011,Mar,12,0,Monday,1,Misty,0.44,0.4394,0.77,0.2537,25,56,81,651,81,81
1820,2011-03-21,Summer,2011,Mar,13,0,Monday,1,Misty,0.5,0.4848,0.63,0.2239,35,77,112,651,112,112
1821,2011-03-21,Summer,2011,Mar,14,0,Monday,1,Misty,0.54,0.5152,0.64,0.2239,36,65,101,651,101,101
1822,2011-03-21,Summer,2011,Mar,15,0,Monday,1,Misty,0.56,0.5303,0.6,0.2239,41,66,107,651,107,107
1823,2011-03-21,Summer,2011,Mar,16,0,Monday,1,Misty,0.54,0.5152,0.64,0.2836,29,112,141,651,141,141
1824,2011-03-21,Summer,2011,Mar,17,0,Monday,1,Misty,0.54,0.5152,0.64,0.2537,41,231,272,651,272,272
1825,2011-03-21,Summer,2011,Mar,18,0,Monday,1,Misty,0.52,0.5,0.72,0.2239,44,232,276,651,276,276
1826,2011-03-21,Summer,2011,Mar,19,0,Monday,1,Clear,0.58,0.5455,0.6,0.4179,22,199,221,651,221,221
1827,2011-03-21,Summer,2011,Mar,20,0,Monday,1,Clear,0.56,0.5303,0.64,0.194,16,106,122,651,122,122
1828,2011-03-21,Summer,2011,Mar,21,0,Monday,1,Clear,0.46,0.4545,0.94,0.194,12,79,91,651,91,91
1829,2011-03-21,Summer,2011,Mar,22,0,Monday,1,Clear,0.46,0.4545,0.88,0.2239,18,60,78,651,78,78
1830,2011-03-21,Summer,2011,Mar,23,0,Monday,1,Clear,0.46,0.4545,0.88,0.0896,8,22,30,651,30,30
1831,2011-03-22,Summer,2011,Mar,0,0,Tuesday,1,Clear,0.46,0.4545,0.88,0.194,4,7,11,650,11,11
1832,2011-03-22,Summer,2011,Mar,1,0,Tuesday,1,Clear,0.42,0.4242,1.0,0.1343,6,13,19,650,19,19
1833,2011-03-22,Summer,2011,Mar,2,0,Tuesday,1,Clear,0.44,0.4394,0.94,0.0896,0,1,1,650,1,1
1834,2011-03-22,Summer,2011,Mar,3,0,Tuesday,1,Clear,0.44,0.4394,0.82,0.2239,3,2,5,650,5,5
1835,2011-03-22,Summer,2011,Mar,4,0,Tuesday,1,Misty,0.42,0.4242,0.82,0.1642,0,1,1,650,1,1
1836,2011-03-22,Summer,2011,Mar,5,0,Tuesday,1,Misty,0.4,0.4091,0.87,0.1343,1,11,12,650,12,12
1837,2011-03-22,Summer,2011,Mar,6,0,Tuesday,1,Clear,0.4,0.4091,0.87,0.2537,2,58,60,650,60,60
1838,2011-03-22,Summer,2011,Mar,7,0,Tuesday,1,Misty,0.4,0.4091,0.76,0.1045,4,132,136,650,136,136
1839,2011-03-22,Summer,2011,Mar,8,0,Tuesday,1,Misty,0.4,0.4091,0.58,0.2985,24,312,336,650,336,336
1840,2011-03-22,Summer,2011,Mar,9,0,Tuesday,1,Misty,0.4,0.4091,0.58,0.4627,19,159,178,650,178,178
1841,2011-03-22,Summer,2011,Mar,10,0,Tuesday,1,Misty,0.44,0.4394,0.54,0.2985,29,95,124,650,124,124
1842,2011-03-22,Summer,2011,Mar,11,0,Tuesday,1,Clear,0.44,0.4394,0.51,0.3284,22,64,86,650,86,86
1843,2011-03-22,Summer,2011,Mar,12,0,Tuesday,1,Clear,0.46,0.4545,0.47,0.2537,35,86,121,650,121,121
1844,2011-03-22,Summer,2011,Mar,13,0,Tuesday,1,Clear,0.5,0.4848,0.45,0.2239,21,85,106,650,106,106
1845,2011-03-22,Summer,2011,Mar,14,0,Tuesday,1,Clear,0.5,0.4848,0.42,0.3284,30,71,101,650,101,101
1846,2011-03-22,Summer,2011,Mar,15,0,Tuesday,1,Clear,0.5,0.4848,0.42,0.2239,55,79,134,650,134,134
1847,2011-03-22,Summer,2011,Mar,16,0,Tuesday,1,Clear,0.5,0.4848,0.42,0.1045,40,125,165,650,165,165
1848,2011-03-22,Summer,2011,Mar,17,0,Tuesday,1,Clear,0.5,0.4848,0.42,0.1045,42,265,307,650,307,307
1849,2011-03-22,Summer,2011,Mar,18,0,Tuesday,1,Clear,0.48,0.4697,0.44,0.0896,41,271,312,650,312,312
1850,2011-03-22,Summer,2011,Mar,19,0,Tuesday,1,Misty,0.44,0.4394,0.54,0.2537,22,142,164,650,164,164
1851,2011-03-22,Summer,2011,Mar,20,0,Tuesday,1,Misty,0.44,0.4394,0.54,0.3582,19,116,135,650,135,135
1852,2011-03-22,Summer,2011,Mar,21,0,Tuesday,1,Misty,0.42,0.4242,0.54,0.2836,24,63,87,650,87,87
1853,2011-03-22,Summer,2011,Mar,22,0,Tuesday,1,Misty,0.4,0.4091,0.58,0.2537,13,57,70,650,70,70
1854,2011-03-22,Summer,2011,Mar,23,0,Tuesday,1,Misty,0.4,0.4091,0.58,0.2537,4,28,32,650,32,32
1855,2011-03-23,Summer,2011,Mar,0,0,Wednesday,1,Light_rainsnow,0.36,0.3485,0.71,0.2239,3,8,11,649,11,11
1856,2011-03-23,Summer,2011,Mar,1,0,Wednesday,1,Light_rainsnow,0.34,0.3182,0.76,0.2239,0,7,7,649,7,7
1857,2011-03-23,Summer,2011,Mar,2,0,Wednesday,1,Light_rainsnow,0.34,0.3182,0.76,0.2239,1,1,2,649,2,2
1858,2011-03-23,Summer,2011,Mar,3,0,Wednesday,1,Misty,0.34,0.3182,0.76,0.2537,0,3,3,649,3,3
1859,2011-03-23,Summer,2011,Mar,5,0,Wednesday,1,Light_rainsnow,0.32,0.3182,0.87,0.194,0,10,10,649,10,10
1860,2011-03-23,Summer,2011,Mar,6,0,Wednesday,1,Misty,0.34,0.3182,0.87,0.2537,1,43,44,649,44,44
1861,2011-03-23,Summer,2011,Mar,7,0,Wednesday,1,Misty,0.32,0.303,0.93,0.2239,7,111,118,649,118,118
1862,2011-03-23,Summer,2011,Mar,8,0,Wednesday,1,Misty,0.32,0.3182,0.87,0.194,14,247,261,649,261,261
1863,2011-03-23,Summer,2011,Mar,9,0,Wednesday,1,Misty,0.32,0.303,0.81,0.2537,8,174,182,649,182,182
1864,2011-03-23,Summer,2011,Mar,10,0,Wednesday,1,Misty,0.34,0.3182,0.81,0.2836,15,60,75,649,75,75
1865,2011-03-23,Summer,2011,Mar,11,0,Wednesday,1,Misty,0.34,0.3333,0.87,0.194,18,53,71,649,71,71
1866,2011-03-23,Summer,2011,Mar,12,0,Wednesday,1,Misty,0.34,0.3182,0.87,0.2239,14,73,87,649,87,87
1867,2011-03-23,Summer,2011,Mar,13,0,Wednesday,1,Light_rainsnow,0.34,0.3333,0.87,0.1343,14,94,108,649,108,108
1868,2011-03-23,Summer,2011,Mar,14,0,Wednesday,1,Misty,0.36,0.3636,0.87,0.1045,13,71,84,649,84,84
1869,2011-03-23,Summer,2011,Mar,15,0,Wednesday,1,Misty,0.38,0.3939,0.82,0.2239,11,74,85,649,85,85
1870,2011-03-23,Summer,2011,Mar,16,0,Wednesday,1,Misty,0.4,0.4091,0.76,0.2239,13,123,136,649,136,136
1871,2011-03-23,Summer,2011,Mar,17,0,Wednesday,1,Misty,0.4,0.4091,0.76,0.2239,28,245,273,649,273,273
1872,2011-03-23,Summer,2011,Mar,18,0,Wednesday,1,Light_rainsnow,0.38,0.3939,0.82,0.2537,20,218,238,649,238,238
1873,2011-03-23,Summer,2011,Mar,19,0,Wednesday,1,Light_rainsnow,0.38,0.3939,0.82,0.2537,12,147,159,649,159,159
1874,2011-03-23,Summer,2011,Mar,20,0,Wednesday,1,Light_rainsnow,0.36,0.303,0.87,0.6418,3,72,75,649,75,75
1875,2011-03-23,Summer,2011,Mar,21,0,Wednesday,1,Light_rainsnow,0.32,0.2879,1.0,0.4179,0,22,22,649,22,22
1876,2011-03-23,Summer,2011,Mar,22,0,Wednesday,1,Misty,0.32,0.3182,0.93,0.1642,6,38,44,649,44,44
1877,2011-03-23,Summer,2011,Mar,23,0,Wednesday,1,Light_rainsnow,0.32,0.3333,0.9,0.0,2,24,26,649,26,26
1878,2011-03-24,Summer,2011,Mar,0,0,Thursday,1,Misty,0.32,0.303,0.93,0.2239,0,11,11,648,11,11
1879,2011-03-24,Summer,2011,Mar,1,0,Thursday,1,Misty,0.3,0.2879,1.0,0.2239,0,3,3,648,3,3
1880,2011-03-24,Summer,2011,Mar,2,0,Thursday,1,Misty,0.3,0.2879,1.0,0.2537,0,6,6,648,6,6
1881,2011-03-24,Summer,2011,Mar,3,0,Thursday,1,Misty,0.28,0.2727,1.0,0.194,1,0,1,648,1,1
1882,2011-03-24,Summer,2011,Mar,4,0,Thursday,1,Misty,0.28,0.2727,1.0,0.194,0,1,1,648,1,1
1883,2011-03-24,Summer,2011,Mar,5,0,Thursday,1,Misty,0.28,0.2727,0.93,0.2239,1,8,9,648,9,9
1884,2011-03-24,Summer,2011,Mar,6,0,Thursday,1,Misty,0.28,0.2727,0.93,0.2239,0,41,41,648,41,41
1885,2011-03-24,Summer,2011,Mar,7,0,Thursday,1,Light_rainsnow,0.26,0.2576,1.0,0.2239,2,106,108,648,108,108
1886,2011-03-24,Summer,2011,Mar,8,0,Thursday,1,Light_rainsnow,0.26,0.2273,1.0,0.2985,4,120,124,648,124,124
1887,2011-03-24,Summer,2011,Mar,9,0,Thursday,1,Misty,0.26,0.2576,0.93,0.2239,3,94,97,648,97,97
1888,2011-03-24,Summer,2011,Mar,10,0,Thursday,1,Misty,0.26,0.2273,0.93,0.3284,10,55,65,648,65,65
1889,2011-03-24,Summer,2011,Mar,11,0,Thursday,1,Misty,0.3,0.2727,0.81,0.2985,10,61,71,648,71,71
1890,2011-03-24,Summer,2011,Mar,12,0,Thursday,1,Misty,0.3,0.2727,0.7,0.3284,12,82,94,648,94,94
1891,2011-03-24,Summer,2011,Mar,13,0,Thursday,1,Misty,0.32,0.303,0.7,0.2239,11,90,101,648,101,101
1892,2011-03-24,Summer,2011,Mar,14,0,Thursday,1,Misty,0.3,0.303,0.7,0.1343,17,66,83,648,83,83
1893,2011-03-24,Summer,2011,Mar,15,0,Thursday,1,Misty,0.3,0.2879,0.7,0.2537,13,77,90,648,90,90
1894,2011-03-24,Summer,2011,Mar,16,0,Thursday,1,Misty,0.3,0.2879,0.65,0.2239,6,78,84,648,84,84
1895,2011-03-24,Summer,2011,Mar,17,0,Thursday,1,Misty,0.3,0.2879,0.7,0.2239,12,221,233,648,233,233
1896,2011-03-24,Summer,2011,Mar,18,0,Thursday,1,Misty,0.3,0.2727,0.61,0.2985,17,197,214,648,214,214
1897,2011-03-24,Summer,2011,Mar,19,0,Thursday,1,Clear,0.3,0.2727,0.56,0.3881,16,122,138,648,138,138
1898,2011-03-24,Summer,2011,Mar,20,0,Thursday,1,Clear,0.28,0.2576,0.61,0.2836,8,110,118,648,118,118
1899,2011-03-24,Summer,2011,Mar,21,0,Thursday,1,Clear,0.26,0.2576,0.65,0.2239,11,67,78,648,78,78
1900,2011-03-24,Summer,2011,Mar,22,0,Thursday,1,Clear,0.26,0.2576,0.65,0.1642,3,59,62,648,62,62
1901,2011-03-24,Summer,2011,Mar,23,0,Thursday,1,Clear,0.24,0.2273,0.65,0.194,9,24,33,648,33,33
1902,2011-03-25,Summer,2011,Mar,0,0,Friday,1,Clear,0.24,0.2273,0.6,0.194,1,17,18,647,18,18
1903,2011-03-25,Summer,2011,Mar,1,0,Friday,1,Clear,0.2,0.2121,0.69,0.1642,0,5,5,647,5,5
1904,2011-03-25,Summer,2011,Mar,2,0,Friday,1,Clear,0.2,0.197,0.69,0.2239,0,5,5,647,5,5
1905,2011-03-25,Summer,2011,Mar,3,0,Friday,1,Clear,0.2,0.2273,0.69,0.1045,0,2,2,647,2,2
1906,2011-03-25,Summer,2011,Mar,4,0,Friday,1,Clear,0.18,0.2121,0.74,0.1045,3,2,5,647,5,5
1907,2011-03-25,Summer,2011,Mar,5,0,Friday,1,Clear,0.18,0.197,0.74,0.1642,0,9,9,647,9,9
1908,2011-03-25,Summer,2011,Mar,6,0,Friday,1,Clear,0.18,0.1818,0.74,0.2239,0,32,32,647,32,32
1909,2011-03-25,Summer,2011,Mar,7,0,Friday,1,Clear,0.2,0.1818,0.59,0.3582,4,100,104,647,104,104
1910,2011-03-25,Summer,2011,Mar,8,0,Friday,1,Clear,0.22,0.2121,0.51,0.2836,9,228,237,647,237,237
1911,2011-03-25,Summer,2011,Mar,9,0,Friday,1,Clear,0.24,0.2121,0.48,0.2985,16,150,166,647,166,166
1912,2011-03-25,Summer,2011,Mar,10,0,Friday,1,Clear,0.26,0.2576,0.48,0.0,15,53,68,647,68,68
1913,2011-03-25,Summer,2011,Mar,11,0,Friday,1,Clear,0.3,0.2879,0.45,0.2836,17,58,75,647,75,75
1914,2011-03-25,Summer,2011,Mar,12,0,Friday,1,Clear,0.32,0.303,0.42,0.2537,37,108,145,647,145,145
1915,2011-03-25,Summer,2011,Mar,13,0,Friday,1,Clear,0.32,0.3182,0.39,0.194,34,104,138,647,138,138
1916,2011-03-25,Summer,2011,Mar,14,0,Friday,1,Clear,0.36,0.3333,0.32,0.3284,30,103,133,647,133,133
1917,2011-03-25,Summer,2011,Mar,15,0,Friday,1,Misty,0.34,0.3182,0.36,0.2537,43,79,122,647,122,122
1918,2011-03-25,Summer,2011,Mar,16,0,Friday,1,Misty,0.34,0.303,0.34,0.2985,23,127,150,647,150,150
1919,2011-03-25,Summer,2011,Mar,17,0,Friday,1,Misty,0.32,0.2879,0.36,0.3582,23,202,225,647,225,225
1920,2011-03-25,Summer,2011,Mar,18,0,Friday,1,Clear,0.3,0.2879,0.39,0.2537,8,190,198,647,198,198
1921,2011-03-25,Summer,2011,Mar,19,0,Friday,1,Misty,0.3,0.2879,0.36,0.2836,9,126,135,647,135,135
1922,2011-03-25,Summer,2011,Mar,20,0,Friday,1,Misty,0.3,0.303,0.39,0.1343,6,75,81,647,81,81
1923,2011-03-25,Summer,2011,Mar,21,0,Friday,1,Misty,0.3,0.303,0.39,0.1642,11,64,75,647,75,75
1924,2011-03-25,Summer,2011,Mar,22,0,Friday,1,Misty,0.28,0.2576,0.38,0.3284,3,40,43,647,43,43
1925,2011-03-25,Summer,2011,Mar,23,0,Friday,1,Misty,0.26,0.2424,0.38,0.2836,8,31,39,647,39,39
1926,2011-03-26,Summer,2011,Mar,0,0,Saturday,0,Misty,0.26,0.2424,0.38,0.2836,3,25,28,646,28,28
1927,2011-03-26,Summer,2011,Mar,1,0,Saturday,0,Clear,0.26,0.2273,0.38,0.2985,3,24,27,646,27,27
1928,2011-03-26,Summer,2011,Mar,2,0,Saturday,0,Clear,0.22,0.2121,0.44,0.2239,4,21,25,646,25,25
1929,2011-03-26,Summer,2011,Mar,3,0,Saturday,0,Clear,0.2,0.197,0.47,0.194,2,7,9,646,9,9
1930,2011-03-26,Summer,2011,Mar,4,0,Saturday,0,Clear,0.22,0.2121,0.44,0.2239,2,4,6,646,6,6
1931,2011-03-26,Summer,2011,Mar,5,0,Saturday,0,Clear,0.2,0.197,0.51,0.194,0,8,8,646,8,8
1932,2011-03-26,Summer,2011,Mar,6,0,Saturday,0,Clear,0.18,0.1818,0.55,0.194,2,8,10,646,10,10
1933,2011-03-26,Summer,2011,Mar,7,0,Saturday,0,Clear,0.2,0.197,0.51,0.194,18,23,41,646,41,41
1934,2011-03-26,Summer,2011,Mar,8,0,Saturday,0,Clear,0.22,0.2273,0.44,0.1343,24,42,66,646,66,66
1935,2011-03-26,Summer,2011,Mar,9,0,Saturday,0,Clear,0.24,0.2424,0.41,0.1343,32,68,100,646,100,100
1936,2011-03-26,Summer,2011,Mar,10,0,Saturday,0,Clear,0.26,0.2576,0.41,0.1642,32,93,125,646,125,125
1937,2011-03-26,Summer,2011,Mar,11,0,Saturday,0,Clear,0.28,0.2727,0.38,0.1642,75,93,168,646,168,168
1938,2011-03-26,Summer,2011,Mar,12,0,Saturday,0,Clear,0.3,0.2879,0.36,0.194,98,129,227,646,227,227
1939,2011-03-26,Summer,2011,Mar,13,0,Saturday,0,Clear,0.32,0.303,0.33,0.2239,94,145,239,646,239,239
1940,2011-03-26,Summer,2011,Mar,14,0,Saturday,0,Clear,0.34,0.3182,0.29,0.2239,93,123,216,646,216,216
1941,2011-03-26,Summer,2011,Mar,15,0,Saturday,0,Clear,0.34,0.3333,0.29,0.194,110,109,219,646,219,219
1942,2011-03-26,Summer,2011,Mar,16,0,Saturday,0,Clear,0.34,0.3333,0.23,0.194,118,130,248,646,248,248
1943,2011-03-26,Summer,2011,Mar,17,0,Saturday,0,Clear,0.32,0.303,0.24,0.2239,102,101,203,646,203,203
1944,2011-03-26,Summer,2011,Mar,18,0,Saturday,0,Misty,0.32,0.3182,0.21,0.1642,64,89,153,646,153,153
1945,2011-03-26,Summer,2011,Mar,19,0,Saturday,0,Misty,0.28,0.2727,0.45,0.2537,45,93,138,646,138,138
1946,2011-03-26,Summer,2011,Mar,20,0,Saturday,0,Misty,0.28,0.2727,0.45,0.2537,18,67,85,646,85,85
1947,2011-03-26,Summer,2011,Mar,21,0,Saturday,0,Misty,0.26,0.2576,0.44,0.194,15,36,51,646,51,51
1948,2011-03-26,Summer,2011,Mar,22,0,Saturday,0,Misty,0.28,0.2727,0.41,0.2239,17,46,63,646,63,63
1949,2011-03-26,Summer,2011,Mar,23,0,Saturday,0,Misty,0.26,0.2424,0.44,0.2836,10,31,41,646,41,41
1950,2011-03-27,Summer,2011,Mar,0,0,Sunday,0,Misty,0.26,0.2576,0.41,0.1642,5,26,31,645,31,31
1951,2011-03-27,Summer,2011,Mar,1,0,Sunday,0,Misty,0.24,0.2273,0.52,0.194,3,17,20,645,20,20
1952,2011-03-27,Summer,2011,Mar,2,0,Sunday,0,Light_rainsnow,0.22,0.2273,0.55,0.194,6,15,21,645,21,21
1953,2011-03-27,Summer,2011,Mar,3,0,Sunday,0,Light_rainsnow,0.2,0.197,0.69,0.2239,0,14,14,645,14,14
1954,2011-03-27,Summer,2011,Mar,4,0,Sunday,0,Light_rainsnow,0.18,0.197,0.74,0.1642,1,5,6,645,6,6
1955,2011-03-27,Summer,2011,Mar,6,0,Sunday,0,Light_rainsnow,0.16,0.1818,0.86,0.1343,0,2,2,645,2,2
1956,2011-03-27,Summer,2011,Mar,7,0,Sunday,0,Light_rainsnow,0.16,0.1667,0.86,0.1642,0,7,7,645,7,7
1957,2011-03-27,Summer,2011,Mar,8,0,Sunday,0,Clear,0.2,0.197,0.69,0.2239,6,8,14,645,14,14
1958,2011-03-27,Summer,2011,Mar,9,0,Sunday,0,Clear,0.22,0.2273,0.55,0.1343,17,37,54,645,54,54
1959,2011-03-27,Summer,2011,Mar,10,0,Sunday,0,Misty,0.22,0.2121,0.55,0.2239,27,59,86,645,86,86
1960,2011-03-27,Summer,2011,Mar,11,0,Sunday,0,Misty,0.24,0.2424,0.48,0.1642,23,85,108,645,108,108
1961,2011-03-27,Summer,2011,Mar,12,0,Sunday,0,Misty,0.26,0.2576,0.44,0.2239,43,120,163,645,163,163
1962,2011-03-27,Summer,2011,Mar,13,0,Sunday,0,Clear,0.3,0.2879,0.39,0.2239,47,100,147,645,147,147
1963,2011-03-27,Summer,2011,Mar,14,0,Sunday,0,Clear,0.32,0.3182,0.36,0.1642,61,103,164,645,164,164
1964,2011-03-27,Summer,2011,Mar,15,0,Sunday,0,Clear,0.32,0.303,0.36,0.2836,61,111,172,645,172,172
1965,2011-03-27,Summer,2011,Mar,16,0,Sunday,0,Clear,0.34,0.3333,0.34,0.0,45,98,143,645,143,143
1966,2011-03-27,Summer,2011,Mar,17,0,Sunday,0,Clear,0.32,0.303,0.31,0.2537,50,109,159,645,159,159
1967,2011-03-27,Summer,2011,Mar,18,0,Sunday,0,Clear,0.3,0.2879,0.33,0.194,32,105,137,645,137,137
1968,2011-03-27,Summer,2011,Mar,19,0,Sunday,0,Clear,0.3,0.2879,0.31,0.2239,23,80,103,645,103,103
1969,2011-03-27,Summer,2011,Mar,20,0,Sunday,0,Clear,0.28,0.2727,0.36,0.1642,7,50,57,645,57,57
1970,2011-03-27,Summer,2011,Mar,21,0,Sunday,0,Clear,0.26,0.2576,0.41,0.1642,7,29,36,645,36,36
1971,2011-03-27,Summer,2011,Mar,22,0,Sunday,0,Clear,0.26,0.2576,0.41,0.1642,5,25,30,645,30,30
1972,2011-03-27,Summer,2011,Mar,23,0,Sunday,0,Clear,0.26,0.2576,0.44,0.194,3,16,19,645,19,19
1973,2011-03-28,Summer,2011,Mar,0,0,Monday,1,Clear,0.22,0.2273,0.55,0.194,1,11,12,644,12,12
1974,2011-03-28,Summer,2011,Mar,1,0,Monday,1,Clear,0.22,0.2273,0.44,0.194,2,4,6,644,6,6
1975,2011-03-28,Summer,2011,Mar,2,0,Monday,1,Clear,0.22,0.2273,0.44,0.1642,0,5,5,644,5,5
1976,2011-03-28,Summer,2011,Mar,3,0,Monday,1,Clear,0.22,0.2273,0.44,0.1642,0,2,2,644,2,2
1977,2011-03-28,Summer,2011,Mar,5,0,Monday,1,Clear,0.18,0.1818,0.43,0.194,0,8,8,644,8,8
1978,2011-03-28,Summer,2011,Mar,6,0,Monday,1,Clear,0.18,0.1667,0.34,0.2836,0,40,40,644,40,40
1979,2011-03-28,Summer,2011,Mar,7,0,Monday,1,Clear,0.2,0.1818,0.32,0.3284,6,104,110,644,110,110
1980,2011-03-28,Summer,2011,Mar,8,0,Monday,1,Clear,0.2,0.197,0.34,0.2239,15,239,254,644,254,254
1981,2011-03-28,Summer,2011,Mar,9,0,Monday,1,Misty,0.22,0.2121,0.32,0.2239,12,109,121,644,121,121
1982,2011-03-28,Summer,2011,Mar,10,0,Monday,1,Clear,0.24,0.2273,0.3,0.194,22,47,69,644,69,69
1983,2011-03-28,Summer,2011,Mar,11,0,Monday,1,Misty,0.26,0.2424,0.3,0.2836,18,39,57,644,57,57
1984,2011-03-28,Summer,2011,Mar,12,0,Monday,1,Misty,0.26,0.2727,0.25,0.0,8,71,79,644,79,79
1985,2011-03-28,Summer,2011,Mar,13,0,Monday,1,Misty,0.3,0.2879,0.24,0.2239,14,69,83,644,83,83
1986,2011-03-28,Summer,2011,Mar,14,0,Monday,1,Clear,0.32,0.303,0.22,0.2239,15,65,80,644,80,80
1987,2011-03-28,Summer,2011,Mar,15,0,Monday,1,Clear,0.32,0.303,0.24,0.2836,19,53,72,644,72,72
1988,2011-03-28,Summer,2011,Mar,16,0,Monday,1,Clear,0.34,0.3182,0.23,0.2239,15,117,132,644,132,132
1989,2011-03-28,Summer,2011,Mar,17,0,Monday,1,Clear,0.34,0.303,0.23,0.2985,25,227,252,644,252,252
1990,2011-03-28,Summer,2011,Mar,18,0,Monday,1,Clear,0.32,0.303,0.21,0.2836,21,220,241,644,241,241
1991,2011-03-28,Summer,2011,Mar,19,0,Monday,1,Clear,0.3,0.303,0.22,0.1343,17,156,173,644,173,173
1992,2011-03-28,Summer,2011,Mar,20,0,Monday,1,Clear,0.32,0.3333,0.22,0.1045,5,107,112,644,112,112
1993,2011-03-28,Summer,2011,Mar,21,0,Monday,1,Clear,0.32,0.3333,0.21,0.1343,6,55,61,644,61,61
1994,2011-03-28,Summer,2011,Mar,22,0,Monday,1,Clear,0.3,0.2879,0.22,0.2239,0,40,40,644,40,40
1995,2011-03-28,Summer,2011,Mar,23,0,Monday,1,Clear,0.28,0.2576,0.24,0.2985,1,18,19,644,19,19
1996,2011-03-29,Summer,2011,Mar,0,0,Tuesday,1,Clear,0.26,0.2273,0.28,0.3284,1,15,16,643,16,16
1997,2011-03-29,Summer,2011,Mar,1,0,Tuesday,1,Clear,0.24,0.2121,0.32,0.2985,0,4,4,643,4,4
1998,2011-03-29,Summer,2011,Mar,2,0,Tuesday,1,Clear,0.24,0.2121,0.32,0.2985,0,3,3,643,3,3
1999,2011-03-29,Summer,2011,Mar,3,0,Tuesday,1,Clear,0.24,0.2121,0.32,0.2985,2,1,3,643,3,3
2000,2011-03-29,Summer,2011,Mar,4,0,Tuesday,1,Clear,0.2,0.2121,0.44,0.1642,1,1,2,643,2,2
2001,2011-03-29,Summer,2011,Mar,5,0,Tuesday,1,Clear,0.22,0.2121,0.37,0.2537,0,8,8,643,8,8
2002,2011-03-29,Summer,2011,Mar,6,0,Tuesday,1,Clear,0.22,0.2121,0.41,0.2985,4,46,50,643,50,50
2003,2011-03-29,Summer,2011,Mar,7,0,Tuesday,1,Clear,0.22,0.197,0.41,0.3582,5,128,133,643,133,133
2004,2011-03-29,Summer,2011,Mar,8,0,Tuesday,1,Clear,0.24,0.2121,0.35,0.3582,19,268,287,643,287,287
2005,2011-03-29,Summer,2011,Mar,9,0,Tuesday,1,Clear,0.28,0.2576,0.28,0.3881,16,156,172,643,172,172
2006,2011-03-29,Summer,2011,Mar,10,0,Tuesday,1,Clear,0.3,0.2727,0.24,0.2985,13,46,59,643,59,59
2007,2011-03-29,Summer,2011,Mar,11,0,Tuesday,1,Misty,0.34,0.303,0.25,0.3881,18,63,81,643,81,81
2008,2011-03-29,Summer,2011,Mar,12,0,Tuesday,1,Clear,0.34,0.3333,0.25,0.1642,29,77,106,643,106,106
2009,2011-03-29,Summer,2011,Mar,13,0,Tuesday,1,Clear,0.34,0.303,0.25,0.2985,24,80,104,643,104,104
2010,2011-03-29,Summer,2011,Mar,14,0,Tuesday,1,Clear,0.36,0.3333,0.25,0.2537,20,66,86,643,86,86
2011,2011-03-29,Summer,2011,Mar,15,0,Tuesday,1,Clear,0.38,0.3939,0.25,0.2239,22,65,87,643,87,87
2012,2011-03-29,Summer,2011,Mar,16,0,Tuesday,1,Clear,0.38,0.3939,0.22,0.1642,12,124,136,643,136,136
2013,2011-03-29,Summer,2011,Mar,17,0,Tuesday,1,Clear,0.4,0.4091,0.2,0.1343,34,265,299,643,299,299
2014,2011-03-29,Summer,2011,Mar,18,0,Tuesday,1,Clear,0.36,0.3636,0.21,0.0896,42,252,294,643,294,294
2015,2011-03-29,Summer,2011,Mar,19,0,Tuesday,1,Clear,0.34,0.3333,0.23,0.194,20,170,190,643,190,190
2016,2011-03-29,Summer,2011,Mar,20,0,Tuesday,1,Clear,0.36,0.3636,0.21,0.0896,13,119,132,643,132,132
2017,2011-03-29,Summer,2011,Mar,21,0,Tuesday,1,Clear,0.34,0.3636,0.42,0.0,8,75,83,643,83,83
2018,2011-03-29,Summer,2011,Mar,22,0,Tuesday,1,Clear,0.34,0.3636,0.49,0.0,6,49,55,643,55,55
2019,2011-03-29,Summer,2011,Mar,23,0,Tuesday,1,Misty,0.32,0.3333,0.57,0.1045,8,27,35,643,35,35
2020,2011-03-30,Summer,2011,Mar,0,0,Wednesday,1,Misty,0.32,0.3485,0.57,0.0,3,8,11,642,11,11
2021,2011-03-30,Summer,2011,Mar,1,0,Wednesday,1,Clear,0.32,0.3485,0.39,0.0,1,9,10,642,10,10
2022,2011-03-30,Summer,2011,Mar,2,0,Wednesday,1,Misty,0.32,0.3485,0.57,0.0,0,4,4,642,4,4
2023,2011-03-30,Summer,2011,Mar,3,0,Wednesday,1,Misty,0.32,0.3485,0.49,0.0,0,4,4,642,4,4
2024,2011-03-30,Summer,2011,Mar,4,0,Wednesday,1,Misty,0.32,0.3485,0.57,0.0,1,0,1,642,1,1
2025,2011-03-30,Summer,2011,Mar,5,0,Wednesday,1,Misty,0.3,0.2879,0.56,0.194,0,7,7,642,7,7
2026,2011-03-30,Summer,2011,Mar,6,0,Wednesday,1,Misty,0.3,0.303,0.49,0.1343,4,44,48,642,48,48
2027,2011-03-30,Summer,2011,Mar,7,0,Wednesday,1,Misty,0.32,0.3333,0.45,0.1045,8,128,136,642,136,136
2028,2011-03-30,Summer,2011,Mar,8,0,Wednesday,1,Misty,0.32,0.3182,0.49,0.1642,16,247,263,642,263,263
2029,2011-03-30,Summer,2011,Mar,9,0,Wednesday,1,Misty,0.32,0.303,0.45,0.2239,7,147,154,642,154,154
2030,2011-03-30,Summer,2011,Mar,10,0,Wednesday,1,Misty,0.34,0.3182,0.46,0.2239,13,51,64,642,64,64
2031,2011-03-30,Summer,2011,Mar,11,0,Wednesday,1,Misty,0.34,0.3182,0.46,0.2537,26,64,90,642,90,90
2032,2011-03-30,Summer,2011,Mar,12,0,Wednesday,1,Misty,0.34,0.3333,0.46,0.1642,15,65,80,642,80,80
2033,2011-03-30,Summer,2011,Mar,13,0,Wednesday,1,Misty,0.36,0.3485,0.46,0.2239,14,84,98,642,98,98
2034,2011-03-30,Summer,2011,Mar,14,0,Wednesday,1,Misty,0.36,0.3333,0.46,0.2985,16,64,80,642,80,80
2035,2011-03-30,Summer,2011,Mar,15,0,Wednesday,1,Light_rainsnow,0.28,0.2576,0.81,0.2985,14,56,70,642,70,70
2036,2011-03-30,Summer,2011,Mar,16,0,Wednesday,1,Light_rainsnow,0.28,0.2727,0.87,0.2537,0,36,36,642,36,36
2037,2011-03-30,Summer,2011,Mar,17,0,Wednesday,1,Light_rainsnow,0.26,0.2727,0.93,0.1045,11,105,116,642,116,116
2038,2011-03-30,Summer,2011,Mar,18,0,Wednesday,1,Misty,0.26,0.2576,0.93,0.2239,6,79,85,642,85,85
2039,2011-03-30,Summer,2011,Mar,19,0,Wednesday,1,Misty,0.26,0.2576,0.93,0.2239,5,67,72,642,72,72
2040,2011-03-30,Summer,2011,Mar,20,0,Wednesday,1,Light_rainsnow,0.24,0.2121,0.93,0.2985,4,40,44,642,44,44
2041,2011-03-30,Summer,2011,Mar,21,0,Wednesday,1,Misty,0.24,0.2273,0.93,0.2537,0,27,27,642,27,27
2042,2011-03-30,Summer,2011,Mar,22,0,Wednesday,1,Light_rainsnow,0.24,0.2273,0.93,0.2239,3,21,24,642,24,24
2043,2011-03-30,Summer,2011,Mar,23,0,Wednesday,1,Light_rainsnow,0.24,0.2121,0.93,0.2836,1,11,12,642,12,12
2044,2011-03-31,Summer,2011,Mar,0,0,Thursday,1,Light_rainsnow,0.24,0.2273,0.93,0.2239,0,3,3,641,3,3
2045,2011-03-31,Summer,2011,Mar,1,0,Thursday,1,Light_rainsnow,0.24,0.2273,0.93,0.194,1,4,5,641,5,5
2046,2011-03-31,Summer,2011,Mar,2,0,Thursday,1,Light_rainsnow,0.24,0.2273,0.93,0.194,0,5,5,641,5,5
2047,2011-03-31,Summer,2011,Mar,3,0,Thursday,1,Light_rainsnow,0.24,0.2273,0.93,0.2239,0,1,1,641,1,1
2048,2011-03-31,Summer,2011,Mar,4,0,Thursday,1,Light_rainsnow,0.24,0.2273,0.93,0.2537,0,2,2,641,2,2
2049,2011-03-31,Summer,2011,Mar,5,0,Thursday,1,Light_rainsnow,0.24,0.2273,0.93,0.2239,0,8,8,641,8,8
2050,2011-03-31,Summer,2011,Mar,6,0,Thursday,1,Light_rainsnow,0.24,0.2121,0.93,0.2985,2,34,36,641,36,36
2051,2011-03-31,Summer,2011,Mar,7,0,Thursday,1,Light_rainsnow,0.24,0.2273,0.93,0.2537,5,87,92,641,92,92
2052,2011-03-31,Summer,2011,Mar,8,0,Thursday,1,Misty,0.24,0.2273,1.0,0.2537,7,185,192,641,192,192
2053,2011-03-31,Summer,2011,Mar,9,0,Thursday,1,Light_rainsnow,0.26,0.2424,0.93,0.2537,6,126,132,641,132,132
2054,2011-03-31,Summer,2011,Mar,10,0,Thursday,1,Light_rainsnow,0.26,0.2424,0.93,0.2537,15,54,69,641,69,69
2055,2011-03-31,Summer,2011,Mar,11,0,Thursday,1,Light_rainsnow,0.28,0.2727,0.93,0.194,6,52,58,641,58,58
2056,2011-03-31,Summer,2011,Mar,12,0,Thursday,1,Light_rainsnow,0.28,0.2727,0.93,0.194,17,73,90,641,90,90
2057,2011-03-31,Summer,2011,Mar,13,0,Thursday,1,Light_rainsnow,0.3,0.303,0.87,0.1343,13,55,68,641,68,68
2058,2011-03-31,Summer,2011,Mar,14,0,Thursday,1,Light_rainsnow,0.3,0.303,0.87,0.1343,27,49,76,641,76,76
2059,2011-03-31,Summer,2011,Mar,15,0,Thursday,1,Light_rainsnow,0.3,0.2727,0.87,0.2985,4,61,65,641,65,65
2060,2011-03-31,Summer,2011,Mar,16,0,Thursday,1,Misty,0.3,0.2879,0.87,0.2537,13,72,85,641,85,85
2061,2011-03-31,Summer,2011,Mar,17,0,Thursday,1,Misty,0.3,0.2879,0.87,0.2537,15,153,168,641,168,168
2062,2011-03-31,Summer,2011,Mar,18,0,Thursday,1,Misty,0.3,0.303,0.87,0.1343,12,165,177,641,177,177
2063,2011-03-31,Summer,2011,Mar,19,0,Thursday,1,Misty,0.3,0.303,0.87,0.1343,12,118,130,641,130,130
2064,2011-03-31,Summer,2011,Mar,20,0,Thursday,1,Light_rainsnow,0.28,0.2576,0.93,0.2836,6,79,85,641,85,85
2065,2011-03-31,Summer,2011,Mar,21,0,Thursday,1,Misty,0.28,0.2727,0.93,0.1642,7,53,60,641,60,60
2066,2011-03-31,Summer,2011,Mar,22,0,Thursday,1,Light_rainsnow,0.28,0.2727,0.93,0.2537,7,44,51,641,51,51
2067,2011-03-31,Summer,2011,Mar,23,0,Thursday,1,Light_rainsnow,0.26,0.2576,1.0,0.1642,4,23,27,641,27,27
2068,2011-04-01,Summer,2011,Apr,0,0,Friday,1,Light_rainsnow,0.26,0.2576,1.0,0.1642,0,6,6,640,6,6
2069,2011-04-01,Summer,2011,Apr,1,0,Friday,1,Light_rainsnow,0.26,0.2576,1.0,0.1642,0,4,4,640,4,4
2070,2011-04-01,Summer,2011,Apr,2,0,Friday,1,Light_rainsnow,0.26,0.2576,0.93,0.194,0,7,7,640,7,7
2071,2011-04-01,Summer,2011,Apr,3,0,Friday,1,Misty,0.24,0.2273,0.93,0.2537,0,4,4,640,4,4
2072,2011-04-01,Summer,2011,Apr,4,0,Friday,1,Misty,0.24,0.2273,0.93,0.2537,0,3,3,640,3,3
2073,2011-04-01,Summer,2011,Apr,5,0,Friday,1,Light_rainsnow,0.24,0.2273,0.93,0.2239,1,11,12,640,12,12
2074,2011-04-01,Summer,2011,Apr,6,0,Friday,1,Light_rainsnow,0.24,0.2273,0.93,0.2239,2,26,28,640,28,28
2075,2011-04-01,Summer,2011,Apr,7,0,Friday,1,Light_rainsnow,0.24,0.2424,0.93,0.0,4,91,95,640,95,95
2076,2011-04-01,Summer,2011,Apr,8,0,Friday,1,Misty,0.26,0.2424,0.87,0.2537,8,198,206,640,206,206
2077,2011-04-01,Summer,2011,Apr,9,0,Friday,1,Clear,0.32,0.2879,0.7,0.3582,11,162,173,640,173,173
2078,2011-04-01,Summer,2011,Apr,10,0,Friday,1,Clear,0.32,0.303,0.66,0.2836,12,63,75,640,75,75
2079,2011-04-01,Summer,2011,Apr,11,0,Friday,1,Clear,0.32,0.2879,0.61,0.3582,17,72,89,640,89,89
2080,2011-04-01,Summer,2011,Apr,12,0,Friday,1,Clear,0.34,0.303,0.53,0.3582,15,80,95,640,95,95
2081,2011-04-01,Summer,2011,Apr,13,0,Friday,1,Clear,0.36,0.3333,0.5,0.3582,18,92,110,640,110,110
2082,2011-04-01,Summer,2011,Apr,14,0,Friday,1,Misty,0.36,0.3333,0.46,0.3582,26,61,87,640,87,87
2083,2011-04-01,Summer,2011,Apr,15,0,Friday,1,Clear,0.34,0.303,0.46,0.4179,30,81,111,640,111,111
2084,2011-04-01,Summer,2011,Apr,16,0,Friday,1,Clear,0.34,0.303,0.46,0.4179,42,125,167,640,167,167
2085,2011-04-01,Summer,2011,Apr,17,0,Friday,1,Clear,0.34,0.303,0.46,0.3284,36,245,281,640,281,281
2086,2011-04-01,Summer,2011,Apr,18,0,Friday,1,Clear,0.34,0.303,0.46,0.3284,36,205,241,640,241,241
2087,2011-04-01,Summer,2011,Apr,19,0,Friday,1,Clear,0.34,0.303,0.49,0.3284,16,120,136,640,136,136
2088,2011-04-01,Summer,2011,Apr,20,0,Friday,1,Clear,0.32,0.3182,0.53,0.194,2,75,77,640,77,77
2089,2011-04-01,Summer,2011,Apr,21,0,Friday,1,Clear,0.32,0.3333,0.53,0.1343,9,84,93,640,93,93
2090,2011-04-01,Summer,2011,Apr,22,0,Friday,1,Clear,0.3,0.303,0.56,0.1642,10,64,74,640,74,74
2091,2011-04-01,Summer,2011,Apr,23,0,Friday,1,Clear,0.3,0.3182,0.61,0.0896,12,41,53,640,53,53
2092,2011-04-02,Summer,2011,Apr,0,0,Saturday,0,Misty,0.3,0.3333,0.61,0.0,3,29,32,639,32,32
2093,2011-04-02,Summer,2011,Apr,1,0,Saturday,0,Clear,0.26,0.2727,0.65,0.1343,4,28,32,639,32,32
2094,2011-04-02,Summer,2011,Apr,2,0,Saturday,0,Clear,0.24,0.2424,0.75,0.1343,1,20,21,639,21,21
2095,2011-04-02,Summer,2011,Apr,3,0,Saturday,0,Clear,0.24,0.2424,0.7,0.1642,1,8,9,639,9,9
2096,2011-04-02,Summer,2011,Apr,4,0,Saturday,0,Clear,0.24,0.2424,0.7,0.1642,0,5,5,639,5,5
2097,2011-04-02,Summer,2011,Apr,5,0,Saturday,0,Misty,0.24,0.2424,0.75,0.1642,1,4,5,639,5,5
2098,2011-04-02,Summer,2011,Apr,6,0,Saturday,0,Clear,0.26,0.2727,0.7,0.1045,5,7,12,639,12,12
2099,2011-04-02,Summer,2011,Apr,7,0,Saturday,0,Misty,0.26,0.2727,0.7,0.1045,2,16,18,639,18,18
2100,2011-04-02,Summer,2011,Apr,8,0,Saturday,0,Clear,0.3,0.3182,0.7,0.1045,10,45,55,639,55,55
2101,2011-04-02,Summer,2011,Apr,9,0,Saturday,0,Misty,0.34,0.3485,0.66,0.1045,22,65,87,639,87,87
2102,2011-04-02,Summer,2011,Apr,10,0,Saturday,0,Misty,0.36,0.3485,0.57,0.1642,41,113,154,639,154,154
2103,2011-04-02,Summer,2011,Apr,11,0,Saturday,0,Misty,0.4,0.4091,0.47,0.1642,72,126,198,639,198,198
2104,2011-04-02,Summer,2011,Apr,12,0,Saturday,0,Light_rainsnow,0.32,0.3333,0.81,0.1343,84,100,184,639,184,184
2105,2011-04-02,Summer,2011,Apr,13,0,Saturday,0,Clear,0.34,0.3333,0.81,0.1343,56,81,137,639,137,137
2106,2011-04-02,Summer,2011,Apr,14,0,Saturday,0,Light_rainsnow,0.32,0.303,0.76,0.3284,97,93,190,639,190,190
2107,2011-04-02,Summer,2011,Apr,15,0,Saturday,0,Light_rainsnow,0.34,0.303,0.76,0.3881,72,64,136,639,136,136
2108,2011-04-02,Summer,2011,Apr,16,0,Saturday,0,Clear,0.38,0.3939,0.62,0.3284,111,85,196,639,196,196
2109,2011-04-02,Summer,2011,Apr,17,0,Saturday,0,Clear,0.38,0.3939,0.54,0.3582,89,95,184,639,184,184
2110,2011-04-02,Summer,2011,Apr,18,0,Saturday,0,Clear,0.38,0.3939,0.54,0.194,69,110,179,639,179,179
2111,2011-04-02,Summer,2011,Apr,19,0,Saturday,0,Clear,0.36,0.3333,0.53,0.3582,71,77,148,639,148,148
2112,2011-04-02,Summer,2011,Apr,20,0,Saturday,0,Clear,0.34,0.3182,0.53,0.2836,29,56,85,639,85,85
2113,2011-04-02,Summer,2011,Apr,21,0,Saturday,0,Clear,0.32,0.303,0.61,0.2537,24,53,77,639,77,77
2114,2011-04-02,Summer,2011,Apr,22,0,Saturday,0,Clear,0.32,0.303,0.61,0.2985,14,41,55,639,55,55
2115,2011-04-02,Summer,2011,Apr,23,0,Saturday,0,Clear,0.32,0.3182,0.61,0.1642,20,33,53,639,53,53
2116,2011-04-03,Summer,2011,Apr,0,0,Sunday,0,Clear,0.3,0.2879,0.65,0.194,8,31,39,638,39,39
2117,2011-04-03,Summer,2011,Apr,1,0,Sunday,0,Clear,0.3,0.3182,0.61,0.1045,8,26,34,638,34,34
2118,2011-04-03,Summer,2011,Apr,2,0,Sunday,0,Clear,0.26,0.2727,0.7,0.1343,5,19,24,638,24,24
2119,2011-04-03,Summer,2011,Apr,3,0,Sunday,0,Clear,0.3,0.3333,0.61,0.0,3,8,11,638,11,11
2120,2011-04-03,Summer,2011,Apr,4,0,Sunday,0,Clear,0.28,0.303,0.7,0.0896,3,0,3,638,3,3
2121,2011-04-03,Summer,2011,Apr,5,0,Sunday,0,Clear,0.28,0.2727,0.65,0.2239,1,4,5,638,5,5
2122,2011-04-03,Summer,2011,Apr,6,0,Sunday,0,Clear,0.28,0.2727,0.65,0.194,10,23,33,638,33,33
2123,2011-04-03,Summer,2011,Apr,7,0,Sunday,0,Clear,0.32,0.303,0.57,0.2239,13,20,33,638,33,33
2124,2011-04-03,Summer,2011,Apr,8,0,Sunday,0,Clear,0.34,0.3333,0.57,0.1642,18,44,62,638,62,62
2125,2011-04-03,Summer,2011,Apr,9,0,Sunday,0,Clear,0.36,0.3182,0.5,0.4925,68,74,142,638,142,142
2126,2011-04-03,Summer,2011,Apr,10,0,Sunday,0,Clear,0.4,0.4091,0.43,0.4179,111,104,215,638,215,215
2127,2011-04-03,Summer,2011,Apr,11,0,Sunday,0,Clear,0.42,0.4242,0.41,0.2537,139,104,243,638,243,243
2128,2011-04-03,Summer,2011,Apr,12,0,Sunday,0,Clear,0.44,0.4394,0.38,0.2836,166,147,313,638,313,313
2129,2011-04-03,Summer,2011,Apr,13,0,Sunday,0,Clear,0.44,0.4394,0.33,0.2985,219,148,367,638,367,367
2130,2011-04-03,Summer,2011,Apr,14,0,Sunday,0,Clear,0.46,0.4545,0.31,0.1343,240,109,349,638,349,349
2131,2011-04-03,Summer,2011,Apr,15,0,Sunday,0,Misty,0.46,0.4545,0.33,0.0,174,118,292,638,292,292
2132,2011-04-03,Summer,2011,Apr,16,0,Sunday,0,Misty,0.46,0.4545,0.31,0.194,147,156,303,638,303,303
2133,2011-04-03,Summer,2011,Apr,17,0,Sunday,0,Misty,0.46,0.4545,0.28,0.1343,148,126,274,638,274,274
2134,2011-04-03,Summer,2011,Apr,18,0,Sunday,0,Misty,0.46,0.4545,0.31,0.0,71,101,172,638,172,172
2135,2011-04-03,Summer,2011,Apr,19,0,Sunday,0,Misty,0.42,0.4242,0.44,0.194,51,93,144,638,144,144
2136,2011-04-03,Summer,2011,Apr,20,0,Sunday,0,Light_rainsnow,0.42,0.4242,0.41,0.2239,24,55,79,638,79,79
2137,2011-04-03,Summer,2011,Apr,21,0,Sunday,0,Misty,0.42,0.4242,0.44,0.2239,8,37,45,638,45,45
2138,2011-04-03,Summer,2011,Apr,22,0,Sunday,0,Clear,0.4,0.4091,0.43,0.1045,7,29,36,638,36,36
2139,2011-04-03,Summer,2011,Apr,23,0,Sunday,0,Clear,0.4,0.4091,0.5,0.0896,9,22,31,638,31,31
2140,2011-04-04,Summer,2011,Apr,0,0,Monday,1,Clear,0.4,0.4091,0.5,0.2239,1,5,6,637,6,6
2141,2011-04-04,Summer,2011,Apr,1,0,Monday,1,Clear,0.4,0.4091,0.56,0.3582,7,4,11,637,11,11
2142,2011-04-04,Summer,2011,Apr,2,0,Monday,1,Clear,0.38,0.3939,0.66,0.2537,1,1,2,637,2,2
2143,2011-04-04,Summer,2011,Apr,3,0,Monday,1,Clear,0.38,0.3939,0.66,0.2836,1,0,1,637,1,1
2144,2011-04-04,Summer,2011,Apr,4,0,Monday,1,Clear,0.38,0.3939,0.71,0.2985,1,1,2,637,2,2
2145,2011-04-04,Summer,2011,Apr,5,0,Monday,1,Clear,0.4,0.4091,0.62,0.2537,0,7,7,637,7,7
2146,2011-04-04,Summer,2011,Apr,6,0,Monday,1,Clear,0.42,0.4242,0.58,0.2836,3,43,46,637,46,46
2147,2011-04-04,Summer,2011,Apr,7,0,Monday,1,Misty,0.44,0.4394,0.54,0.2537,7,150,157,637,157,157
2148,2011-04-04,Summer,2011,Apr,8,0,Monday,1,Misty,0.46,0.4545,0.55,0.2985,31,308,339,637,339,339
2149,2011-04-04,Summer,2011,Apr,9,0,Monday,1,Misty,0.5,0.4848,0.51,0.3881,24,134,158,637,158,158
2150,2011-04-04,Summer,2011,Apr,10,0,Monday,1,Misty,0.54,0.5152,0.45,0.3582,35,55,90,637,90,90
2151,2011-04-04,Summer,2011,Apr,11,0,Monday,1,Clear,0.6,0.6212,0.4,0.3881,58,66,124,637,124,124
2152,2011-04-04,Summer,2011,Apr,12,0,Monday,1,Clear,0.64,0.6212,0.36,0.4627,59,98,157,637,157,157
2153,2011-04-04,Summer,2011,Apr,13,0,Monday,1,Clear,0.68,0.6364,0.34,0.3284,47,92,139,637,139,139
2154,2011-04-04,Summer,2011,Apr,14,0,Monday,1,Misty,0.74,0.6515,0.27,0.4925,47,76,123,637,123,123
2155,2011-04-04,Summer,2011,Apr,15,0,Monday,1,Clear,0.76,0.6667,0.23,0.5522,47,96,143,637,143,143
2156,2011-04-04,Summer,2011,Apr,16,0,Monday,1,Clear,0.76,0.6515,0.22,0.5224,59,130,189,637,189,189
2157,2011-04-04,Summer,2011,Apr,17,0,Monday,1,Clear,0.74,0.6515,0.23,0.6119,83,283,366,637,366,366
2158,2011-04-04,Summer,2011,Apr,18,0,Monday,1,Misty,0.72,0.6364,0.23,0.4925,78,308,386,637,386,386
2159,2011-04-04,Summer,2011,Apr,19,0,Monday,1,Clear,0.7,0.6364,0.24,0.4627,51,227,278,637,278,278
2160,2011-04-04,Summer,2011,Apr,20,0,Monday,1,Misty,0.7,0.6364,0.24,0.5522,40,133,173,637,173,173
2161,2011-04-04,Summer,2011,Apr,21,0,Monday,1,Misty,0.7,0.6364,0.3,0.4478,19,76,95,637,95,95
2162,2011-04-04,Summer,2011,Apr,22,0,Monday,1,Misty,0.68,0.6364,0.36,0.4627,17,58,75,637,75,75
2163,2011-04-04,Summer,2011,Apr,23,0,Monday,1,Misty,0.64,0.6212,0.47,0.2239,18,30,48,637,48,48
2164,2011-04-05,Summer,2011,Apr,0,0,Tuesday,1,Clear,0.62,0.6212,0.5,0.1045,10,12,22,636,22,22
2165,2011-04-05,Summer,2011,Apr,1,0,Tuesday,1,Light_rainsnow,0.62,0.6212,0.57,0.4179,10,5,15,636,15,15
2166,2011-04-05,Summer,2011,Apr,2,0,Tuesday,1,Misty,0.54,0.5152,0.73,0.3284,0,5,5,636,5,5
2167,2011-04-05,Summer,2011,Apr,3,0,Tuesday,1,Misty,0.54,0.5152,0.73,0.3284,1,3,4,636,4,4
2168,2011-04-05,Summer,2011,Apr,4,0,Tuesday,1,Light_rainsnow,0.5,0.4848,0.88,0.4925,0,2,2,636,2,2
2169,2011-04-05,Summer,2011,Apr,5,0,Tuesday,1,Light_rainsnow,0.46,0.4545,0.94,0.2985,0,5,5,636,5,5
2170,2011-04-05,Summer,2011,Apr,6,0,Tuesday,1,Misty,0.48,0.4697,0.88,0.3284,2,36,38,636,38,38
2171,2011-04-05,Summer,2011,Apr,7,0,Tuesday,1,Misty,0.48,0.4697,0.88,0.3284,10,124,134,636,134,134
2172,2011-04-05,Summer,2011,Apr,8,0,Tuesday,1,Light_rainsnow,0.38,0.3939,0.87,0.5821,9,148,157,636,157,157
2173,2011-04-05,Summer,2011,Apr,9,0,Tuesday,1,Light_rainsnow,0.36,0.3182,0.87,0.4925,2,44,46,636,46,46
2174,2011-04-05,Summer,2011,Apr,10,0,Tuesday,1,Light_rainsnow,0.34,0.303,0.81,0.3881,3,25,28,636,28,28
2175,2011-04-05,Summer,2011,Apr,11,0,Tuesday,1,Light_rainsnow,0.32,0.2879,0.81,0.4478,1,18,19,636,19,19
2176,2011-04-05,Summer,2011,Apr,12,0,Tuesday,1,Misty,0.34,0.303,0.71,0.3881,6,32,38,636,38,38
2177,2011-04-05,Summer,2011,Apr,13,0,Tuesday,1,Misty,0.36,0.3333,0.63,0.4179,5,51,56,636,56,56
2178,2011-04-05,Summer,2011,Apr,14,0,Tuesday,1,Misty,0.36,0.3182,0.57,0.4925,9,67,76,636,76,76
2179,2011-04-05,Summer,2011,Apr,15,0,Tuesday,1,Clear,0.4,0.4091,0.46,0.4627,6,62,68,636,68,68
2180,2011-04-05,Summer,2011,Apr,16,0,Tuesday,1,Clear,0.38,0.3939,0.46,0.4179,17,113,130,636,130,130
2181,2011-04-05,Summer,2011,Apr,17,0,Tuesday,1,Clear,0.42,0.4242,0.38,0.4179,27,246,273,636,273,273
2182,2011-04-05,Summer,2011,Apr,18,0,Tuesday,1,Clear,0.38,0.3939,0.4,0.4925,19,248,267,636,267,267
2183,2011-04-05,Summer,2011,Apr,19,0,Tuesday,1,Clear,0.36,0.3333,0.43,0.2985,12,148,160,636,160,160
2184,2011-04-05,Summer,2011,Apr,20,0,Tuesday,1,Clear,0.34,0.3182,0.46,0.2836,4,87,91,636,91,91
2185,2011-04-05,Summer,2011,Apr,21,0,Tuesday,1,Clear,0.34,0.2879,0.46,0.5224,8,81,89,636,89,89
2186,2011-04-05,Summer,2011,Apr,22,0,Tuesday,1,Clear,0.32,0.303,0.49,0.2985,3,43,46,636,46,46
2187,2011-04-05,Summer,2011,Apr,23,0,Tuesday,1,Clear,0.3,0.2879,0.49,0.2836,3,23,26,636,26,26
2188,2011-04-06,Summer,2011,Apr,0,0,Wednesday,1,Clear,0.3,0.3182,0.49,0.1045,0,15,15,635,15,15
2189,2011-04-06,Summer,2011,Apr,1,0,Wednesday,1,Clear,0.26,0.2727,0.6,0.1343,0,2,2,635,2,2
2190,2011-04-06,Summer,2011,Apr,2,0,Wednesday,1,Clear,0.24,0.2424,0.7,0.1343,0,5,5,635,5,5
2191,2011-04-06,Summer,2011,Apr,3,0,Wednesday,1,Clear,0.26,0.2727,0.6,0.1343,0,4,4,635,4,4
2192,2011-04-06,Summer,2011,Apr,4,0,Wednesday,1,Clear,0.24,0.2424,0.65,0.1343,0,1,1,635,1,1
2193,2011-04-06,Summer,2011,Apr,5,0,Wednesday,1,Clear,0.24,0.2576,0.7,0.1045,1,12,13,635,13,13
2194,2011-04-06,Summer,2011,Apr,6,0,Wednesday,1,Clear,0.24,0.2576,0.7,0.1045,4,52,56,635,56,56
2195,2011-04-06,Summer,2011,Apr,7,0,Wednesday,1,Clear,0.26,0.2727,0.65,0.1045,3,130,133,635,133,133
2196,2011-04-06,Summer,2011,Apr,8,0,Wednesday,1,Clear,0.32,0.303,0.61,0.2239,17,308,325,635,325,325
2197,2011-04-06,Summer,2011,Apr,9,0,Wednesday,1,Clear,0.36,0.3333,0.46,0.2537,8,157,165,635,165,165
2198,2011-04-06,Summer,2011,Apr,10,0,Wednesday,1,Clear,0.4,0.4091,0.37,0.3881,21,48,69,635,69,69
2199,2011-04-06,Summer,2011,Apr,11,0,Wednesday,1,Clear,0.42,0.4242,0.38,0.3881,23,70,93,635,93,93
2200,2011-04-06,Summer,2011,Apr,12,0,Wednesday,1,Clear,0.44,0.4394,0.41,0.2537,22,112,134,635,134,134
2201,2011-04-06,Summer,2011,Apr,13,0,Wednesday,1,Clear,0.46,0.4545,0.38,0.4925,29,83,112,635,112,112
2202,2011-04-06,Summer,2011,Apr,14,0,Wednesday,1,Clear,0.5,0.4848,0.34,0.4179,35,80,115,635,115,115
2203,2011-04-06,Summer,2011,Apr,15,0,Wednesday,1,Clear,0.52,0.5,0.32,0.3284,34,83,117,635,117,117
2204,2011-04-06,Summer,2011,Apr,16,0,Wednesday,1,Clear,0.54,0.5152,0.28,0.4179,27,142,169,635,169,169
2205,2011-04-06,Summer,2011,Apr,17,0,Wednesday,1,Clear,0.52,0.5,0.32,0.4478,53,303,356,635,356,356
2206,2011-04-06,Summer,2011,Apr,18,0,Wednesday,1,Clear,0.52,0.5,0.29,0.3582,43,282,325,635,325,325
2207,2011-04-06,Summer,2011,Apr,19,0,Wednesday,1,Clear,0.5,0.4848,0.31,0.2985,36,196,232,635,232,232
2208,2011-04-06,Summer,2011,Apr,20,0,Wednesday,1,Clear,0.46,0.4545,0.51,0.2239,15,126,141,635,141,141
2209,2011-04-06,Summer,2011,Apr,21,0,Wednesday,1,Clear,0.46,0.4545,0.41,0.2836,18,84,102,635,102,102
2210,2011-04-06,Summer,2011,Apr,22,0,Wednesday,1,Clear,0.46,0.4545,0.41,0.2836,13,71,84,635,84,84
2211,2011-04-06,Summer,2011,Apr,23,0,Wednesday,1,Clear,0.46,0.4545,0.41,0.2985,11,29,40,635,40,40
2212,2011-04-07,Summer,2011,Apr,0,0,Thursday,1,Clear,0.46,0.4545,0.41,0.2836,5,15,20,634,20,20
2213,2011-04-07,Summer,2011,Apr,1,0,Thursday,1,Clear,0.42,0.4242,0.47,0.1343,2,11,13,634,13,13
2214,2011-04-07,Summer,2011,Apr,2,0,Thursday,1,Clear,0.42,0.4242,0.54,0.0,0,7,7,634,7,7
2215,2011-04-07,Summer,2011,Apr,3,0,Thursday,1,Clear,0.36,0.3485,0.66,0.194,0,3,3,634,3,3
2216,2011-04-07,Summer,2011,Apr,4,0,Thursday,1,Clear,0.34,0.3333,0.76,0.194,0,1,1,634,1,1
2217,2011-04-07,Summer,2011,Apr,5,0,Thursday,1,Clear,0.34,0.3182,0.76,0.2239,0,6,6,634,6,6
2218,2011-04-07,Summer,2011,Apr,6,0,Thursday,1,Clear,0.32,0.303,0.81,0.2537,5,59,64,634,64,64
2219,2011-04-07,Summer,2011,Apr,7,0,Thursday,1,Misty,0.34,0.3333,0.76,0.1642,8,152,160,634,160,160
2220,2011-04-07,Summer,2011,Apr,8,0,Thursday,1,Clear,0.36,0.3485,0.76,0.194,23,291,314,634,314,314
2221,2011-04-07,Summer,2011,Apr,9,0,Thursday,1,Misty,0.4,0.4091,0.66,0.1343,15,155,170,634,170,170
2222,2011-04-07,Summer,2011,Apr,10,0,Thursday,1,Misty,0.42,0.4242,0.67,0.1045,29,66,95,634,95,95
2223,2011-04-07,Summer,2011,Apr,11,0,Thursday,1,Misty,0.46,0.4545,0.55,0.0,36,86,122,634,122,122
2224,2011-04-07,Summer,2011,Apr,12,0,Thursday,1,Misty,0.46,0.4545,0.55,0.0,39,114,153,634,153,153
2225,2011-04-07,Summer,2011,Apr,13,0,Thursday,1,Misty,0.52,0.5,0.48,0.0896,36,99,135,634,135,135
2226,2011-04-07,Summer,2011,Apr,14,0,Thursday,1,Clear,0.56,0.5303,0.43,0.0896,46,111,157,634,157,157
2227,2011-04-07,Summer,2011,Apr,15,0,Thursday,1,Clear,0.6,0.6212,0.38,0.1045,27,133,160,634,160,160
2228,2011-04-07,Summer,2011,Apr,16,0,Thursday,1,Clear,0.6,0.6212,0.35,0.0,52,161,213,634,213,213
2229,2011-04-07,Summer,2011,Apr,17,0,Thursday,1,Clear,0.52,0.5,0.52,0.2836,63,280,343,634,343,343
2230,2011-04-07,Summer,2011,Apr,18,0,Thursday,1,Clear,0.48,0.4697,0.55,0.2537,68,265,333,634,333,333
2231,2011-04-07,Summer,2011,Apr,19,0,Thursday,1,Clear,0.46,0.4545,0.59,0.2985,34,192,226,634,226,226
2232,2011-04-07,Summer,2011,Apr,20,0,Thursday,1,Clear,0.44,0.4394,0.62,0.1642,37,166,203,634,203,203
2233,2011-04-07,Summer,2011,Apr,21,0,Thursday,1,Misty,0.44,0.4394,0.67,0.2836,19,89,108,634,108,108
2234,2011-04-07,Summer,2011,Apr,22,0,Thursday,1,Misty,0.4,0.4091,0.76,0.194,18,63,81,634,81,81
2235,2011-04-07,Summer,2011,Apr,23,0,Thursday,1,Clear,0.38,0.3939,0.76,0.2537,9,45,54,634,54,54
2236,2011-04-08,Summer,2011,Apr,0,0,Friday,1,Misty,0.36,0.3485,0.76,0.2239,4,21,25,633,25,25
2237,2011-04-08,Summer,2011,Apr,1,0,Friday,1,Misty,0.34,0.3333,0.76,0.1343,3,6,9,633,9,9
2238,2011-04-08,Summer,2011,Apr,2,0,Friday,1,Light_rainsnow,0.34,0.3333,0.76,0.1642,3,10,13,633,13,13
2239,2011-04-08,Summer,2011,Apr,3,0,Friday,1,Light_rainsnow,0.34,0.3333,0.76,0.1642,0,1,1,633,1,1
2240,2011-04-08,Summer,2011,Apr,4,0,Friday,1,Misty,0.34,0.3333,0.86,0.1343,0,1,1,633,1,1
2241,2011-04-08,Summer,2011,Apr,5,0,Friday,1,Misty,0.32,0.3182,0.87,0.194,1,8,9,633,9,9
2242,2011-04-08,Summer,2011,Apr,6,0,Friday,1,Misty,0.34,0.3636,0.87,0.0,2,33,35,633,35,35
2243,2011-04-08,Summer,2011,Apr,7,0,Friday,1,Light_rainsnow,0.34,0.3333,0.87,0.1642,4,109,113,633,113,113
2244,2011-04-08,Summer,2011,Apr,8,0,Friday,1,Light_rainsnow,0.34,0.3333,0.87,0.1642,13,208,221,633,221,221
2245,2011-04-08,Summer,2011,Apr,9,0,Friday,1,Misty,0.36,0.3485,0.76,0.194,17,168,185,633,185,185
2246,2011-04-08,Summer,2011,Apr,10,0,Friday,1,Misty,0.36,0.3333,0.71,0.2836,10,63,73,633,73,73
2247,2011-04-08,Summer,2011,Apr,11,0,Friday,1,Misty,0.4,0.4091,0.62,0.3881,19,79,98,633,98,98
2248,2011-04-08,Summer,2011,Apr,12,0,Friday,1,Light_rainsnow,0.38,0.3939,0.66,0.2239,29,51,80,633,80,80
2249,2011-04-08,Summer,2011,Apr,13,0,Friday,1,Light_rainsnow,0.36,0.3333,0.76,0.2836,7,35,42,633,42,42
2250,2011-04-08,Summer,2011,Apr,14,0,Friday,1,Light_rainsnow,0.34,0.3182,0.87,0.2239,2,13,15,633,15,15
2251,2011-04-08,Summer,2011,Apr,15,0,Friday,1,Light_rainsnow,0.34,0.3182,0.87,0.2239,1,24,25,633,25,25
2252,2011-04-08,Summer,2011,Apr,16,0,Friday,1,Misty,0.32,0.303,0.93,0.2537,2,58,60,633,60,60
2253,2011-04-08,Summer,2011,Apr,17,0,Friday,1,Light_rainsnow,0.32,0.303,0.93,0.2537,10,138,148,633,148,148
2254,2011-04-08,Summer,2011,Apr,18,0,Friday,1,Light_rainsnow,0.32,0.303,0.93,0.2537,8,54,62,633,62,62
2255,2011-04-08,Summer,2011,Apr,19,0,Friday,1,Light_rainsnow,0.3,0.2727,0.93,0.4179,1,52,53,633,53,53
2256,2011-04-08,Summer,2011,Apr,20,0,Friday,1,Misty,0.3,0.2727,0.93,0.3284,12,51,63,633,63,63
2257,2011-04-08,Summer,2011,Apr,21,0,Friday,1,Misty,0.3,0.2879,0.93,0.2537,11,43,54,633,54,54
2258,2011-04-08,Summer,2011,Apr,22,0,Friday,1,Misty,0.3,0.2727,0.93,0.2985,9,42,51,633,51,51
2259,2011-04-08,Summer,2011,Apr,23,0,Friday,1,Misty,0.3,0.2879,0.93,0.2239,4,31,35,633,35,35
2260,2011-04-09,Summer,2011,Apr,0,0,Saturday,0,Misty,0.3,0.2879,0.87,0.2239,5,26,31,632,31,31
2261,2011-04-09,Summer,2011,Apr,1,0,Saturday,0,Misty,0.3,0.303,0.87,0.1343,3,17,20,632,20,20
2262,2011-04-09,Summer,2011,Apr,2,0,Saturday,0,Misty,0.32,0.303,0.87,0.2239,2,15,17,632,17,17
2263,2011-04-09,Summer,2011,Apr,3,0,Saturday,0,Light_rainsnow,0.3,0.2879,1.0,0.2537,3,11,14,632,14,14
2264,2011-04-09,Summer,2011,Apr,4,0,Saturday,0,Light_rainsnow,0.3,0.2727,1.0,0.2537,0,3,3,632,3,3
2265,2011-04-09,Summer,2011,Apr,5,0,Saturday,0,Misty,0.3,0.2879,0.93,0.2239,0,5,5,632,5,5
2266,2011-04-09,Summer,2011,Apr,6,0,Saturday,0,Misty,0.3,0.2879,0.93,0.194,0,13,13,632,13,13
2267,2011-04-09,Summer,2011,Apr,7,0,Saturday,0,Misty,0.3,0.303,0.93,0.1642,8,13,21,632,21,21
2268,2011-04-09,Summer,2011,Apr,8,0,Saturday,0,Misty,0.32,0.303,0.93,0.1642,7,47,54,632,54,54
2269,2011-04-09,Summer,2011,Apr,9,0,Saturday,0,Misty,0.34,0.3485,0.87,0.1045,27,71,98,632,98,98
2270,2011-04-09,Summer,2011,Apr,10,0,Saturday,0,Misty,0.34,0.3333,0.87,0.1343,43,90,133,632,133,133
2271,2011-04-09,Summer,2011,Apr,11,0,Saturday,0,Misty,0.36,0.3636,0.81,0.0,51,91,142,632,142,142
2272,2011-04-09,Summer,2011,Apr,12,0,Saturday,0,Misty,0.36,0.3485,0.81,0.1343,79,123,202,632,202,202
2273,2011-04-09,Summer,2011,Apr,13,0,Saturday,0,Misty,0.36,0.3788,0.81,0.0,114,108,222,632,222,222
2274,2011-04-09,Summer,2011,Apr,14,0,Saturday,0,Misty,0.36,0.3485,0.81,0.1343,94,118,212,632,212,212
2275,2011-04-09,Summer,2011,Apr,15,0,Saturday,0,Misty,0.36,0.3788,0.87,0.0,85,116,201,632,201,201
2276,2011-04-09,Summer,2011,Apr,16,0,Saturday,0,Misty,0.38,0.3939,0.82,0.0,73,118,191,632,191,191
2277,2011-04-09,Summer,2011,Apr,17,0,Saturday,0,Misty,0.38,0.3939,0.82,0.0896,128,129,257,632,257,257
2278,2011-04-09,Summer,2011,Apr,18,0,Saturday,0,Misty,0.38,0.3939,0.82,0.1045,48,129,177,632,177,177
2279,2011-04-09,Summer,2011,Apr,19,0,Saturday,0,Misty,0.38,0.3939,0.82,0.1343,47,83,130,632,130,130
2280,2011-04-09,Summer,2011,Apr,20,0,Saturday,0,Misty,0.38,0.3939,0.87,0.1642,19,74,93,632,93,93
2281,2011-04-09,Summer,2011,Apr,21,0,Saturday,0,Misty,0.36,0.3485,0.93,0.1343,10,65,75,632,75,75
2282,2011-04-09,Summer,2011,Apr,22,0,Saturday,0,Misty,0.36,0.3485,0.93,0.1343,21,66,87,632,87,87
2283,2011-04-09,Summer,2011,Apr,23,0,Saturday,0,Misty,0.38,0.3939,0.87,0.0896,12,45,57,632,57,57
2284,2011-04-10,Summer,2011,Apr,0,0,Sunday,0,Misty,0.38,0.3939,0.87,0.0896,5,48,53,631,53,53
2285,2011-04-10,Summer,2011,Apr,1,0,Sunday,0,Misty,0.38,0.3939,0.87,0.1343,6,31,37,631,37,37
2286,2011-04-10,Summer,2011,Apr,2,0,Sunday,0,Misty,0.38,0.3939,0.87,0.0896,12,24,36,631,36,36
2287,2011-04-10,Summer,2011,Apr,3,0,Sunday,0,Misty,0.38,0.3939,0.87,0.1343,5,11,16,631,16,16
2288,2011-04-10,Summer,2011,Apr,4,0,Sunday,0,Misty,0.36,0.3636,0.93,0.1045,3,2,5,631,5,5
2289,2011-04-10,Summer,2011,Apr,5,0,Sunday,0,Misty,0.36,0.3636,0.93,0.0896,0,4,4,631,4,4
2290,2011-04-10,Summer,2011,Apr,6,0,Sunday,0,Misty,0.36,0.3636,0.93,0.0896,0,4,4,631,4,4
2291,2011-04-10,Summer,2011,Apr,7,0,Sunday,0,Misty,0.36,0.3636,1.0,0.0896,3,7,10,631,10,10
2292,2011-04-10,Summer,2011,Apr,8,0,Sunday,0,Misty,0.38,0.3939,0.94,0.0896,17,38,55,631,55,55
2293,2011-04-10,Summer,2011,Apr,9,0,Sunday,0,Misty,0.38,0.3939,0.94,0.1343,31,50,81,631,81,81
2294,2011-04-10,Summer,2011,Apr,10,0,Sunday,0,Misty,0.4,0.4091,0.87,0.0,69,81,150,631,150,150
2295,2011-04-10,Summer,2011,Apr,11,0,Sunday,0,Misty,0.4,0.4091,0.87,0.1343,93,109,202,631,202,202
2296,2011-04-10,Summer,2011,Apr,12,0,Sunday,0,Misty,0.42,0.4242,0.88,0.1343,94,136,230,631,230,230
2297,2011-04-10,Summer,2011,Apr,13,0,Sunday,0,Clear,0.46,0.4545,0.82,0.1045,121,142,263,631,263,263
2298,2011-04-10,Summer,2011,Apr,14,0,Sunday,0,Clear,0.5,0.4848,0.72,0.194,148,133,281,631,281,281
2299,2011-04-10,Summer,2011,Apr,15,0,Sunday,0,Clear,0.5,0.4848,0.77,0.2239,156,141,297,631,297,297
2300,2011-04-10,Summer,2011,Apr,16,0,Sunday,0,Misty,0.52,0.5,0.72,0.1642,135,153,288,631,288,288
2301,2011-04-10,Summer,2011,Apr,17,0,Sunday,0,Misty,0.52,0.5,0.72,0.194,84,152,236,631,236,236
2302,2011-04-10,Summer,2011,Apr,18,0,Sunday,0,Clear,0.5,0.4848,0.77,0.194,103,137,240,631,240,240
2303,2011-04-10,Summer,2011,Apr,19,0,Sunday,0,Clear,0.5,0.4848,0.77,0.194,47,84,131,631,131,131
2304,2011-04-10,Summer,2011,Apr,20,0,Sunday,0,Clear,0.46,0.4545,0.82,0.1343,21,71,92,631,92,92
2305,2011-04-10,Summer,2011,Apr,21,0,Sunday,0,Clear,0.44,0.4394,0.88,0.194,18,77,95,631,95,95
2306,2011-04-10,Summer,2011,Apr,22,0,Sunday,0,Clear,0.44,0.4394,0.94,0.2537,12,45,57,631,57,57
2307,2011-04-10,Summer,2011,Apr,23,0,Sunday,0,Clear,0.46,0.4545,0.88,0.3582,5,27,32,631,32,32
2308,2011-04-11,Summer,2011,Apr,0,0,Monday,1,Clear,0.48,0.4697,0.88,0.3284,7,16,23,630,23,23
2309,2011-04-11,Summer,2011,Apr,1,0,Monday,1,Clear,0.46,0.4545,0.94,0.2836,1,3,4,630,4,4
2310,2011-04-11,Summer,2011,Apr,2,0,Monday,1,Clear,0.46,0.4545,0.94,0.2836,7,2,9,630,9,9
2311,2011-04-11,Summer,2011,Apr,4,0,Monday,1,Clear,0.46,0.4545,0.94,0.194,0,1,1,630,1,1
2312,2011-04-11,Summer,2011,Apr,5,0,Monday,1,Clear,0.46,0.4545,0.94,0.194,1,12,13,630,13,13
2313,2011-04-11,Summer,2011,Apr,6,0,Monday,1,Misty,0.46,0.4545,1.0,0.2239,2,59,61,630,61,61
2314,2011-04-11,Summer,2011,Apr,7,0,Monday,1,Misty,0.5,0.4848,0.88,0.2239,12,164,176,630,176,176
2315,2011-04-11,Summer,2011,Apr,8,0,Monday,1,Misty,0.52,0.5,0.88,0.2836,28,286,314,630,314,314
2316,2011-04-11,Summer,2011,Apr,9,0,Monday,1,Misty,0.56,0.5303,0.83,0.2836,33,132,165,630,165,165
2317,2011-04-11,Summer,2011,Apr,10,0,Monday,1,Misty,0.56,0.5303,0.83,0.2985,41,55,96,630,96,96
2318,2011-04-11,Summer,2011,Apr,11,0,Monday,1,Misty,0.6,0.5909,0.73,0.2985,45,59,104,630,104,104
2319,2011-04-11,Summer,2011,Apr,12,0,Monday,1,Misty,0.6,0.5909,0.73,0.3284,37,97,134,630,134,134
2320,2011-04-11,Summer,2011,Apr,13,0,Monday,1,Misty,0.64,0.6061,0.69,0.4179,62,77,139,630,139,139
2321,2011-04-11,Summer,2011,Apr,14,0,Monday,1,Misty,0.72,0.6667,0.54,0.3582,60,85,145,630,145,145
2322,2011-04-11,Summer,2011,Apr,15,0,Monday,1,Clear,0.74,0.6667,0.48,0.5224,56,85,141,630,141,141
2323,2011-04-11,Summer,2011,Apr,16,0,Monday,1,Clear,0.74,0.6667,0.48,0.5224,73,162,235,630,235,235
2324,2011-04-11,Summer,2011,Apr,17,0,Monday,1,Clear,0.74,0.6667,0.48,0.5224,100,352,452,630,452,452
2325,2011-04-11,Summer,2011,Apr,18,0,Monday,1,Clear,0.72,0.6667,0.51,0.3881,93,290,383,630,383,383
2326,2011-04-11,Summer,2011,Apr,19,0,Monday,1,Clear,0.72,0.6667,0.51,0.4478,73,211,284,630,284,284
2327,2011-04-11,Summer,2011,Apr,20,0,Monday,1,Clear,0.68,0.6364,0.57,0.5224,44,122,166,630,166,166
2328,2011-04-11,Summer,2011,Apr,21,0,Monday,1,Clear,0.66,0.6212,0.61,0.2537,39,119,158,630,158,158
2329,2011-04-11,Summer,2011,Apr,22,0,Monday,1,Misty,0.64,0.6212,0.5,0.2836,25,66,91,630,91,91
2330,2011-04-11,Summer,2011,Apr,23,0,Monday,1,Light_rainsnow,0.58,0.5455,0.6,0.0,16,38,54,630,54,54
2331,2011-04-12,Summer,2011,Apr,0,0,Tuesday,1,Misty,0.62,0.6212,0.5,0.1045,11,13,24,629,24,24
2332,2011-04-12,Summer,2011,Apr,1,0,Tuesday,1,Misty,0.62,0.6212,0.5,0.0896,6,7,13,629,13,13
2333,2011-04-12,Summer,2011,Apr,2,0,Tuesday,1,Misty,0.6,0.6212,0.53,0.1343,7,7,14,629,14,14
2334,2011-04-12,Summer,2011,Apr,3,0,Tuesday,1,Misty,0.58,0.5455,0.56,0.1343,0,1,1,629,1,1
2335,2011-04-12,Summer,2011,Apr,4,0,Tuesday,1,Misty,0.56,0.5303,0.64,0.1343,4,2,6,629,6,6
2336,2011-04-12,Summer,2011,Apr,5,0,Tuesday,1,Misty,0.54,0.5152,0.68,0.1343,1,15,16,629,16,16
2337,2011-04-12,Summer,2011,Apr,6,0,Tuesday,1,Misty,0.54,0.5152,0.68,0.2836,3,55,58,629,58,58
2338,2011-04-12,Summer,2011,Apr,7,0,Tuesday,1,Misty,0.54,0.5152,0.68,0.2239,12,177,189,629,189,189
2339,2011-04-12,Summer,2011,Apr,8,0,Tuesday,1,Light_rainsnow,0.48,0.4697,0.88,0.3881,15,211,226,629,226,226
2340,2011-04-12,Summer,2011,Apr,9,0,Tuesday,1,Light_rainsnow,0.46,0.4545,0.94,0.4925,4,50,54,629,54,54
2341,2011-04-12,Summer,2011,Apr,10,0,Tuesday,1,Light_rainsnow,0.5,0.4848,0.82,0.4179,6,34,40,629,40,40
2342,2011-04-12,Summer,2011,Apr,11,0,Tuesday,1,Clear,0.52,0.5,0.77,0.3582,11,38,49,629,49,49
2343,2011-04-12,Summer,2011,Apr,12,0,Tuesday,1,Misty,0.56,0.5303,0.64,0.4627,9,83,92,629,92,92
2344,2011-04-12,Summer,2011,Apr,13,0,Tuesday,1,Light_rainsnow,0.54,0.5152,0.68,0.2836,22,84,106,629,106,106
2345,2011-04-12,Summer,2011,Apr,14,0,Tuesday,1,Misty,0.5,0.4848,0.82,0.2836,16,28,44,629,44,44
2346,2011-04-12,Summer,2011,Apr,15,0,Tuesday,1,Misty,0.48,0.4697,0.77,0.5224,24,54,78,629,78,78
2347,2011-04-12,Summer,2011,Apr,16,0,Tuesday,1,Misty,0.48,0.4697,0.77,0.3881,19,80,99,629,99,99
2348,2011-04-12,Summer,2011,Apr,17,0,Tuesday,1,Light_rainsnow,0.44,0.4394,0.77,0.2239,29,262,291,629,291,291
2349,2011-04-12,Summer,2011,Apr,18,0,Tuesday,1,Light_rainsnow,0.44,0.4394,0.77,0.2239,21,203,224,629,224,224
2350,2011-04-12,Summer,2011,Apr,19,0,Tuesday,1,Misty,0.42,0.4242,0.82,0.2836,3,127,130,629,130,130
2351,2011-04-12,Summer,2011,Apr,20,0,Tuesday,1,Misty,0.42,0.4242,0.82,0.2836,9,94,103,629,103,103
2352,2011-04-12,Summer,2011,Apr,21,0,Tuesday,1,Misty,0.42,0.4242,0.82,0.194,10,74,84,629,84,84
2353,2011-04-12,Summer,2011,Apr,22,0,Tuesday,1,Misty,0.4,0.4091,0.94,0.2985,7,47,54,629,54,54
2354,2011-04-12,Summer,2011,Apr,23,0,Tuesday,1,Misty,0.4,0.4091,0.94,0.2537,8,31,39,629,39,39
2355,2011-04-13,Summer,2011,Apr,0,0,Wednesday,1,Misty,0.4,0.4091,1.0,0.2985,3,12,15,628,15,15
2356,2011-04-13,Summer,2011,Apr,1,0,Wednesday,1,Misty,0.4,0.4091,1.0,0.2985,0,1,1,628,1,1
2357,2011-04-13,Summer,2011,Apr,2,0,Wednesday,1,Light_rainsnow,0.4,0.4091,1.0,0.2985,0,2,2,628,2,2
2358,2011-04-13,Summer,2011,Apr,3,0,Wednesday,1,Light_rainsnow,0.4,0.4091,0.94,0.3284,0,2,2,628,2,2
2359,2011-04-13,Summer,2011,Apr,4,0,Wednesday,1,Light_rainsnow,0.4,0.4091,0.94,0.3284,1,2,3,628,3,3
2360,2011-04-13,Summer,2011,Apr,5,0,Wednesday,1,Light_rainsnow,0.38,0.3939,0.94,0.2537,1,4,5,628,5,5
2361,2011-04-13,Summer,2011,Apr,6,0,Wednesday,1,Light_rainsnow,0.38,0.3939,0.94,0.2239,1,33,34,628,34,34
2362,2011-04-13,Summer,2011,Apr,7,0,Wednesday,1,Light_rainsnow,0.36,0.3485,1.0,0.2239,3,67,70,628,70,70
2363,2011-04-13,Summer,2011,Apr,8,0,Wednesday,1,Light_rainsnow,0.38,0.3939,0.94,0.194,6,158,164,628,164,164
2364,2011-04-13,Summer,2011,Apr,9,0,Wednesday,1,Misty,0.38,0.3939,0.94,0.2239,2,63,65,628,65,65
2365,2011-04-13,Summer,2011,Apr,10,0,Wednesday,1,Misty,0.4,0.4091,0.87,0.194,4,42,46,628,46,46
2366,2011-04-13,Summer,2011,Apr,11,0,Wednesday,1,Misty,0.42,0.4242,0.82,0.194,4,57,61,628,61,61
2367,2011-04-13,Summer,2011,Apr,12,0,Wednesday,1,Light_rainsnow,0.42,0.4242,0.82,0.2537,12,83,95,628,95,95
2368,2011-04-13,Summer,2011,Apr,13,0,Wednesday,1,Misty,0.44,0.4394,0.77,0.194,6,55,61,628,61,61
2369,2011-04-13,Summer,2011,Apr,14,0,Wednesday,1,Misty,0.42,0.4242,0.77,0.2537,24,82,106,628,106,106
2370,2011-04-13,Summer,2011,Apr,15,0,Wednesday,1,Misty,0.44,0.4394,0.72,0.2836,12,69,81,628,81,81
2371,2011-04-13,Summer,2011,Apr,16,0,Wednesday,1,Clear,0.46,0.4545,0.67,0.2836,23,119,142,628,142,142
2372,2011-04-13,Summer,2011,Apr,17,0,Wednesday,1,Clear,0.46,0.4545,0.67,0.2985,25,284,309,628,309,309
2373,2011-04-13,Summer,2011,Apr,18,0,Wednesday,1,Clear,0.44,0.4394,0.62,0.3881,28,293,321,628,321,321
2374,2011-04-13,Summer,2011,Apr,19,0,Wednesday,1,Clear,0.44,0.4394,0.62,0.2537,15,160,175,628,175,175
2375,2011-04-13,Summer,2011,Apr,20,0,Wednesday,1,Clear,0.44,0.4394,0.62,0.2537,7,119,126,628,126,126
2376,2011-04-13,Summer,2011,Apr,21,0,Wednesday,1,Clear,0.42,0.4242,0.67,0.1642,17,100,117,628,117,117
2377,2011-04-13,Summer,2011,Apr,22,0,Wednesday,1,Clear,0.42,0.4242,0.67,0.194,10,89,99,628,99,99
2378,2011-04-13,Summer,2011,Apr,23,0,Wednesday,1,Clear,0.4,0.4091,0.71,0.1343,5,57,62,628,62,62
2379,2011-04-14,Summer,2011,Apr,0,0,Thursday,1,Clear,0.38,0.3939,0.76,0.1343,3,18,21,627,21,21
2380,2011-04-14,Summer,2011,Apr,1,0,Thursday,1,Clear,0.38,0.3939,0.76,0.2239,1,9,10,627,10,10
2381,2011-04-14,Summer,2011,Apr,2,0,Thursday,1,Clear,0.36,0.3485,0.76,0.1343,0,3,3,627,3,3
2382,2011-04-14,Summer,2011,Apr,3,0,Thursday,1,Clear,0.34,0.3333,0.81,0.1343,0,2,2,627,2,2
2383,2011-04-14,Summer,2011,Apr,4,0,Thursday,1,Clear,0.34,0.3636,0.76,0.0,1,8,9,627,9,9
2384,2011-04-14,Summer,2011,Apr,5,0,Thursday,1,Clear,0.34,0.3485,0.76,0.0896,2,12,14,627,14,14
2385,2011-04-14,Summer,2011,Apr,6,0,Thursday,1,Clear,0.34,0.3485,0.76,0.1045,4,66,70,627,70,70
2386,2011-04-14,Summer,2011,Apr,7,0,Thursday,1,Clear,0.38,0.3939,0.66,0.0,11,182,193,627,193,193
2387,2011-04-14,Summer,2011,Apr,8,0,Thursday,1,Clear,0.42,0.4242,0.58,0.1642,21,316,337,627,337,337
2388,2011-04-14,Summer,2011,Apr,9,0,Thursday,1,Clear,0.46,0.4545,0.51,0.1343,18,152,170,627,170,170
2389,2011-04-14,Summer,2011,Apr,10,0,Thursday,1,Clear,0.5,0.4848,0.51,0.194,21,68,89,627,89,89
2390,2011-04-14,Summer,2011,Apr,11,0,Thursday,1,Clear,0.52,0.5,0.45,0.1642,28,87,115,627,115,115
2391,2011-04-14,Summer,2011,Apr,12,0,Thursday,1,Clear,0.54,0.5152,0.42,0.1343,35,110,145,627,145,145
2392,2011-04-14,Summer,2011,Apr,13,0,Thursday,1,Clear,0.56,0.5303,0.37,0.2239,38,121,159,627,159,159
2393,2011-04-14,Summer,2011,Apr,14,0,Thursday,1,Clear,0.56,0.5303,0.35,0.0896,36,101,137,627,137,137
2394,2011-04-14,Summer,2011,Apr,15,0,Thursday,1,Clear,0.6,0.6212,0.31,0.0896,57,85,142,627,142,142
2395,2011-04-14,Summer,2011,Apr,16,0,Thursday,1,Clear,0.6,0.6061,0.26,0.1045,49,153,202,627,202,202
2396,2011-04-14,Summer,2011,Apr,17,0,Thursday,1,Clear,0.6,0.6061,0.28,0.0,50,338,388,627,388,388
2397,2011-04-14,Summer,2011,Apr,18,0,Thursday,1,Clear,0.56,0.5303,0.3,0.0,47,290,337,627,337,337
2398,2011-04-14,Summer,2011,Apr,19,0,Thursday,1,Clear,0.54,0.5152,0.32,0.0,37,222,259,627,259,259
2399,2011-04-14,Summer,2011,Apr,20,0,Thursday,1,Clear,0.5,0.4848,0.51,0.194,22,147,169,627,169,169
2400,2011-04-14,Summer,2011,Apr,21,0,Thursday,1,Clear,0.46,0.4545,0.63,0.1343,19,126,145,627,145,145
2401,2011-04-14,Summer,2011,Apr,22,0,Thursday,1,Clear,0.48,0.4697,0.55,0.1045,22,82,104,627,104,104
2402,2011-04-14,Summer,2011,Apr,23,0,Thursday,1,Clear,0.46,0.4545,0.59,0.1045,7,40,47,627,47,47
2403,2011-04-15,Summer,2011,Apr,0,1,Friday,0,Clear,0.44,0.4394,0.67,0.0,6,21,27,626,27,27
2404,2011-04-15,Summer,2011,Apr,1,1,Friday,0,Clear,0.44,0.4394,0.62,0.0,6,9,15,626,15,15
2405,2011-04-15,Summer,2011,Apr,2,1,Friday,0,Clear,0.4,0.4091,0.76,0.0,8,10,18,626,18,18
2406,2011-04-15,Summer,2011,Apr,3,1,Friday,0,Clear,0.4,0.4091,0.76,0.0,0,3,3,626,3,3
2407,2011-04-15,Summer,2011,Apr,4,1,Friday,0,Clear,0.38,0.3939,0.82,0.0896,0,3,3,626,3,3
2408,2011-04-15,Summer,2011,Apr,5,1,Friday,0,Clear,0.36,0.3636,0.81,0.1045,2,11,13,626,13,13
2409,2011-04-15,Summer,2011,Apr,6,1,Friday,0,Clear,0.36,0.3636,0.81,0.0896,5,42,47,626,47,47
2410,2011-04-15,Summer,2011,Apr,7,1,Friday,0,Clear,0.4,0.4091,0.71,0.1642,10,139,149,626,149,149
2411,2011-04-15,Summer,2011,Apr,8,1,Friday,0,Clear,0.44,0.4394,0.62,0.2985,21,279,300,626,300,300
2412,2011-04-15,Summer,2011,Apr,9,1,Friday,0,Clear,0.5,0.4848,0.55,0.194,16,162,178,626,178,178
2413,2011-04-15,Summer,2011,Apr,10,1,Friday,0,Clear,0.5,0.4848,0.55,0.194,31,91,122,626,122,122
2414,2011-04-15,Summer,2011,Apr,11,1,Friday,0,Clear,0.52,0.5,0.55,0.194,41,95,136,626,136,136
2415,2011-04-15,Summer,2011,Apr,12,1,Friday,0,Clear,0.52,0.5,0.55,0.2836,45,155,200,626,200,200
2416,2011-04-15,Summer,2011,Apr,13,1,Friday,0,Clear,0.54,0.5152,0.52,0.2537,47,133,180,626,180,180
2417,2011-04-15,Summer,2011,Apr,14,1,Friday,0,Clear,0.54,0.5152,0.52,0.2537,57,106,163,626,163,163
2418,2011-04-15,Summer,2011,Apr,15,1,Friday,0,Clear,0.54,0.5152,0.52,0.4478,50,112,162,626,162,162
2419,2011-04-15,Summer,2011,Apr,16,1,Friday,0,Clear,0.52,0.5,0.55,0.4925,70,173,243,626,243,243
2420,2011-04-15,Summer,2011,Apr,17,1,Friday,0,Misty,0.5,0.4848,0.63,0.3881,64,267,331,626,331,331
2421,2011-04-15,Summer,2011,Apr,18,1,Friday,0,Misty,0.46,0.4545,0.67,0.3881,47,216,263,626,263,263
2422,2011-04-15,Summer,2011,Apr,19,1,Friday,0,Clear,0.42,0.4242,0.77,0.3881,41,168,209,626,209,209
2423,2011-04-15,Summer,2011,Apr,20,1,Friday,0,Misty,0.4,0.4091,0.76,0.3284,26,92,118,626,118,118
2424,2011-04-15,Summer,2011,Apr,21,1,Friday,0,Misty,0.4,0.4091,0.76,0.2985,25,77,102,626,102,102
2425,2011-04-15,Summer,2011,Apr,22,1,Friday,0,Misty,0.38,0.3939,0.82,0.3881,16,64,80,626,80,80
2426,2011-04-15,Summer,2011,Apr,23,1,Friday,0,Misty,0.36,0.3485,0.81,0.194,8,56,64,626,64,64
2427,2011-04-16,Summer,2011,Apr,0,0,Saturday,0,Misty,0.36,0.3485,0.81,0.2239,7,36,43,625,43,43
2428,2011-04-16,Summer,2011,Apr,1,0,Saturday,0,Misty,0.36,0.3333,0.87,0.2836,5,28,33,625,33,33
2429,2011-04-16,Summer,2011,Apr,2,0,Saturday,0,Misty,0.36,0.3485,0.87,0.1343,5,19,24,625,24,24
2430,2011-04-16,Summer,2011,Apr,3,0,Saturday,0,Misty,0.36,0.3485,0.87,0.1642,5,9,14,625,14,14
2431,2011-04-16,Summer,2011,Apr,4,0,Saturday,0,Misty,0.36,0.3485,0.87,0.2239,1,4,5,625,5,5
2432,2011-04-16,Summer,2011,Apr,5,0,Saturday,0,Misty,0.38,0.3939,0.87,0.2836,1,3,4,625,4,4
2433,2011-04-16,Summer,2011,Apr,6,0,Saturday,0,Light_rainsnow,0.4,0.4091,0.82,0.3284,1,9,10,625,10,10
2434,2011-04-16,Summer,2011,Apr,7,0,Saturday,0,Misty,0.4,0.4091,0.82,0.4179,3,18,21,625,21,21
2435,2011-04-16,Summer,2011,Apr,8,0,Saturday,0,Light_rainsnow,0.4,0.4091,0.87,0.3582,7,38,45,625,45,45
2436,2011-04-16,Summer,2011,Apr,9,0,Saturday,0,Light_rainsnow,0.4,0.4091,1.0,0.2985,2,27,29,625,29,29
2437,2011-04-16,Summer,2011,Apr,10,0,Saturday,0,Light_rainsnow,0.42,0.4242,0.94,0.3881,1,21,22,625,22,22
2438,2011-04-16,Summer,2011,Apr,11,0,Saturday,0,Light_rainsnow,0.42,0.4242,0.94,0.4478,4,27,31,625,31,31
2439,2011-04-16,Summer,2011,Apr,12,0,Saturday,0,Misty,0.46,0.4545,0.88,0.5821,6,26,32,625,32,32
2440,2011-04-16,Summer,2011,Apr,13,0,Saturday,0,Light_rainsnow,0.46,0.4545,0.94,0.5224,9,49,58,625,58,58
2441,2011-04-16,Summer,2011,Apr,14,0,Saturday,0,Light_rainsnow,0.52,0.5,0.83,0.5821,14,49,63,625,63,63
2442,2011-04-16,Summer,2011,Apr,15,0,Saturday,0,Light_rainsnow,0.52,0.5,0.83,0.5821,16,62,78,625,78,78
2443,2011-04-16,Summer,2011,Apr,16,0,Saturday,0,Light_rainsnow,0.5,0.4848,0.88,0.4627,6,27,33,625,33,33
2444,2011-04-16,Summer,2011,Apr,17,0,Saturday,0,Light_rainsnow,0.5,0.4848,0.88,0.5821,1,14,15,625,15,15
2445,2011-04-16,Summer,2011,Apr,18,0,Saturday,0,Misty,0.5,0.4848,0.94,0.3881,6,32,38,625,38,38
2446,2011-04-16,Summer,2011,Apr,19,0,Saturday,0,Misty,0.52,0.5,0.94,0.4179,9,62,71,625,71,71
2447,2011-04-16,Summer,2011,Apr,20,0,Saturday,0,Light_rainsnow,0.44,0.4394,0.94,0.2239,4,49,53,625,53,53
2448,2011-04-16,Summer,2011,Apr,21,0,Saturday,0,Misty,0.44,0.4394,0.94,0.0,1,13,14,625,14,14
2449,2011-04-16,Summer,2011,Apr,22,0,Saturday,0,Light_rainsnow,0.42,0.4242,1.0,0.0,2,22,24,625,24,24
2450,2011-04-16,Summer,2011,Apr,23,0,Saturday,0,Misty,0.44,0.4394,0.77,0.2836,5,30,35,625,35,35
2451,2011-04-17,Summer,2011,Apr,0,0,Sunday,0,Misty,0.44,0.4394,0.77,0.2836,4,29,33,624,33,33
2452,2011-04-17,Summer,2011,Apr,1,0,Sunday,0,Clear,0.42,0.4242,0.67,0.2239,6,25,31,624,31,31
2453,2011-04-17,Summer,2011,Apr,2,0,Sunday,0,Clear,0.4,0.4091,0.62,0.194,4,25,29,624,29,29
2454,2011-04-17,Summer,2011,Apr,3,0,Sunday,0,Clear,0.4,0.4091,0.66,0.1343,12,13,25,624,25,25
2455,2011-04-17,Summer,2011,Apr,4,0,Sunday,0,Clear,0.36,0.3636,0.76,0.1045,2,5,7,624,7,7
2456,2011-04-17,Summer,2011,Apr,5,0,Sunday,0,Clear,0.36,0.3485,0.71,0.1642,2,1,3,624,3,3
2457,2011-04-17,Summer,2011,Apr,6,0,Sunday,0,Clear,0.36,0.3182,0.66,0.4478,3,5,8,624,8,8
2458,2011-04-17,Summer,2011,Apr,7,0,Sunday,0,Clear,0.36,0.3333,0.5,0.3582,2,14,16,624,16,16
2459,2011-04-17,Summer,2011,Apr,8,0,Sunday,0,Clear,0.38,0.3939,0.46,0.3881,7,36,43,624,43,43
2460,2011-04-17,Summer,2011,Apr,9,0,Sunday,0,Clear,0.4,0.4091,0.43,0.2836,31,71,102,624,102,102
2461,2011-04-17,Summer,2011,Apr,10,0,Sunday,0,Clear,0.42,0.4242,0.44,0.4478,91,120,211,624,211,211
2462,2011-04-17,Summer,2011,Apr,11,0,Sunday,0,Clear,0.46,0.4545,0.41,0.4179,119,185,304,624,304,304
2463,2011-04-17,Summer,2011,Apr,12,0,Sunday,0,Clear,0.46,0.4545,0.38,0.3881,167,187,354,624,354,354
2464,2011-04-17,Summer,2011,Apr,13,0,Sunday,0,Clear,0.5,0.4848,0.34,0.3881,181,162,343,624,343,343
2465,2011-04-17,Summer,2011,Apr,14,0,Sunday,0,Clear,0.52,0.5,0.34,0.3881,170,191,361,624,361,361
2466,2011-04-17,Summer,2011,Apr,15,0,Sunday,0,Clear,0.54,0.5152,0.32,0.5224,179,209,388,624,388,388
2467,2011-04-17,Summer,2011,Apr,16,0,Sunday,0,Clear,0.54,0.5152,0.3,0.3582,161,182,343,624,343,343
2468,2011-04-17,Summer,2011,Apr,17,0,Sunday,0,Clear,0.56,0.5303,0.3,0.4478,143,163,306,624,306,306
2469,2011-04-17,Summer,2011,Apr,18,0,Sunday,0,Clear,0.56,0.5303,0.3,0.3881,102,175,277,624,277,277
2470,2011-04-17,Summer,2011,Apr,19,0,Sunday,0,Clear,0.56,0.5303,0.3,0.2985,75,135,210,624,210,210
2471,2011-04-17,Summer,2011,Apr,20,0,Sunday,0,Clear,0.52,0.5,0.36,0.194,44,97,141,624,141,141
2472,2011-04-17,Summer,2011,Apr,21,0,Sunday,0,Clear,0.5,0.4848,0.42,0.194,13,70,83,624,83,83
2473,2011-04-17,Summer,2011,Apr,22,0,Sunday,0,Clear,0.5,0.4848,0.39,0.1045,21,49,70,624,70,70
2474,2011-04-17,Summer,2011,Apr,23,0,Sunday,0,Clear,0.44,0.4394,0.67,0.1642,19,37,56,624,56,56
2475,2011-04-18,Summer,2011,Apr,0,0,Monday,1,Clear,0.46,0.4545,0.47,0.0896,15,24,39,623,39,39
2476,2011-04-18,Summer,2011,Apr,1,0,Monday,1,Clear,0.46,0.4545,0.47,0.1343,11,8,19,623,19,19
2477,2011-04-18,Summer,2011,Apr,2,0,Monday,1,Clear,0.42,0.4242,0.67,0.1045,14,2,16,623,16,16
2478,2011-04-18,Summer,2011,Apr,3,0,Monday,1,Clear,0.42,0.4242,0.62,0.1045,6,1,7,623,7,7
2479,2011-04-18,Summer,2011,Apr,4,0,Monday,1,Clear,0.4,0.4091,0.87,0.1642,2,4,6,623,6,6
2480,2011-04-18,Summer,2011,Apr,5,0,Monday,1,Clear,0.4,0.4091,0.76,0.0896,0,16,16,623,16,16
2481,2011-04-18,Summer,2011,Apr,6,0,Monday,1,Clear,0.4,0.4091,0.82,0.0,3,51,54,623,54,54
2482,2011-04-18,Summer,2011,Apr,7,0,Monday,1,Clear,0.46,0.4545,0.63,0.0,12,156,168,623,168,168
2483,2011-04-18,Summer,2011,Apr,8,0,Monday,1,Clear,0.46,0.4545,0.63,0.0,20,277,297,623,297,297
2484,2011-04-18,Summer,2011,Apr,9,0,Monday,1,Misty,0.5,0.4848,0.55,0.1045,37,132,169,623,169,169
2485,2011-04-18,Summer,2011,Apr,10,0,Monday,1,Misty,0.52,0.5,0.55,0.1045,41,68,109,623,109,109
2486,2011-04-18,Summer,2011,Apr,11,0,Monday,1,Misty,0.54,0.5152,0.52,0.0896,36,87,123,623,123,123
2487,2011-04-18,Summer,2011,Apr,12,0,Monday,1,Misty,0.56,0.5303,0.49,0.0896,60,124,184,623,184,184
2488,2011-04-18,Summer,2011,Apr,13,0,Monday,1,Misty,0.56,0.5303,0.49,0.1642,41,128,169,623,169,169
2489,2011-04-18,Summer,2011,Apr,14,0,Monday,1,Misty,0.58,0.5455,0.49,0.194,49,95,144,623,144,144
2490,2011-04-18,Summer,2011,Apr,15,0,Monday,1,Misty,0.6,0.6212,0.43,0.194,64,112,176,623,176,176
2491,2011-04-18,Summer,2011,Apr,16,0,Monday,1,Clear,0.6,0.6212,0.46,0.2836,40,165,205,623,205,205
2492,2011-04-18,Summer,2011,Apr,17,0,Monday,1,Clear,0.58,0.5455,0.49,0.2836,66,362,428,623,428,428
2493,2011-04-18,Summer,2011,Apr,18,0,Monday,1,Clear,0.64,0.6212,0.31,0.3582,41,321,362,623,362,362
2494,2011-04-18,Summer,2011,Apr,19,0,Monday,1,Clear,0.56,0.5303,0.46,0.2537,42,244,286,623,286,286
2495,2011-04-18,Summer,2011,Apr,20,0,Monday,1,Clear,0.6,0.6212,0.33,0.2985,29,136,165,623,165,165
2496,2011-04-18,Summer,2011,Apr,21,0,Monday,1,Clear,0.56,0.5303,0.37,0.2836,20,131,151,623,151,151
2497,2011-04-18,Summer,2011,Apr,22,0,Monday,1,Clear,0.52,0.5,0.55,0.2836,9,81,90,623,90,90
2498,2011-04-18,Summer,2011,Apr,23,0,Monday,1,Clear,0.5,0.4848,0.59,0.2537,11,35,46,623,46,46
2499,2011-04-19,Summer,2011,Apr,0,0,Tuesday,1,Clear,0.5,0.4848,0.55,0.2239,2,23,25,622,25,25
2500,2011-04-19,Summer,2011,Apr,1,0,Tuesday,1,Clear,0.46,0.4545,0.63,0.2239,5,2,7,622,7,7
2501,2011-04-19,Summer,2011,Apr,2,0,Tuesday,1,Clear,0.46,0.4545,0.67,0.2836,8,5,13,622,13,13
2502,2011-04-19,Summer,2011,Apr,3,0,Tuesday,1,Clear,0.48,0.4697,0.63,0.2239,0,3,3,622,3,3
2503,2011-04-19,Summer,2011,Apr,4,0,Tuesday,1,Clear,0.46,0.4545,0.67,0.0896,1,4,5,622,5,5
2504,2011-04-19,Summer,2011,Apr,5,0,Tuesday,1,Misty,0.46,0.4545,0.72,0.194,1,17,18,622,18,18
2505,2011-04-19,Summer,2011,Apr,6,0,Tuesday,1,Misty,0.48,0.4697,0.67,0.0,2,63,65,622,65,65
2506,2011-04-19,Summer,2011,Apr,7,0,Tuesday,1,Misty,0.52,0.5,0.55,0.0,22,166,188,622,188,188
2507,2011-04-19,Summer,2011,Apr,8,0,Tuesday,1,Misty,0.5,0.4848,0.68,0.1343,20,331,351,622,351,351
2508,2011-04-19,Summer,2011,Apr,9,0,Tuesday,1,Light_rainsnow,0.52,0.5,0.63,0.0896,23,139,162,622,162,162
2509,2011-04-19,Summer,2011,Apr,10,0,Tuesday,1,Misty,0.5,0.4848,0.72,0.2239,15,60,75,622,75,75
2510,2011-04-19,Summer,2011,Apr,11,0,Tuesday,1,Misty,0.54,0.5152,0.68,0.1642,19,53,72,622,72,72
2511,2011-04-19,Summer,2011,Apr,12,0,Tuesday,1,Misty,0.54,0.5152,0.64,0.0896,19,84,103,622,103,103
2512,2011-04-19,Summer,2011,Apr,13,0,Tuesday,1,Misty,0.54,0.5152,0.68,0.2239,26,103,129,622,129,129
2513,2011-04-19,Summer,2011,Apr,14,0,Tuesday,1,Misty,0.54,0.5152,0.64,0.194,19,88,107,622,107,107
2514,2011-04-19,Summer,2011,Apr,15,0,Tuesday,1,Misty,0.54,0.5152,0.65,0.1642,44,83,127,622,127,127
2515,2011-04-19,Summer,2011,Apr,16,0,Tuesday,1,Clear,0.56,0.5303,0.52,0.2985,30,162,192,622,192,192
2516,2011-04-19,Summer,2011,Apr,17,0,Tuesday,1,Clear,0.56,0.5303,0.6,0.1045,39,372,411,622,411,411
2517,2011-04-19,Summer,2011,Apr,18,0,Tuesday,1,Misty,0.54,0.5152,0.64,0.1343,44,377,421,622,421,421
2518,2011-04-19,Summer,2011,Apr,19,0,Tuesday,1,Misty,0.5,0.4848,0.72,0.194,28,248,276,622,276,276
2519,2011-04-19,Summer,2011,Apr,20,0,Tuesday,1,Misty,0.5,0.4848,0.72,0.2239,20,148,168,622,168,168
2520,2011-04-19,Summer,2011,Apr,21,0,Tuesday,1,Misty,0.5,0.4848,0.72,0.1343,8,114,122,622,122,122
2521,2011-04-19,Summer,2011,Apr,22,0,Tuesday,1,Clear,0.48,0.4697,0.77,0.0896,3,109,112,622,112,112
2522,2011-04-19,Summer,2011,Apr,23,0,Tuesday,1,Clear,0.46,0.4545,0.88,0.0896,11,41,52,622,52,52
2523,2011-04-20,Summer,2011,Apr,0,0,Wednesday,1,Clear,0.44,0.4394,0.88,0.1343,4,29,33,621,33,33
2524,2011-04-20,Summer,2011,Apr,1,0,Wednesday,1,Clear,0.42,0.4242,0.94,0.1642,2,5,7,621,7,7
2525,2011-04-20,Summer,2011,Apr,2,0,Wednesday,1,Clear,0.42,0.4242,0.94,0.1642,0,2,2,621,2,2
2526,2011-04-20,Summer,2011,Apr,3,0,Wednesday,1,Clear,0.42,0.4242,0.94,0.0,0,2,2,621,2,2
2527,2011-04-20,Summer,2011,Apr,4,0,Wednesday,1,Clear,0.4,0.4091,1.0,0.1045,5,4,9,621,9,9
2528,2011-04-20,Summer,2011,Apr,5,0,Wednesday,1,Clear,0.4,0.4091,0.94,0.194,1,14,15,621,15,15
2529,2011-04-20,Summer,2011,Apr,6,0,Wednesday,1,Clear,0.42,0.4242,0.94,0.1642,2,62,64,621,64,64
2530,2011-04-20,Summer,2011,Apr,7,0,Wednesday,1,Clear,0.44,0.4394,0.94,0.0,26,211,237,621,237,237
2531,2011-04-20,Summer,2011,Apr,8,0,Wednesday,1,Clear,0.62,0.6061,0.69,0.4627,22,374,396,621,396,396
2532,2011-04-20,Summer,2011,Apr,9,0,Wednesday,1,Clear,0.66,0.6212,0.61,0.2836,27,170,197,621,197,197
2533,2011-04-20,Summer,2011,Apr,10,0,Wednesday,1,Clear,0.62,0.6061,0.69,0.0896,45,86,131,621,131,131
2534,2011-04-20,Summer,2011,Apr,11,0,Wednesday,1,Clear,0.62,0.6061,0.69,0.0896,31,87,118,621,118,118
2535,2011-04-20,Summer,2011,Apr,12,0,Wednesday,1,Clear,0.7,0.6515,0.48,0.3881,28,117,145,621,145,145
2536,2011-04-20,Summer,2011,Apr,13,0,Wednesday,1,Clear,0.7,0.6515,0.48,0.3881,42,135,177,621,177,177
2537,2011-04-20,Summer,2011,Apr,14,0,Wednesday,1,Clear,0.74,0.6515,0.4,0.4627,33,115,148,621,148,148
2538,2011-04-20,Summer,2011,Apr,15,0,Wednesday,1,Misty,0.76,0.6667,0.35,0.3582,32,113,145,621,145,145
2539,2011-04-20,Summer,2011,Apr,16,0,Wednesday,1,Misty,0.76,0.6667,0.35,0.3582,54,201,255,621,255,255
2540,2011-04-20,Summer,2011,Apr,17,0,Wednesday,1,Misty,0.74,0.6515,0.37,0.4179,34,398,432,621,432,432
2541,2011-04-20,Summer,2011,Apr,18,0,Wednesday,1,Clear,0.74,0.6515,0.3,0.3582,56,385,441,621,441,441
2542,2011-04-20,Summer,2011,Apr,19,0,Wednesday,1,Clear,0.7,0.6364,0.32,0.2537,74,309,383,621,383,383
2543,2011-04-20,Summer,2011,Apr,20,0,Wednesday,1,Clear,0.68,0.6212,0.32,0.1045,31,194,225,621,225,225
2544,2011-04-20,Summer,2011,Apr,21,0,Wednesday,1,Clear,0.66,0.6212,0.36,0.2836,38,134,172,621,172,172
2545,2011-04-20,Summer,2011,Apr,22,0,Wednesday,1,Clear,0.62,0.6212,0.41,0.2537,12,105,117,621,117,117
2546,2011-04-20,Summer,2011,Apr,23,0,Wednesday,1,Clear,0.6,0.6212,0.4,0.3284,14,79,93,621,93,93
2547,2011-04-21,Summer,2011,Apr,0,0,Thursday,1,Clear,0.56,0.5303,0.43,0.3582,11,33,44,620,44,44
2548,2011-04-21,Summer,2011,Apr,1,0,Thursday,1,Clear,0.52,0.5,0.45,0.2239,6,20,26,620,26,26
2549,2011-04-21,Summer,2011,Apr,2,0,Thursday,1,Clear,0.5,0.4848,0.42,0.3881,3,10,13,620,13,13
2550,2011-04-21,Summer,2011,Apr,3,0,Thursday,1,Misty,0.46,0.4545,0.51,0.4627,4,3,7,620,7,7
2551,2011-04-21,Summer,2011,Apr,4,0,Thursday,1,Misty,0.44,0.4394,0.54,0.4478,2,4,6,620,6,6
2552,2011-04-21,Summer,2011,Apr,5,0,Thursday,1,Misty,0.42,0.4242,0.54,0.5522,0,14,14,620,14,14
2553,2011-04-21,Summer,2011,Apr,6,0,Thursday,1,Misty,0.4,0.4091,0.58,0.5821,2,73,75,620,75,75
2554,2011-04-21,Summer,2011,Apr,7,0,Thursday,1,Misty,0.42,0.4242,0.47,0.4627,15,183,198,620,198,198
2555,2011-04-21,Summer,2011,Apr,8,0,Thursday,1,Misty,0.4,0.4091,0.5,0.4925,19,346,365,620,365,365
2556,2011-04-21,Summer,2011,Apr,9,0,Thursday,1,Misty,0.42,0.4242,0.47,0.2836,18,178,196,620,196,196
2557,2011-04-21,Summer,2011,Apr,10,0,Thursday,1,Clear,0.42,0.4242,0.44,0.3582,25,73,98,620,98,98
2558,2011-04-21,Summer,2011,Apr,11,0,Thursday,1,Clear,0.44,0.4394,0.41,0.2836,34,99,133,620,133,133
2559,2011-04-21,Summer,2011,Apr,12,0,Thursday,1,Clear,0.46,0.4545,0.38,0.1642,49,150,199,620,199,199
2560,2011-04-21,Summer,2011,Apr,13,0,Thursday,1,Clear,0.48,0.4697,0.33,0.3284,55,122,177,620,177,177
2561,2011-04-21,Summer,2011,Apr,14,0,Thursday,1,Clear,0.5,0.4848,0.34,0.3881,68,160,228,620,228,228
2562,2011-04-21,Summer,2011,Apr,15,0,Thursday,1,Clear,0.52,0.5,0.29,0.4179,69,166,235,620,235,235
2563,2011-04-21,Summer,2011,Apr,16,0,Thursday,1,Clear,0.52,0.5,0.27,0.3582,66,228,294,620,294,294
2564,2011-04-21,Summer,2011,Apr,17,0,Thursday,1,Clear,0.5,0.4848,0.29,0.1642,79,402,481,620,481,481
2565,2011-04-21,Summer,2011,Apr,18,0,Thursday,1,Clear,0.5,0.4848,0.25,0.2836,71,381,452,620,452,452
2566,2011-04-21,Summer,2011,Apr,19,0,Thursday,1,Clear,0.46,0.4545,0.28,0.2836,52,272,324,620,324,324
2567,2011-04-21,Summer,2011,Apr,20,0,Thursday,1,Clear,0.44,0.4394,0.3,0.1343,28,176,204,620,204,204
2568,2011-04-21,Summer,2011,Apr,21,0,Thursday,1,Clear,0.42,0.4242,0.47,0.194,25,159,184,620,184,184
2569,2011-04-21,Summer,2011,Apr,22,0,Thursday,1,Clear,0.42,0.4242,0.38,0.0896,31,106,137,620,137,137
2570,2011-04-21,Summer,2011,Apr,23,0,Thursday,1,Clear,0.4,0.4091,0.43,0.1045,13,86,99,620,99,99
2571,2011-04-22,Summer,2011,Apr,0,0,Friday,1,Clear,0.36,0.3485,0.62,0.194,3,30,33,619,33,33
2572,2011-04-22,Summer,2011,Apr,1,0,Friday,1,Clear,0.36,0.3333,0.53,0.2537,2,22,24,619,24,24
2573,2011-04-22,Summer,2011,Apr,2,0,Friday,1,Clear,0.36,0.3333,0.53,0.2985,2,7,9,619,9,9
2574,2011-04-22,Summer,2011,Apr,3,0,Friday,1,Clear,0.36,0.3333,0.53,0.2985,0,2,2,619,2,2
2575,2011-04-22,Summer,2011,Apr,4,0,Friday,1,Clear,0.34,0.3182,0.53,0.2836,1,2,3,619,3,3
2576,2011-04-22,Summer,2011,Apr,5,0,Friday,1,Clear,0.34,0.3182,0.53,0.2239,0,16,16,619,16,16
2577,2011-04-22,Summer,2011,Apr,6,0,Friday,1,Clear,0.34,0.3182,0.53,0.2836,2,47,49,619,49,49
2578,2011-04-22,Summer,2011,Apr,7,0,Friday,1,Misty,0.34,0.3182,0.53,0.2836,5,175,180,619,180,180
2579,2011-04-22,Summer,2011,Apr,8,0,Friday,1,Misty,0.34,0.3182,0.53,0.2537,15,331,346,619,346,346
2580,2011-04-22,Summer,2011,Apr,9,0,Friday,1,Light_rainsnow,0.34,0.303,0.61,0.2985,17,178,195,619,195,195
2581,2011-04-22,Summer,2011,Apr,10,0,Friday,1,Misty,0.36,0.3485,0.62,0.194,32,104,136,619,136,136
2582,2011-04-22,Summer,2011,Apr,11,0,Friday,1,Light_rainsnow,0.34,0.3333,0.66,0.194,23,83,106,619,106,106
2583,2011-04-22,Summer,2011,Apr,12,0,Friday,1,Light_rainsnow,0.34,0.3333,0.76,0.1343,19,61,80,619,80,80
2584,2011-04-22,Summer,2011,Apr,13,0,Friday,1,Light_rainsnow,0.34,0.3333,0.87,0.194,3,37,40,619,40,40
2585,2011-04-22,Summer,2011,Apr,14,0,Friday,1,Light_rainsnow,0.34,0.3182,0.87,0.2537,3,33,36,619,36,36
2586,2011-04-22,Summer,2011,Apr,15,0,Friday,1,Light_rainsnow,0.34,0.3333,0.87,0.194,13,62,75,619,75,75
2587,2011-04-22,Summer,2011,Apr,16,0,Friday,1,Light_rainsnow,0.34,0.3333,0.87,0.1343,4,58,62,619,62,62
2588,2011-04-22,Summer,2011,Apr,17,0,Friday,1,Light_rainsnow,0.32,0.303,0.93,0.2239,6,63,69,619,69,69
2589,2011-04-22,Summer,2011,Apr,18,0,Friday,1,Light_rainsnow,0.32,0.303,0.93,0.2239,4,47,51,619,51,51
2590,2011-04-22,Summer,2011,Apr,19,0,Friday,1,Light_rainsnow,0.32,0.303,0.93,0.2239,7,48,55,619,55,55
2591,2011-04-22,Summer,2011,Apr,20,0,Friday,1,Light_rainsnow,0.32,0.303,0.87,0.2239,8,39,47,619,47,47
2592,2011-04-22,Summer,2011,Apr,21,0,Friday,1,Light_rainsnow,0.3,0.303,0.93,0.1642,5,23,28,619,28,28
2593,2011-04-22,Summer,2011,Apr,22,0,Friday,1,Light_rainsnow,0.3,0.303,1.0,0.1343,3,21,24,619,24,24
2594,2011-04-22,Summer,2011,Apr,23,0,Friday,1,Light_rainsnow,0.32,0.3333,0.93,0.1045,0,17,17,619,17,17
2595,2011-04-23,Summer,2011,Apr,0,0,Saturday,0,Misty,0.32,0.3182,1.0,0.194,0,18,18,618,18,18
2596,2011-04-23,Summer,2011,Apr,1,0,Saturday,0,Misty,0.32,0.3182,1.0,0.194,5,11,16,618,16,16
2597,2011-04-23,Summer,2011,Apr,2,0,Saturday,0,Light_rainsnow,0.32,0.3333,1.0,0.1343,3,14,17,618,17,17
2598,2011-04-23,Summer,2011,Apr,3,0,Saturday,0,Light_rainsnow,0.32,0.3333,1.0,0.0896,0,4,4,618,4,4
2599,2011-04-23,Summer,2011,Apr,4,0,Saturday,0,Light_rainsnow,0.34,0.3636,1.0,0.0,2,3,5,618,5,5
2600,2011-04-23,Summer,2011,Apr,5,0,Saturday,0,Light_rainsnow,0.34,0.3636,1.0,0.0,1,6,7,618,7,7
2601,2011-04-23,Summer,2011,Apr,6,0,Saturday,0,Misty,0.34,0.3333,1.0,0.1642,0,11,11,618,11,11
2602,2011-04-23,Summer,2011,Apr,7,0,Saturday,0,Light_rainsnow,0.34,0.3333,1.0,0.1642,2,17,19,618,19,19
2603,2011-04-23,Summer,2011,Apr,8,0,Saturday,0,Misty,0.36,0.3333,1.0,0.2537,15,32,47,618,47,47
2604,2011-04-23,Summer,2011,Apr,9,0,Saturday,0,Misty,0.38,0.3939,0.94,0.2985,13,55,68,618,68,68
2605,2011-04-23,Summer,2011,Apr,10,0,Saturday,0,Misty,0.42,0.4242,0.88,0.2239,36,93,129,618,129,129
2606,2011-04-23,Summer,2011,Apr,11,0,Saturday,0,Misty,0.46,0.4545,0.88,0.2239,68,164,232,618,232,232
2607,2011-04-23,Summer,2011,Apr,12,0,Saturday,0,Clear,0.52,0.5,0.83,0.4179,94,197,291,618,291,291
2608,2011-04-23,Summer,2011,Apr,13,0,Saturday,0,Clear,0.52,0.5,0.83,0.3881,126,186,312,618,312,312
2609,2011-04-23,Summer,2011,Apr,14,0,Saturday,0,Clear,0.58,0.5455,0.78,0.3582,182,209,391,618,391,391
2610,2011-04-23,Summer,2011,Apr,15,0,Saturday,0,Clear,0.6,0.5909,0.73,0.3881,171,226,397,618,397,397
2611,2011-04-23,Summer,2011,Apr,16,0,Saturday,0,Clear,0.6,0.5909,0.73,0.2836,180,246,426,618,426,426
2612,2011-04-23,Summer,2011,Apr,17,0,Saturday,0,Clear,0.6,0.5909,0.73,0.3284,168,215,383,618,383,383
2613,2011-04-23,Summer,2011,Apr,18,0,Saturday,0,Clear,0.58,0.5455,0.78,0.194,149,227,376,618,376,376
2614,2011-04-23,Summer,2011,Apr,19,0,Saturday,0,Clear,0.56,0.5303,0.83,0.2836,84,199,283,618,283,283
2615,2011-04-23,Summer,2011,Apr,20,0,Saturday,0,Misty,0.54,0.5152,0.88,0.2537,45,138,183,618,183,183
2616,2011-04-23,Summer,2011,Apr,21,0,Saturday,0,Misty,0.56,0.5303,0.83,0.2836,32,103,135,618,135,135
2617,2011-04-23,Summer,2011,Apr,22,0,Saturday,0,Misty,0.58,0.5455,0.78,0.2537,55,114,169,618,169,169
2618,2011-04-23,Summer,2011,Apr,23,0,Saturday,0,Misty,0.54,0.5152,0.88,0.1642,31,86,117,618,117,117
2619,2011-04-24,Summer,2011,Apr,0,0,Sunday,0,Clear,0.52,0.5,0.83,0.2239,30,66,96,617,96,96
2620,2011-04-24,Summer,2011,Apr,1,0,Sunday,0,Clear,0.5,0.4848,0.88,0.194,14,40,54,617,54,54
2621,2011-04-24,Summer,2011,Apr,2,0,Sunday,0,Clear,0.5,0.4848,0.88,0.194,27,45,72,617,72,72
2622,2011-04-24,Summer,2011,Apr,3,0,Sunday,0,Clear,0.5,0.4848,0.94,0.0896,4,20,24,617,24,24
2623,2011-04-24,Summer,2011,Apr,4,0,Sunday,0,Clear,0.5,0.4848,0.94,0.0896,0,5,5,617,5,5
2624,2011-04-24,Summer,2011,Apr,5,0,Sunday,0,Clear,0.5,0.4848,0.94,0.0896,5,7,12,617,12,12
2625,2011-04-24,Summer,2011,Apr,6,0,Sunday,0,Misty,0.5,0.4848,1.0,0.0,10,3,13,617,13,13
2626,2011-04-24,Summer,2011,Apr,7,0,Sunday,0,Misty,0.5,0.4848,1.0,0.0,16,11,27,617,27,27
2627,2011-04-24,Summer,2011,Apr,8,0,Sunday,0,Clear,0.52,0.5,0.94,0.2239,38,42,80,617,80,80
2628,2011-04-24,Summer,2011,Apr,9,0,Sunday,0,Clear,0.56,0.5303,0.88,0.2537,73,104,177,617,177,177
2629,2011-04-24,Summer,2011,Apr,10,0,Sunday,0,Clear,0.6,0.5758,0.78,0.1642,118,171,289,617,289,289
2630,2011-04-24,Summer,2011,Apr,11,0,Sunday,0,Clear,0.66,0.6212,0.65,0.1343,124,193,317,617,317,317
2631,2011-04-24,Summer,2011,Apr,12,0,Sunday,0,Clear,0.68,0.6364,0.65,0.2537,168,220,388,617,388,388
2632,2011-04-24,Summer,2011,Apr,13,0,Sunday,0,Clear,0.7,0.6515,0.58,0.2836,205,236,441,617,441,441
2633,2011-04-24,Summer,2011,Apr,14,0,Sunday,0,Clear,0.7,0.6515,0.54,0.3284,197,223,420,617,420,420
2634,2011-04-24,Summer,2011,Apr,15,0,Sunday,0,Clear,0.66,0.6212,0.61,0.2537,167,202,369,617,369,369
2635,2011-04-24,Summer,2011,Apr,16,0,Sunday,0,Clear,0.74,0.6667,0.48,0.3881,162,197,359,617,359,359
2636,2011-04-24,Summer,2011,Apr,17,0,Sunday,0,Clear,0.66,0.6212,0.65,0.2985,142,189,331,617,331,331
2637,2011-04-24,Summer,2011,Apr,18,0,Sunday,0,Clear,0.64,0.6061,0.69,0.1642,96,174,270,617,270,270
2638,2011-04-24,Summer,2011,Apr,19,0,Sunday,0,Light_rainsnow,0.6,0.5606,0.83,0.2836,62,132,194,617,194,194
2639,2011-04-24,Summer,2011,Apr,20,0,Sunday,0,Light_rainsnow,0.6,0.5606,0.83,0.2836,34,71,105,617,105,105
2640,2011-04-24,Summer,2011,Apr,21,0,Sunday,0,Light_rainsnow,0.54,0.5152,0.94,0.1642,8,53,61,617,61,61
2641,2011-04-24,Summer,2011,Apr,22,0,Sunday,0,Light_rainsnow,0.54,0.5152,1.0,0.1642,5,40,45,617,45,45
2642,2011-04-24,Summer,2011,Apr,23,0,Sunday,0,Light_rainsnow,0.54,0.5152,1.0,0.0896,5,37,42,617,42,42
2643,2011-04-25,Summer,2011,Apr,0,0,Monday,1,Light_rainsnow,0.52,0.5,1.0,0.0,2,10,12,616,12,12
2644,2011-04-25,Summer,2011,Apr,1,0,Monday,1,Clear,0.54,0.5152,1.0,0.0896,2,8,10,616,10,10
2645,2011-04-25,Summer,2011,Apr,2,0,Monday,1,Clear,0.54,0.5152,1.0,0.0896,1,9,10,616,10,10
2646,2011-04-25,Summer,2011,Apr,3,0,Monday,1,Misty,0.5,0.4848,1.0,0.1045,2,8,10,616,10,10
2647,2011-04-25,Summer,2011,Apr,4,0,Monday,1,Misty,0.52,0.5,1.0,0.0,1,4,5,616,5,5
2648,2011-04-25,Summer,2011,Apr,5,0,Monday,1,Misty,0.46,0.4545,1.0,0.0,3,14,17,616,17,17
2649,2011-04-25,Summer,2011,Apr,6,0,Monday,1,Misty,0.5,0.4848,1.0,0.0,7,59,66,616,66,66
2650,2011-04-25,Summer,2011,Apr,7,0,Monday,1,Misty,0.52,0.5,1.0,0.0896,13,183,196,616,196,196
2651,2011-04-25,Summer,2011,Apr,8,0,Monday,1,Clear,0.56,0.5303,0.88,0.1045,27,326,353,616,353,353
2652,2011-04-25,Summer,2011,Apr,9,0,Monday,1,Clear,0.6,0.5606,0.83,0.1343,27,147,174,616,174,174
2653,2011-04-25,Summer,2011,Apr,10,0,Monday,1,Clear,0.64,0.6061,0.73,0.2239,61,64,125,616,125,125
2654,2011-04-25,Summer,2011,Apr,11,0,Monday,1,Clear,0.64,0.6061,0.73,0.2239,53,94,147,616,147,147
2655,2011-04-25,Summer,2011,Apr,12,0,Monday,1,Clear,0.66,0.6212,0.74,0.2537,48,140,188,616,188,188
2656,2011-04-25,Summer,2011,Apr,13,0,Monday,1,Clear,0.7,0.6515,0.65,0.2239,57,146,203,616,203,203
2657,2011-04-25,Summer,2011,Apr,14,0,Monday,1,Clear,0.72,0.6667,0.54,0.2239,47,99,146,616,146,146
2658,2011-04-25,Summer,2011,Apr,15,0,Monday,1,Clear,0.74,0.6667,0.51,0.2239,50,125,175,616,175,175
2659,2011-04-25,Summer,2011,Apr,16,0,Monday,1,Clear,0.7,0.6515,0.54,0.3582,41,198,239,616,239,239
2660,2011-04-25,Summer,2011,Apr,17,0,Monday,1,Clear,0.7,0.6515,0.54,0.2985,80,441,521,616,521,521
2661,2011-04-25,Summer,2011,Apr,18,0,Monday,1,Clear,0.68,0.6364,0.57,0.3582,74,425,499,616,499,499
2662,2011-04-25,Summer,2011,Apr,19,0,Monday,1,Clear,0.66,0.6212,0.57,0.3284,62,320,382,616,382,382
2663,2011-04-25,Summer,2011,Apr,20,0,Monday,1,Clear,0.66,0.6212,0.61,0.2836,42,195,237,616,237,237
2664,2011-04-25,Summer,2011,Apr,21,0,Monday,1,Clear,0.62,0.6061,0.69,0.2537,41,149,190,616,190,190
2665,2011-04-25,Summer,2011,Apr,22,0,Monday,1,Clear,0.6,0.5909,0.73,0.2985,23,83,106,616,106,106
2666,2011-04-25,Summer,2011,Apr,23,0,Monday,1,Clear,0.58,0.5455,0.78,0.2836,9,53,62,616,62,62
2667,2011-04-26,Summer,2011,Apr,0,0,Tuesday,1,Clear,0.62,0.6061,0.69,0.2836,10,17,27,615,27,27
2668,2011-04-26,Summer,2011,Apr,1,0,Tuesday,1,Clear,0.62,0.5909,0.73,0.2836,16,5,21,615,21,21
2669,2011-04-26,Summer,2011,Apr,2,0,Tuesday,1,Clear,0.56,0.5303,0.83,0.3284,17,9,26,615,26,26
2670,2011-04-26,Summer,2011,Apr,3,0,Tuesday,1,Clear,0.54,0.5152,0.88,0.2836,17,4,21,615,21,21
2671,2011-04-26,Summer,2011,Apr,4,0,Tuesday,1,Clear,0.56,0.5303,0.83,0.2537,2,4,6,615,6,6
2672,2011-04-26,Summer,2011,Apr,5,0,Tuesday,1,Clear,0.54,0.5152,0.88,0.2537,0,16,16,615,16,16
2673,2011-04-26,Summer,2011,Apr,6,0,Tuesday,1,Clear,0.56,0.5303,0.88,0.2239,0,80,80,615,80,80
2674,2011-04-26,Summer,2011,Apr,7,0,Tuesday,1,Clear,0.58,0.5455,0.83,0.2985,16,254,270,615,270,270
2675,2011-04-26,Summer,2011,Apr,8,0,Tuesday,1,Clear,0.58,0.5455,0.83,0.2985,32,417,449,615,449,449
2676,2011-04-26,Summer,2011,Apr,9,0,Tuesday,1,Clear,0.64,0.6061,0.73,0.3582,35,164,199,615,199,199
2677,2011-04-26,Summer,2011,Apr,10,0,Tuesday,1,Clear,0.66,0.6212,0.69,0.3582,22,98,120,615,120,120
2678,2011-04-26,Summer,2011,Apr,11,0,Tuesday,1,Clear,0.68,0.6364,0.65,0.3881,40,132,172,615,172,172
2679,2011-04-26,Summer,2011,Apr,12,0,Tuesday,1,Clear,0.7,0.6515,0.61,0.4179,40,146,186,615,186,186
2680,2011-04-26,Summer,2011,Apr,13,0,Tuesday,1,Clear,0.74,0.6667,0.51,0.4478,37,139,176,615,176,176
2681,2011-04-26,Summer,2011,Apr,14,0,Tuesday,1,Clear,0.72,0.6667,0.58,0.3284,40,115,155,615,155,155
2682,2011-04-26,Summer,2011,Apr,15,0,Tuesday,1,Clear,0.7,0.6515,0.61,0.3582,34,119,153,615,153,153
2683,2011-04-26,Summer,2011,Apr,16,0,Tuesday,1,Clear,0.7,0.6515,0.58,0.3881,40,251,291,615,291,291
2684,2011-04-26,Summer,2011,Apr,17,0,Tuesday,1,Clear,0.68,0.6364,0.61,0.3582,66,455,521,615,521,521
2685,2011-04-26,Summer,2011,Apr,18,0,Tuesday,1,Clear,0.68,0.6364,0.65,0.4478,65,463,528,615,528,528
2686,2011-04-26,Summer,2011,Apr,19,0,Tuesday,1,Clear,0.64,0.6061,0.73,0.4179,42,286,328,615,328,328
2687,2011-04-26,Summer,2011,Apr,20,0,Tuesday,1,Clear,0.64,0.6061,0.73,0.3582,35,199,234,615,234,234
2688,2011-04-26,Summer,2011,Apr,21,0,Tuesday,1,Clear,0.62,0.5909,0.78,0.2836,33,162,195,615,195,195
2689,2011-04-26,Summer,2011,Apr,22,0,Tuesday,1,Misty,0.6,0.5606,0.83,0.194,32,116,148,615,148,148
2690,2011-04-26,Summer,2011,Apr,23,0,Tuesday,1,Misty,0.6,0.5606,0.83,0.2239,7,71,78,615,78,78
2691,2011-04-27,Summer,2011,Apr,0,0,Wednesday,1,Clear,0.6,0.5606,0.83,0.2239,3,24,27,614,27,27
2692,2011-04-27,Summer,2011,Apr,1,0,Wednesday,1,Clear,0.6,0.5606,0.83,0.2537,2,15,17,614,17,17
2693,2011-04-27,Summer,2011,Apr,2,0,Wednesday,1,Clear,0.58,0.5455,0.88,0.2537,0,5,5,614,5,5
2694,2011-04-27,Summer,2011,Apr,3,0,Wednesday,1,Misty,0.58,0.5455,0.88,0.2836,3,4,7,614,7,7
2695,2011-04-27,Summer,2011,Apr,4,0,Wednesday,1,Clear,0.56,0.5303,0.94,0.2239,0,6,6,614,6,6
2696,2011-04-27,Summer,2011,Apr,5,0,Wednesday,1,Misty,0.56,0.5303,0.94,0.2537,1,16,17,614,17,17
2697,2011-04-27,Summer,2011,Apr,6,0,Wednesday,1,Clear,0.56,0.5303,0.94,0.2537,5,79,84,614,84,84
2698,2011-04-27,Summer,2011,Apr,7,0,Wednesday,1,Misty,0.58,0.5455,0.88,0.2836,17,229,246,614,246,246
2699,2011-04-27,Summer,2011,Apr,8,0,Wednesday,1,Misty,0.58,0.5455,0.88,0.3284,31,413,444,614,444,444
2700,2011-04-27,Summer,2011,Apr,9,0,Wednesday,1,Misty,0.6,0.5455,0.88,0.4179,20,161,181,614,181,181
2701,2011-04-27,Summer,2011,Apr,10,0,Wednesday,1,Misty,0.62,0.5758,0.83,0.2836,26,66,92,614,92,92
2702,2011-04-27,Summer,2011,Apr,11,0,Wednesday,1,Misty,0.64,0.5909,0.78,0.2836,53,103,156,614,156,156
2703,2011-04-27,Summer,2011,Apr,12,0,Wednesday,1,Clear,0.66,0.6061,0.78,0.3284,38,135,173,614,173,173
2704,2011-04-27,Summer,2011,Apr,13,0,Wednesday,1,Clear,0.64,0.5909,0.78,0.2985,31,119,150,614,150,150
2705,2011-04-27,Summer,2011,Apr,14,0,Wednesday,1,Clear,0.68,0.6364,0.74,0.2836,29,119,148,614,148,148
2706,2011-04-27,Summer,2011,Apr,15,0,Wednesday,1,Clear,0.7,0.6515,0.65,0.4925,18,120,138,614,138,138
2707,2011-04-27,Summer,2011,Apr,16,0,Wednesday,1,Clear,0.7,0.6515,0.7,0.3881,29,189,218,614,218,218
2708,2011-04-27,Summer,2011,Apr,17,0,Wednesday,1,Light_rainsnow,0.66,0.6061,0.83,0.3881,63,458,521,614,521,521
2709,2011-04-27,Summer,2011,Apr,18,0,Wednesday,1,Light_rainsnow,0.66,0.6061,0.83,0.3881,46,366,412,614,412,412
2710,2011-04-27,Summer,2011,Apr,19,0,Wednesday,1,Clear,0.62,0.5909,0.78,0.2836,40,220,260,614,260,260
2711,2011-04-27,Summer,2011,Apr,20,0,Wednesday,1,Clear,0.64,0.5758,0.83,0.3284,30,188,218,614,218,218
2712,2011-04-27,Summer,2011,Apr,21,0,Wednesday,1,Clear,0.62,0.5606,0.88,0.2836,19,126,145,614,145,145
2713,2011-04-27,Summer,2011,Apr,22,0,Wednesday,1,Misty,0.62,0.5606,0.88,0.3284,18,111,129,614,129,129
2714,2011-04-27,Summer,2011,Apr,23,0,Wednesday,1,Misty,0.62,0.5606,0.88,0.3582,25,53,78,614,78,78
2715,2011-04-28,Summer,2011,Apr,0,0,Thursday,1,Clear,0.64,0.5909,0.78,0.3582,13,41,54,613,54,54
2716,2011-04-28,Summer,2011,Apr,1,0,Thursday,1,Misty,0.62,0.5758,0.83,0.3881,8,12,20,613,20,20
2717,2011-04-28,Summer,2011,Apr,2,0,Thursday,1,Misty,0.62,0.5758,0.83,0.4478,14,7,21,613,21,21
2718,2011-04-28,Summer,2011,Apr,3,0,Thursday,1,Misty,0.64,0.5909,0.78,0.3881,2,1,3,613,3,3
2719,2011-04-28,Summer,2011,Apr,4,0,Thursday,1,Misty,0.62,0.5758,0.83,0.4179,4,5,9,613,9,9
2720,2011-04-28,Summer,2011,Apr,5,0,Thursday,1,Misty,0.62,0.5758,0.83,0.3881,0,13,13,613,13,13
2721,2011-04-28,Summer,2011,Apr,6,0,Thursday,1,Misty,0.64,0.5909,0.78,0.4627,7,79,86,613,86,86
2722,2011-04-28,Summer,2011,Apr,7,0,Thursday,1,Misty,0.64,0.5909,0.78,0.4478,14,201,215,613,215,215
2723,2011-04-28,Summer,2011,Apr,8,0,Thursday,1,Misty,0.66,0.6061,0.78,0.4478,31,367,398,613,398,398
2724,2011-04-28,Summer,2011,Apr,9,0,Thursday,1,Light_rainsnow,0.62,0.5606,0.88,0.3284,18,165,183,613,183,183
2725,2011-04-28,Summer,2011,Apr,10,0,Thursday,1,Misty,0.62,0.5606,0.88,0.2836,9,45,54,613,54,54
2726,2011-04-28,Summer,2011,Apr,11,0,Thursday,1,Misty,0.62,0.5758,0.83,0.2836,10,74,84,613,84,84
2727,2011-04-28,Summer,2011,Apr,12,0,Thursday,1,Misty,0.62,0.5909,0.78,0.2537,23,84,107,613,107,107
2728,2011-04-28,Summer,2011,Apr,13,0,Thursday,1,Misty,0.62,0.5758,0.83,0.2985,18,103,121,613,121,121
2729,2011-04-28,Summer,2011,Apr,14,0,Thursday,1,Clear,0.62,0.5758,0.83,0.2985,21,121,142,613,142,142
2730,2011-04-28,Summer,2011,Apr,15,0,Thursday,1,Clear,0.66,0.6212,0.69,0.3284,46,117,163,613,163,163
2731,2011-04-28,Summer,2011,Apr,16,0,Thursday,1,Clear,0.62,0.5909,0.78,0.2537,42,228,270,613,270,270
2732,2011-04-28,Summer,2011,Apr,17,0,Thursday,1,Clear,0.64,0.6212,0.47,0.3582,49,406,455,613,455,455
2733,2011-04-28,Summer,2011,Apr,18,0,Thursday,1,Clear,0.64,0.6212,0.47,0.3582,44,486,530,613,530,530
2734,2011-04-28,Summer,2011,Apr,19,0,Thursday,1,Clear,0.62,0.6212,0.43,0.2985,57,347,404,613,404,404
2735,2011-04-28,Summer,2011,Apr,20,0,Thursday,1,Clear,0.58,0.5455,0.43,0.2239,49,220,269,613,269,269
2736,2011-04-28,Summer,2011,Apr,21,0,Thursday,1,Clear,0.56,0.5303,0.46,0.1343,27,167,194,613,194,194
2737,2011-04-28,Summer,2011,Apr,22,0,Thursday,1,Clear,0.54,0.5152,0.45,0.1642,34,119,153,613,153,153
2738,2011-04-28,Summer,2011,Apr,23,0,Thursday,1,Clear,0.54,0.5152,0.39,0.0896,29,81,110,613,110,110
2739,2011-04-29,Summer,2011,Apr,0,0,Friday,1,Clear,0.52,0.5,0.39,0.2836,11,37,48,612,48,48
2740,2011-04-29,Summer,2011,Apr,1,0,Friday,1,Clear,0.5,0.4848,0.45,0.0896,10,21,31,612,31,31
2741,2011-04-29,Summer,2011,Apr,2,0,Friday,1,Clear,0.46,0.4545,0.63,0.1045,2,8,10,612,10,10
2742,2011-04-29,Summer,2011,Apr,3,0,Friday,1,Clear,0.46,0.4545,0.59,0.0896,1,4,5,612,5,5
2743,2011-04-29,Summer,2011,Apr,4,0,Friday,1,Clear,0.46,0.4545,0.51,0.1343,0,6,6,612,6,6
2744,2011-04-29,Summer,2011,Apr,5,0,Friday,1,Clear,0.46,0.4545,0.47,0.1343,0,25,25,612,25,25
2745,2011-04-29,Summer,2011,Apr,6,0,Friday,1,Clear,0.5,0.4848,0.45,0.2836,4,67,71,612,71,71
2746,2011-04-29,Summer,2011,Apr,7,0,Friday,1,Clear,0.52,0.5,0.42,0.194,18,222,240,612,240,240
2747,2011-04-29,Summer,2011,Apr,8,0,Friday,1,Clear,0.54,0.5152,0.39,0.2985,35,386,421,612,421,421
2748,2011-04-29,Summer,2011,Apr,9,0,Friday,1,Clear,0.54,0.5152,0.39,0.3284,45,185,230,612,230,230
2749,2011-04-29,Summer,2011,Apr,10,0,Friday,1,Clear,0.56,0.5303,0.4,0.2836,57,99,156,612,156,156
2750,2011-04-29,Summer,2011,Apr,11,0,Friday,1,Clear,0.6,0.6212,0.38,0.2239,49,108,157,612,157,157
2751,2011-04-29,Summer,2011,Apr,12,0,Friday,1,Clear,0.56,0.5303,0.37,0.2836,63,160,223,612,223,223
2752,2011-04-29,Summer,2011,Apr,13,0,Friday,1,Clear,0.56,0.5303,0.37,0.2985,74,234,308,612,308,308
2753,2011-04-29,Summer,2011,Apr,14,0,Friday,1,Clear,0.6,0.6212,0.35,0.3284,58,190,248,612,248,248
2754,2011-04-29,Summer,2011,Apr,15,0,Friday,1,Misty,0.56,0.5303,0.4,0.2985,77,175,252,612,252,252
2755,2011-04-29,Summer,2011,Apr,16,0,Friday,1,Misty,0.54,0.5152,0.42,0.3582,59,240,299,612,299,299
2756,2011-04-29,Summer,2011,Apr,17,0,Friday,1,Misty,0.52,0.5,0.45,0.3881,75,433,508,612,508,508
2757,2011-04-29,Summer,2011,Apr,18,0,Friday,1,Clear,0.52,0.5,0.48,0.3582,55,384,439,612,439,439
2758,2011-04-29,Summer,2011,Apr,19,0,Friday,1,Clear,0.46,0.4545,0.55,0.3284,40,230,270,612,270,270
2759,2011-04-29,Summer,2011,Apr,20,0,Friday,1,Clear,0.48,0.4697,0.48,0.2239,34,160,194,612,194,194
2760,2011-04-29,Summer,2011,Apr,21,0,Friday,1,Clear,0.46,0.4545,0.51,0.194,50,145,195,612,195,195
2761,2011-04-29,Summer,2011,Apr,22,0,Friday,1,Clear,0.42,0.4242,0.58,0.1642,36,110,146,612,146,146
2762,2011-04-29,Summer,2011,Apr,23,0,Friday,1,Misty,0.44,0.4394,0.54,0.0896,25,88,113,612,113,113
2763,2011-04-30,Summer,2011,Apr,0,0,Saturday,0,Misty,0.44,0.4394,0.54,0.2537,33,73,106,611,106,106
2764,2011-04-30,Summer,2011,Apr,1,0,Saturday,0,Misty,0.44,0.4394,0.54,0.1642,15,59,74,611,74,74
2765,2011-04-30,Summer,2011,Apr,2,0,Saturday,0,Misty,0.44,0.4394,0.54,0.2239,12,53,65,611,65,65
2766,2011-04-30,Summer,2011,Apr,3,0,Saturday,0,Misty,0.42,0.4242,0.54,0.194,4,13,17,611,17,17
2767,2011-04-30,Summer,2011,Apr,4,0,Saturday,0,Misty,0.42,0.4242,0.54,0.2239,2,5,7,611,7,7
2768,2011-04-30,Summer,2011,Apr,5,0,Saturday,0,Clear,0.42,0.4242,0.54,0.3881,3,4,7,611,7,7
2769,2011-04-30,Summer,2011,Apr,6,0,Saturday,0,Clear,0.4,0.4091,0.58,0.2836,10,11,21,611,21,21
2770,2011-04-30,Summer,2011,Apr,7,0,Saturday,0,Clear,0.4,0.4091,0.54,0.3881,21,27,48,611,48,48
2771,2011-04-30,Summer,2011,Apr,8,0,Saturday,0,Clear,0.4,0.4091,0.54,0.2985,21,70,91,611,91,91
2772,2011-04-30,Summer,2011,Apr,9,0,Saturday,0,Clear,0.44,0.4394,0.51,0.3582,35,121,156,611,156,156
2773,2011-04-30,Summer,2011,Apr,10,0,Saturday,0,Clear,0.48,0.4697,0.44,0.3881,94,185,279,611,279,279
2774,2011-04-30,Summer,2011,Apr,11,0,Saturday,0,Clear,0.5,0.4848,0.42,0.3582,120,201,321,611,321,321
2775,2011-04-30,Summer,2011,Apr,12,0,Saturday,0,Clear,0.52,0.5,0.42,0.3881,178,238,416,611,416,416
2776,2011-04-30,Summer,2011,Apr,13,0,Saturday,0,Clear,0.54,0.5152,0.39,0.2985,185,270,455,611,455,455
2777,2011-04-30,Summer,2011,Apr,14,0,Saturday,0,Clear,0.54,0.5152,0.39,0.2239,184,268,452,611,452,452
2778,2011-04-30,Summer,2011,Apr,15,0,Saturday,0,Clear,0.56,0.5303,0.37,0.1343,217,282,499,611,499,499
2779,2011-04-30,Summer,2011,Apr,16,0,Saturday,0,Clear,0.58,0.5455,0.37,0.194,191,273,464,611,464,464
2780,2011-04-30,Summer,2011,Apr,17,0,Saturday,0,Clear,0.56,0.5303,0.43,0.1343,162,245,407,611,407,407
2781,2011-04-30,Summer,2011,Apr,18,0,Saturday,0,Clear,0.54,0.5152,0.43,0.1343,134,237,371,611,371,371
2782,2011-04-30,Summer,2011,Apr,19,0,Saturday,0,Clear,0.54,0.5152,0.43,0.1343,150,237,387,611,387,387
2783,2011-04-30,Summer,2011,Apr,20,0,Saturday,0,Clear,0.44,0.4394,0.62,0.1343,65,159,224,611,224,224
2784,2011-04-30,Summer,2011,Apr,21,0,Saturday,0,Clear,0.44,0.4394,0.62,0.1343,58,119,177,611,177,177
2785,2011-04-30,Summer,2011,Apr,22,0,Saturday,0,Clear,0.44,0.4394,0.67,0.1045,37,106,143,611,143,143
2786,2011-04-30,Summer,2011,Apr,23,0,Saturday,0,Clear,0.44,0.4394,0.67,0.1045,34,91,125,611,125,125
2787,2011-05-01,Summer,2011,May,0,0,Sunday,0,Clear,0.42,0.4242,0.67,0.0896,19,77,96,610,96,96
2788,2011-05-01,Summer,2011,May,1,0,Sunday,0,Clear,0.42,0.4242,0.69,0.1045,9,50,59,610,59,59
2789,2011-05-01,Summer,2011,May,2,0,Sunday,0,Clear,0.42,0.4242,0.77,0.1045,7,43,50,610,50,50
2790,2011-05-01,Summer,2011,May,3,0,Sunday,0,Clear,0.4,0.4091,0.82,0.1045,8,15,23,610,23,23
2791,2011-05-01,Summer,2011,May,4,0,Sunday,0,Clear,0.4,0.4091,0.76,0.1045,6,11,17,610,17,17
2792,2011-05-01,Summer,2011,May,5,0,Sunday,0,Clear,0.4,0.4091,0.82,0.0896,0,10,10,610,10,10
2793,2011-05-01,Summer,2011,May,6,0,Sunday,0,Misty,0.4,0.4091,0.82,0.0896,4,9,13,610,13,13
2794,2011-05-01,Summer,2011,May,7,0,Sunday,0,Misty,0.42,0.4242,0.77,0.0896,7,26,33,610,33,33
2795,2011-05-01,Summer,2011,May,8,0,Sunday,0,Misty,0.44,0.4394,0.77,0.1343,16,43,59,610,59,59
2796,2011-05-01,Summer,2011,May,9,0,Sunday,0,Misty,0.46,0.4545,0.72,0.1343,45,96,141,610,141,141
2797,2011-05-01,Summer,2011,May,10,0,Sunday,0,Misty,0.48,0.4697,0.63,0.194,109,155,264,610,264,264
2798,2011-05-01,Summer,2011,May,11,0,Sunday,0,Clear,0.46,0.4545,0.82,0.1045,109,141,250,610,250,250
2799,2011-05-01,Summer,2011,May,12,0,Sunday,0,Misty,0.48,0.4697,0.77,0.1045,109,172,281,610,281,281
2800,2011-05-01,Summer,2011,May,13,0,Sunday,0,Misty,0.5,0.4848,0.63,0.1642,123,209,332,610,332,332
2801,2011-05-01,Summer,2011,May,14,0,Sunday,0,Misty,0.5,0.4848,0.68,0.1045,85,153,238,610,238,238
2802,2011-05-01,Summer,2011,May,15,0,Sunday,0,Misty,0.5,0.4848,0.72,0.0,113,153,266,610,266,266
2803,2011-05-01,Summer,2011,May,16,0,Sunday,0,Misty,0.5,0.4848,0.72,0.194,75,139,214,610,214,214
2804,2011-05-01,Summer,2011,May,17,0,Sunday,0,Misty,0.48,0.4697,0.82,0.2537,60,136,196,610,196,196
2805,2011-05-01,Summer,2011,May,18,0,Sunday,0,Misty,0.46,0.4545,0.82,0.0896,33,126,159,610,159,159
2806,2011-05-01,Summer,2011,May,19,0,Sunday,0,Misty,0.46,0.4545,0.84,0.1045,47,131,178,610,178,178
2807,2011-05-01,Summer,2011,May,20,0,Sunday,0,Misty,0.46,0.4545,0.82,0.0,35,86,121,610,121,121
2808,2011-05-01,Summer,2011,May,21,0,Sunday,0,Misty,0.46,0.4545,0.82,0.0,23,82,105,610,105,105
2809,2011-05-01,Summer,2011,May,22,0,Sunday,0,Misty,0.46,0.4545,0.82,0.0,32,68,100,610,100,100
2810,2011-05-01,Summer,2011,May,23,0,Sunday,0,Clear,0.46,0.4545,0.77,0.194,64,82,146,610,146,146
2811,2011-05-02,Summer,2011,May,0,0,Monday,1,Clear,0.46,0.4545,0.72,0.1343,68,109,177,609,177,177
2812,2011-05-02,Summer,2011,May,1,0,Monday,1,Clear,0.46,0.4545,0.72,0.1343,41,73,114,609,114,114
2813,2011-05-02,Summer,2011,May,2,0,Monday,1,Misty,0.44,0.4394,0.77,0.2239,16,19,35,609,35,35
2814,2011-05-02,Summer,2011,May,3,0,Monday,1,Clear,0.44,0.4394,0.77,0.1343,9,7,16,609,16,16
2815,2011-05-02,Summer,2011,May,4,0,Monday,1,Clear,0.44,0.4394,0.77,0.1642,9,8,17,609,17,17
2816,2011-05-02,Summer,2011,May,5,0,Monday,1,Misty,0.44,0.4394,0.77,0.1343,4,16,20,609,20,20
2817,2011-05-02,Summer,2011,May,6,0,Monday,1,Clear,0.44,0.4394,0.88,0.1045,3,59,62,609,62,62
2818,2011-05-02,Summer,2011,May,7,0,Monday,1,Misty,0.46,0.4545,0.82,0.3284,16,193,209,609,209,209
2819,2011-05-02,Summer,2011,May,8,0,Monday,1,Misty,0.48,0.4697,0.77,0.2239,21,350,371,609,371,371
2820,2011-05-02,Summer,2011,May,9,0,Monday,1,Misty,0.5,0.4848,0.77,0.2836,41,131,172,609,172,172
2821,2011-05-02,Summer,2011,May,10,0,Monday,1,Misty,0.54,0.5152,0.77,0.2239,31,77,108,609,108,108
2822,2011-05-02,Summer,2011,May,11,0,Monday,1,Clear,0.58,0.5455,0.73,0.2985,34,96,130,609,130,130
2823,2011-05-02,Summer,2011,May,12,0,Monday,1,Clear,0.62,0.6061,0.69,0.2239,40,147,187,609,187,187
2824,2011-05-02,Summer,2011,May,13,0,Monday,1,Misty,0.62,0.6061,0.69,0.194,51,119,170,609,170,170
2825,2011-05-02,Summer,2011,May,14,0,Monday,1,Clear,0.64,0.6061,0.69,0.2239,48,133,181,609,181,181
2826,2011-05-02,Summer,2011,May,15,0,Monday,1,Clear,0.66,0.6212,0.61,0.194,45,110,155,609,155,155
2827,2011-05-02,Summer,2011,May,16,0,Monday,1,Clear,0.66,0.6212,0.61,0.2239,49,220,269,609,269,269
2828,2011-05-02,Summer,2011,May,17,0,Monday,1,Clear,0.66,0.6212,0.65,0.194,65,472,537,609,537,537
2829,2011-05-02,Summer,2011,May,18,0,Monday,1,Misty,0.64,0.6061,0.65,0.194,68,450,518,609,518,518
2830,2011-05-02,Summer,2011,May,19,0,Monday,1,Misty,0.62,0.6061,0.69,0.1343,46,268,314,609,314,314
2831,2011-05-02,Summer,2011,May,20,0,Monday,1,Misty,0.62,0.6061,0.69,0.1343,44,174,218,609,218,218
2832,2011-05-02,Summer,2011,May,21,0,Monday,1,Misty,0.6,0.5909,0.73,0.1045,54,178,232,609,232,232
2833,2011-05-02,Summer,2011,May,22,0,Monday,1,Misty,0.6,0.5909,0.73,0.0,28,97,125,609,125,125
2834,2011-05-02,Summer,2011,May,23,0,Monday,1,Misty,0.56,0.5303,0.83,0.194,16,48,64,609,64,64
2835,2011-05-03,Summer,2011,May,0,0,Tuesday,1,Misty,0.56,0.5303,0.83,0.2239,0,16,16,608,16,16
2836,2011-05-03,Summer,2011,May,1,0,Tuesday,1,Misty,0.56,0.5303,0.78,0.2537,0,14,14,608,14,14
2837,2011-05-03,Summer,2011,May,2,0,Tuesday,1,Misty,0.56,0.5303,0.78,0.2537,0,5,5,608,5,5
2838,2011-05-03,Summer,2011,May,3,0,Tuesday,1,Clear,0.54,0.5152,0.83,0.2836,0,2,2,608,2,2
2839,2011-05-03,Summer,2011,May,4,0,Tuesday,1,Clear,0.52,0.5,0.88,0.2239,3,1,4,608,4,4
2840,2011-05-03,Summer,2011,May,5,0,Tuesday,1,Clear,0.52,0.5,0.88,0.1343,0,14,14,608,14,14
2841,2011-05-03,Summer,2011,May,6,0,Tuesday,1,Misty,0.52,0.5,0.94,0.1642,7,102,109,608,109,109
2842,2011-05-03,Summer,2011,May,7,0,Tuesday,1,Misty,0.54,0.5152,0.88,0.2239,17,248,265,608,265,265
2843,2011-05-03,Summer,2011,May,8,0,Tuesday,1,Misty,0.56,0.5303,0.83,0.2836,24,435,459,608,459,459
2844,2011-05-03,Summer,2011,May,9,0,Tuesday,1,Misty,0.6,0.5758,0.78,0.3582,29,157,186,608,186,186
2845,2011-05-03,Summer,2011,May,10,0,Tuesday,1,Misty,0.64,0.6061,0.69,0.3582,36,91,127,608,127,127
2846,2011-05-03,Summer,2011,May,11,0,Tuesday,1,Misty,0.66,0.6212,0.65,0.3284,20,120,140,608,140,140
2847,2011-05-03,Summer,2011,May,12,0,Tuesday,1,Misty,0.68,0.6364,0.61,0.4925,48,169,217,608,217,217
2848,2011-05-03,Summer,2011,May,13,0,Tuesday,1,Misty,0.7,0.6515,0.58,0.6119,50,144,194,608,194,194
2849,2011-05-03,Summer,2011,May,14,0,Tuesday,1,Misty,0.7,0.6515,0.58,0.5224,36,122,158,608,158,158
2850,2011-05-03,Summer,2011,May,15,0,Tuesday,1,Misty,0.7,0.6515,0.58,0.4478,37,117,154,608,154,154
2851,2011-05-03,Summer,2011,May,16,0,Tuesday,1,Clear,0.72,0.6667,0.54,0.4627,46,225,271,608,271,271
2852,2011-05-03,Summer,2011,May,17,0,Tuesday,1,Clear,0.7,0.6515,0.54,0.4627,53,464,517,608,517,517
2853,2011-05-03,Summer,2011,May,18,0,Tuesday,1,Clear,0.7,0.6515,0.48,0.4179,59,485,544,608,544,544
2854,2011-05-03,Summer,2011,May,19,0,Tuesday,1,Clear,0.68,0.6364,0.57,0.3582,42,323,365,608,365,365
2855,2011-05-03,Summer,2011,May,20,0,Tuesday,1,Clear,0.66,0.6212,0.61,0.194,28,262,290,608,290,290
2856,2011-05-03,Summer,2011,May,21,0,Tuesday,1,Misty,0.64,0.6212,0.61,0.4478,42,183,225,608,225,225
2857,2011-05-03,Summer,2011,May,22,0,Tuesday,1,Misty,0.58,0.5455,0.6,0.3881,14,99,113,608,113,113
2858,2011-05-03,Summer,2011,May,23,0,Tuesday,1,Misty,0.56,0.5303,0.68,0.3284,12,50,62,608,62,62
2859,2011-05-04,Summer,2011,May,0,0,Wednesday,1,Light_rainsnow,0.52,0.5,0.77,0.1642,5,22,27,607,27,27
2860,2011-05-04,Summer,2011,May,1,0,Wednesday,1,Light_rainsnow,0.5,0.4848,0.82,0.2836,1,6,7,607,7,7
2861,2011-05-04,Summer,2011,May,2,0,Wednesday,1,Light_rainsnow,0.5,0.4848,0.82,0.2836,0,4,4,607,4,4
2862,2011-05-04,Summer,2011,May,3,0,Wednesday,1,Light_rainsnow,0.42,0.4242,0.88,0.5224,0,1,1,607,1,1
2863,2011-05-04,Summer,2011,May,4,0,Wednesday,1,Light_rainsnow,0.38,0.3939,0.94,0.3284,1,2,3,607,3,3
2864,2011-05-04,Summer,2011,May,5,0,Wednesday,1,Light_rainsnow,0.36,0.3333,0.87,0.3284,1,8,9,607,9,9
2865,2011-05-04,Summer,2011,May,6,0,Wednesday,1,Light_rainsnow,0.34,0.303,0.93,0.3881,0,21,21,607,21,21
2866,2011-05-04,Summer,2011,May,7,0,Wednesday,1,Light_rainsnow,0.34,0.303,0.93,0.3582,6,46,52,607,52,52
2867,2011-05-04,Summer,2011,May,8,0,Wednesday,1,Light_rainsnow,0.34,0.303,0.93,0.3881,5,74,79,607,79,79
2868,2011-05-04,Summer,2011,May,9,0,Wednesday,1,Light_rainsnow,0.34,0.303,0.93,0.3582,5,35,40,607,40,40
2869,2011-05-04,Summer,2011,May,10,0,Wednesday,1,Misty,0.34,0.3182,0.93,0.2836,5,26,31,607,31,31
2870,2011-05-04,Summer,2011,May,11,0,Wednesday,1,Clear,0.4,0.4091,0.82,0.3284,3,69,72,607,72,72
2871,2011-05-04,Summer,2011,May,12,0,Wednesday,1,Misty,0.44,0.4394,0.62,0.3582,19,105,124,607,124,124
2872,2011-05-04,Summer,2011,May,13,0,Wednesday,1,Misty,0.46,0.4545,0.59,0.4478,15,128,143,607,143,143
2873,2011-05-04,Summer,2011,May,14,0,Wednesday,1,Clear,0.5,0.4848,0.51,0.3881,13,94,107,607,107,107
2874,2011-05-04,Summer,2011,May,15,0,Wednesday,1,Clear,0.48,0.4697,0.51,0.4179,22,107,129,607,129,129
2875,2011-05-04,Summer,2011,May,16,0,Wednesday,1,Clear,0.5,0.4848,0.45,0.4627,22,173,195,607,195,195
2876,2011-05-04,Summer,2011,May,17,0,Wednesday,1,Clear,0.4,0.4091,0.71,0.2537,22,388,410,607,410,410
2877,2011-05-04,Summer,2011,May,18,0,Wednesday,1,Clear,0.42,0.4242,0.67,0.2537,29,367,396,607,396,396
2878,2011-05-04,Summer,2011,May,19,0,Wednesday,1,Clear,0.42,0.4242,0.58,0.3582,30,266,296,607,296,296
2879,2011-05-04,Summer,2011,May,20,0,Wednesday,1,Clear,0.4,0.4091,0.62,0.3284,17,174,191,607,191,191
2880,2011-05-04,Summer,2011,May,21,0,Wednesday,1,Clear,0.4,0.4091,0.62,0.1642,17,133,150,607,150,150
2881,2011-05-04,Summer,2011,May,22,0,Wednesday,1,Clear,0.38,0.3939,0.62,0.2239,9,80,89,607,89,89
2882,2011-05-04,Summer,2011,May,23,0,Wednesday,1,Clear,0.36,0.3485,0.62,0.2239,8,49,57,607,57,57
2883,2011-05-05,Summer,2011,May,0,0,Thursday,1,Clear,0.36,0.3485,0.66,0.194,4,23,27,606,27,27
2884,2011-05-05,Summer,2011,May,1,0,Thursday,1,Clear,0.34,0.3333,0.71,0.194,4,6,10,606,10,10
2885,2011-05-05,Summer,2011,May,2,0,Thursday,1,Clear,0.34,0.3182,0.66,0.2239,1,4,5,606,5,5
2886,2011-05-05,Summer,2011,May,3,0,Thursday,1,Clear,0.34,0.3182,0.66,0.2537,0,4,4,606,4,4
2887,2011-05-05,Summer,2011,May,4,0,Thursday,1,Clear,0.34,0.3182,0.66,0.2537,4,3,7,606,7,7
2888,2011-05-05,Summer,2011,May,5,0,Thursday,1,Clear,0.34,0.3182,0.66,0.2537,1,29,30,606,30,30
2889,2011-05-05,Summer,2011,May,6,0,Thursday,1,Clear,0.34,0.3182,0.66,0.2537,3,86,89,606,89,89
2890,2011-05-05,Summer,2011,May,7,0,Thursday,1,Clear,0.38,0.3939,0.58,0.2537,16,255,271,606,271,271
2891,2011-05-05,Summer,2011,May,8,0,Thursday,1,Clear,0.42,0.4242,0.5,0.2537,25,415,440,606,440,440
2892,2011-05-05,Summer,2011,May,9,0,Thursday,1,Clear,0.46,0.4545,0.44,0.2836,20,164,184,606,184,184
2893,2011-05-05,Summer,2011,May,10,0,Thursday,1,Clear,0.5,0.4848,0.39,0.2836,30,98,128,606,128,128
2894,2011-05-05,Summer,2011,May,11,0,Thursday,1,Clear,0.52,0.5,0.36,0.4478,43,105,148,606,148,148
2895,2011-05-05,Summer,2011,May,12,0,Thursday,1,Clear,0.52,0.5,0.34,0.3582,27,169,196,606,196,196
2896,2011-05-05,Summer,2011,May,13,0,Thursday,1,Clear,0.54,0.5152,0.3,0.5821,50,142,192,606,192,192
2897,2011-05-05,Summer,2011,May,14,0,Thursday,1,Clear,0.54,0.5152,0.28,0.4478,19,135,154,606,154,154
2898,2011-05-05,Summer,2011,May,15,0,Thursday,1,Clear,0.56,0.5303,0.26,0.4925,27,120,147,606,147,147
2899,2011-05-05,Summer,2011,May,16,0,Thursday,1,Clear,0.58,0.5455,0.24,0.4179,36,233,269,606,269,269
2900,2011-05-05,Summer,2011,May,17,0,Thursday,1,Clear,0.56,0.5303,0.26,0.3881,66,467,533,606,533,533
2901,2011-05-05,Summer,2011,May,18,0,Thursday,1,Clear,0.56,0.5303,0.26,0.2836,64,456,520,606,520,520
2902,2011-05-05,Summer,2011,May,19,0,Thursday,1,Clear,0.54,0.5152,0.28,0.2239,56,305,361,606,361,361
2903,2011-05-05,Summer,2011,May,20,0,Thursday,1,Clear,0.5,0.4848,0.34,0.1642,33,225,258,606,258,258
2904,2011-05-05,Summer,2011,May,21,0,Thursday,1,Clear,0.5,0.4848,0.36,0.194,39,141,180,606,180,180
2905,2011-05-05,Summer,2011,May,22,0,Thursday,1,Clear,0.48,0.4697,0.39,0.194,30,135,165,606,165,165
2906,2011-05-05,Summer,2011,May,23,0,Thursday,1,Clear,0.46,0.4545,0.41,0.194,16,99,115,606,115,115
2907,2011-05-06,Summer,2011,May,0,0,Friday,1,Clear,0.44,0.4394,0.44,0.1642,13,43,56,605,56,56
2908,2011-05-06,Summer,2011,May,1,0,Friday,1,Clear,0.4,0.4091,0.62,0.1642,8,24,32,605,32,32
2909,2011-05-06,Summer,2011,May,2,0,Friday,1,Clear,0.38,0.3939,0.62,0.1045,1,15,16,605,16,16
2910,2011-05-06,Summer,2011,May,3,0,Friday,1,Clear,0.36,0.3636,0.71,0.1045,3,6,9,605,9,9
2911,2011-05-06,Summer,2011,May,4,0,Friday,1,Clear,0.36,0.3636,0.71,0.1045,0,1,1,605,1,1
2912,2011-05-06,Summer,2011,May,5,0,Friday,1,Clear,0.34,0.3485,0.81,0.1045,0,16,16,605,16,16
2913,2011-05-06,Summer,2011,May,6,0,Friday,1,Clear,0.36,0.3636,0.81,0.0896,8,74,82,605,82,82
2914,2011-05-06,Summer,2011,May,7,0,Friday,1,Clear,0.4,0.4091,0.82,0.0,20,202,222,605,222,222
2915,2011-05-06,Summer,2011,May,8,0,Friday,1,Clear,0.42,0.4242,0.77,0.2537,35,415,450,605,450,450
2916,2011-05-06,Summer,2011,May,9,0,Friday,1,Clear,0.46,0.4545,0.67,0.2836,27,161,188,605,188,188
2917,2011-05-06,Summer,2011,May,10,0,Friday,1,Misty,0.54,0.5152,0.49,0.3284,30,97,127,605,127,127
2918,2011-05-06,Summer,2011,May,11,0,Friday,1,Misty,0.54,0.5152,0.49,0.3284,42,123,165,605,165,165
2919,2011-05-06,Summer,2011,May,12,0,Friday,1,Clear,0.56,0.5303,0.49,0.3582,48,198,246,605,246,246
2920,2011-05-06,Summer,2011,May,13,0,Friday,1,Clear,0.58,0.5455,0.4,0.3284,71,182,253,605,253,253
2921,2011-05-06,Summer,2011,May,14,0,Friday,1,Clear,0.6,0.6212,0.4,0.4478,86,127,213,605,213,213
2922,2011-05-06,Summer,2011,May,15,0,Friday,1,Clear,0.6,0.6212,0.38,0.3881,89,171,260,605,260,260
2923,2011-05-06,Summer,2011,May,16,0,Friday,1,Clear,0.6,0.6212,0.4,0.2537,82,262,344,605,344,344
2924,2011-05-06,Summer,2011,May,17,0,Friday,1,Clear,0.58,0.5455,0.4,0.3582,83,470,553,605,553,553
2925,2011-05-06,Summer,2011,May,18,0,Friday,1,Light_rainsnow,0.54,0.5152,0.52,0.3582,85,385,470,605,470,470
2926,2011-05-06,Summer,2011,May,19,0,Friday,1,Light_rainsnow,0.54,0.5152,0.52,0.3582,39,253,292,605,292,292
2927,2011-05-06,Summer,2011,May,20,0,Friday,1,Clear,0.52,0.5,0.48,0.1045,29,161,190,605,190,190
2928,2011-05-06,Summer,2011,May,21,0,Friday,1,Clear,0.48,0.4697,0.67,0.1343,22,130,152,605,152,152
2929,2011-05-06,Summer,2011,May,22,0,Friday,1,Clear,0.46,0.4545,0.72,0.2239,46,105,151,605,151,151
2930,2011-05-06,Summer,2011,May,23,0,Friday,1,Clear,0.44,0.4394,0.82,0.1343,27,93,120,605,120,120
2931,2011-05-07,Summer,2011,May,0,0,Saturday,0,Clear,0.42,0.4242,0.82,0.1343,10,76,86,604,86,86
2932,2011-05-07,Summer,2011,May,1,0,Saturday,0,Clear,0.42,0.4242,0.82,0.1045,8,50,58,604,58,58
2933,2011-05-07,Summer,2011,May,2,0,Saturday,0,Clear,0.42,0.4242,0.82,0.0896,5,47,52,604,52,52
2934,2011-05-07,Summer,2011,May,3,0,Saturday,0,Clear,0.42,0.4242,0.77,0.0896,9,9,18,604,18,18
2935,2011-05-07,Summer,2011,May,4,0,Saturday,0,Clear,0.4,0.4091,0.82,0.1045,1,4,5,604,5,5
2936,2011-05-07,Summer,2011,May,5,0,Saturday,0,Clear,0.46,0.4545,0.59,0.1343,4,3,7,604,7,7
2937,2011-05-07,Summer,2011,May,6,0,Saturday,0,Clear,0.42,0.4242,0.77,0.0896,1,12,13,604,13,13
2938,2011-05-07,Summer,2011,May,7,0,Saturday,0,Clear,0.48,0.4697,0.59,0.0,8,32,40,604,40,40
2939,2011-05-07,Summer,2011,May,8,0,Saturday,0,Clear,0.52,0.5,0.52,0.194,19,96,115,604,115,115
2940,2011-05-07,Summer,2011,May,9,0,Saturday,0,Clear,0.54,0.5152,0.49,0.2836,54,164,218,604,218,218
2941,2011-05-07,Summer,2011,May,10,0,Saturday,0,Clear,0.56,0.5303,0.49,0.2985,90,208,298,604,298,298
2942,2011-05-07,Summer,2011,May,11,0,Saturday,0,Clear,0.56,0.5303,0.43,0.0,132,215,347,604,347,347
2943,2011-05-07,Summer,2011,May,12,0,Saturday,0,Clear,0.6,0.6212,0.4,0.194,129,244,373,604,373,373
2944,2011-05-07,Summer,2011,May,13,0,Saturday,0,Clear,0.6,0.6212,0.35,0.2836,196,240,436,604,436,436
2945,2011-05-07,Summer,2011,May,14,0,Saturday,0,Light_rainsnow,0.6,0.6212,0.35,0.1642,143,235,378,604,378,378
2946,2011-05-07,Summer,2011,May,15,0,Saturday,0,Clear,0.6,0.6212,0.38,0.2537,148,230,378,604,378,378
2947,2011-05-07,Summer,2011,May,16,0,Saturday,0,Clear,0.6,0.6212,0.38,0.194,119,223,342,604,342,342
2948,2011-05-07,Summer,2011,May,17,0,Saturday,0,Clear,0.58,0.5455,0.4,0.2239,138,216,354,604,354,354
2949,2011-05-07,Summer,2011,May,18,0,Saturday,0,Clear,0.58,0.5455,0.37,0.1642,114,175,289,604,289,289
2950,2011-05-07,Summer,2011,May,19,0,Saturday,0,Clear,0.56,0.5303,0.43,0.194,88,179,267,604,267,267
2951,2011-05-07,Summer,2011,May,20,0,Saturday,0,Clear,0.56,0.5303,0.43,0.1343,82,137,219,604,219,219
2952,2011-05-07,Summer,2011,May,21,0,Saturday,0,Clear,0.54,0.5152,0.49,0.2239,58,124,182,604,182,182
2953,2011-05-07,Summer,2011,May,22,0,Saturday,0,Clear,0.54,0.5152,0.49,0.194,26,94,120,604,120,120
2954,2011-05-07,Summer,2011,May,23,0,Saturday,0,Clear,0.5,0.4848,0.59,0.1045,30,89,119,604,119,119
2955,2011-05-08,Summer,2011,May,0,0,Sunday,0,Misty,0.5,0.4848,0.59,0.1045,22,78,100,603,100,100
2956,2011-05-08,Summer,2011,May,1,0,Sunday,0,Misty,0.52,0.5,0.55,0.0,8,56,64,603,64,64
2957,2011-05-08,Summer,2011,May,2,0,Sunday,0,Clear,0.48,0.4697,0.63,0.0,17,42,59,603,59,59
2958,2011-05-08,Summer,2011,May,3,0,Sunday,0,Clear,0.46,0.4545,0.72,0.0896,10,21,31,603,31,31
2959,2011-05-08,Summer,2011,May,4,0,Sunday,0,Clear,0.42,0.4242,0.82,0.0,2,8,10,603,10,10
2960,2011-05-08,Summer,2011,May,5,0,Sunday,0,Misty,0.44,0.4394,0.77,0.0,0,5,5,603,5,5
2961,2011-05-08,Summer,2011,May,6,0,Sunday,0,Misty,0.44,0.4394,0.82,0.0,2,4,6,603,6,6
2962,2011-05-08,Summer,2011,May,7,0,Sunday,0,Misty,0.46,0.4545,0.82,0.0,8,15,23,603,23,23
2963,2011-05-08,Summer,2011,May,8,0,Sunday,0,Clear,0.52,0.5,0.63,0.1343,28,58,86,603,86,86
2964,2011-05-08,Summer,2011,May,9,0,Sunday,0,Clear,0.56,0.5303,0.52,0.2239,48,112,160,603,160,160
2965,2011-05-08,Summer,2011,May,10,0,Sunday,0,Clear,0.58,0.5455,0.49,0.1343,91,153,244,603,244,244
2966,2011-05-08,Summer,2011,May,11,0,Sunday,0,Clear,0.58,0.5455,0.49,0.0896,142,198,340,603,340,340
2967,2011-05-08,Summer,2011,May,12,0,Sunday,0,Clear,0.6,0.6212,0.46,0.0896,139,243,382,603,382,382
2968,2011-05-08,Summer,2011,May,13,0,Sunday,0,Clear,0.6,0.6212,0.49,0.1343,166,224,390,603,390,390
2969,2011-05-08,Summer,2011,May,14,0,Sunday,0,Clear,0.6,0.6212,0.49,0.0,126,240,366,603,366,366
2970,2011-05-08,Summer,2011,May,15,0,Sunday,0,Clear,0.6,0.6212,0.49,0.0,128,230,358,603,358,358
2971,2011-05-08,Summer,2011,May,16,0,Sunday,0,Clear,0.6,0.6212,0.46,0.1045,122,263,385,603,385,385
2972,2011-05-08,Summer,2011,May,17,0,Sunday,0,Light_rainsnow,0.58,0.5455,0.49,0.2836,106,245,351,603,351,351
2973,2011-05-08,Summer,2011,May,18,0,Sunday,0,Clear,0.58,0.5455,0.49,0.0,63,205,268,603,268,268
2974,2011-05-08,Summer,2011,May,19,0,Sunday,0,Clear,0.56,0.5303,0.64,0.0,61,178,239,603,239,239
2975,2011-05-08,Summer,2011,May,20,0,Sunday,0,Clear,0.52,0.5,0.77,0.1343,42,132,174,603,174,174
2976,2011-05-08,Summer,2011,May,21,0,Sunday,0,Clear,0.52,0.5,0.77,0.0896,32,95,127,603,127,127
2977,2011-05-08,Summer,2011,May,22,0,Sunday,0,Clear,0.5,0.4848,0.88,0.0896,29,86,115,603,115,115
2978,2011-05-08,Summer,2011,May,23,0,Sunday,0,Clear,0.46,0.4545,0.88,0.0896,9,41,50,603,50,50
2979,2011-05-09,Summer,2011,May,0,0,Monday,1,Clear,0.46,0.4545,0.82,0.0896,31,22,53,602,53,53
2980,2011-05-09,Summer,2011,May,1,0,Monday,1,Clear,0.44,0.4394,0.88,0.0,25,8,33,602,33,33
2981,2011-05-09,Summer,2011,May,2,0,Monday,1,Clear,0.44,0.4394,0.94,0.0,6,2,8,602,8,8
2982,2011-05-09,Summer,2011,May,3,0,Monday,1,Clear,0.46,0.4545,0.82,0.0896,0,7,7,602,7,7
2983,2011-05-09,Summer,2011,May,4,0,Monday,1,Clear,0.42,0.4242,0.82,0.1642,0,4,4,602,4,4
2984,2011-05-09,Summer,2011,May,5,0,Monday,1,Clear,0.42,0.4242,0.77,0.1642,0,23,23,602,23,23
2985,2011-05-09,Summer,2011,May,6,0,Monday,1,Clear,0.44,0.4394,0.72,0.2537,2,87,89,602,89,89
2986,2011-05-09,Summer,2011,May,7,0,Monday,1,Clear,0.48,0.4697,0.63,0.2537,16,221,237,602,237,237
2987,2011-05-09,Summer,2011,May,8,0,Monday,1,Clear,0.52,0.5,0.55,0.2239,23,351,374,602,374,374
2988,2011-05-09,Summer,2011,May,9,0,Monday,1,Clear,0.54,0.5152,0.56,0.1642,36,142,178,602,178,178
2989,2011-05-09,Summer,2011,May,10,0,Monday,1,Clear,0.56,0.5303,0.52,0.194,24,95,119,602,119,119
2990,2011-05-09,Summer,2011,May,11,0,Monday,1,Clear,0.6,0.6212,0.46,0.2239,26,99,125,602,125,125
2991,2011-05-09,Summer,2011,May,12,0,Monday,1,Clear,0.6,0.6212,0.43,0.194,35,160,195,602,195,195
2992,2011-05-09,Summer,2011,May,13,0,Monday,1,Clear,0.62,0.6212,0.38,0.2836,36,138,174,602,174,174
2993,2011-05-09,Summer,2011,May,14,0,Monday,1,Clear,0.62,0.6212,0.41,0.2239,44,118,162,602,162,162
2994,2011-05-09,Summer,2011,May,15,0,Monday,1,Clear,0.62,0.6212,0.41,0.2239,51,148,199,602,199,199
2995,2011-05-09,Summer,2011,May,16,0,Monday,1,Clear,0.64,0.6212,0.38,0.2239,49,255,304,602,304,304
2996,2011-05-09,Summer,2011,May,17,0,Monday,1,Clear,0.62,0.6212,0.38,0.2537,59,539,598,602,598,598
2997,2011-05-09,Summer,2011,May,18,0,Monday,1,Clear,0.62,0.6212,0.38,0.2985,66,458,524,602,524,524
2998,2011-05-09,Summer,2011,May,19,0,Monday,1,Clear,0.58,0.5455,0.43,0.194,45,339,384,602,384,384
2999,2011-05-09,Summer,2011,May,20,0,Monday,1,Clear,0.54,0.5152,0.49,0.194,25,214,239,602,239,239
3000,2011-05-09,Summer,2011,May,21,0,Monday,1,Clear,0.52,0.5,0.59,0.1343,28,128,156,602,156,156
3001,2011-05-09,Summer,2011,May,22,0,Monday,1,Clear,0.52,0.5,0.68,0.0896,21,95,116,602,116,116
3002,2011-05-09,Summer,2011,May,23,0,Monday,1,Clear,0.5,0.4848,0.68,0.0896,16,45,61,602,61,61
3003,2011-05-10,Summer,2011,May,0,0,Tuesday,1,Clear,0.48,0.4697,0.63,0.0,6,12,18,601,18,18
3004,2011-05-10,Summer,2011,May,1,0,Tuesday,1,Clear,0.46,0.4545,0.59,0.0896,3,12,15,601,15,15
3005,2011-05-10,Summer,2011,May,2,0,Tuesday,1,Clear,0.44,0.4394,0.58,0.1343,1,4,5,601,5,5
3006,2011-05-10,Summer,2011,May,3,0,Tuesday,1,Clear,0.44,0.4394,0.54,0.194,1,3,4,601,4,4
3007,2011-05-10,Summer,2011,May,4,0,Tuesday,1,Clear,0.42,0.4242,0.62,0.2537,0,2,2,601,2,2
3008,2011-05-10,Summer,2011,May,5,0,Tuesday,1,Clear,0.4,0.4091,0.66,0.2239,1,28,29,601,29,29
3009,2011-05-10,Summer,2011,May,6,0,Tuesday,1,Clear,0.42,0.4242,0.67,0.1343,9,103,112,601,112,112
3010,2011-05-10,Summer,2011,May,7,0,Tuesday,1,Misty,0.44,0.4394,0.62,0.1343,13,301,314,601,314,314
3011,2011-05-10,Summer,2011,May,8,0,Tuesday,1,Misty,0.5,0.4848,0.51,0.1045,28,397,425,601,425,425
3012,2011-05-10,Summer,2011,May,9,0,Tuesday,1,Misty,0.52,0.5,0.48,0.1045,29,176,205,601,205,205
3013,2011-05-10,Summer,2011,May,10,0,Tuesday,1,Misty,0.56,0.5303,0.37,0.0896,27,100,127,601,127,127
3014,2011-05-10,Summer,2011,May,11,0,Tuesday,1,Misty,0.56,0.5303,0.43,0.1343,17,108,125,601,125,125
3015,2011-05-10,Summer,2011,May,12,0,Tuesday,1,Misty,0.6,0.6212,0.38,0.0,47,170,217,601,217,217
3016,2011-05-10,Summer,2011,May,13,0,Tuesday,1,Misty,0.62,0.6212,0.38,0.2537,50,152,202,601,202,202
3017,2011-05-10,Summer,2011,May,14,0,Tuesday,1,Misty,0.62,0.6212,0.33,0.0,42,134,176,601,176,176
3018,2011-05-10,Summer,2011,May,15,0,Tuesday,1,Misty,0.64,0.6212,0.33,0.0896,28,152,180,601,180,180
3019,2011-05-10,Summer,2011,May,16,0,Tuesday,1,Clear,0.66,0.6212,0.31,0.1045,56,271,327,601,327,327
3020,2011-05-10,Summer,2011,May,17,0,Tuesday,1,Clear,0.64,0.6212,0.33,0.0,79,532,611,601,611,611
3021,2011-05-10,Summer,2011,May,18,0,Tuesday,1,Clear,0.64,0.6212,0.29,0.1343,70,480,550,601,550,550
3022,2011-05-10,Summer,2011,May,19,0,Tuesday,1,Clear,0.6,0.6212,0.43,0.2239,69,365,434,601,434,434
3023,2011-05-10,Summer,2011,May,20,0,Tuesday,1,Clear,0.54,0.5152,0.6,0.1343,50,241,291,601,291,291
3024,2011-05-10,Summer,2011,May,21,0,Tuesday,1,Clear,0.54,0.5152,0.52,0.0,30,173,203,601,203,203
3025,2011-05-10,Summer,2011,May,22,0,Tuesday,1,Clear,0.52,0.5,0.55,0.1045,29,121,150,601,150,150
3026,2011-05-10,Summer,2011,May,23,0,Tuesday,1,Misty,0.52,0.5,0.59,0.1343,9,72,81,601,81,81
3027,2011-05-11,Summer,2011,May,0,0,Wednesday,1,Misty,0.52,0.5,0.55,0.1343,8,30,38,600,38,38
3028,2011-05-11,Summer,2011,May,1,0,Wednesday,1,Misty,0.5,0.4848,0.59,0.1045,4,16,20,600,20,20
3029,2011-05-11,Summer,2011,May,2,0,Wednesday,1,Clear,0.52,0.5,0.59,0.0,6,4,10,600,10,10
3030,2011-05-11,Summer,2011,May,3,0,Wednesday,1,Clear,0.5,0.4848,0.63,0.2239,0,3,3,600,3,3
3031,2011-05-11,Summer,2011,May,4,0,Wednesday,1,Misty,0.48,0.4697,0.88,0.1343,0,2,2,600,2,2
3032,2011-05-11,Summer,2011,May,5,0,Wednesday,1,Clear,0.46,0.4545,0.88,0.1343,0,20,20,600,20,20
3033,2011-05-11,Summer,2011,May,6,0,Wednesday,1,Clear,0.46,0.4545,0.82,0.1343,6,93,99,600,99,99
3034,2011-05-11,Summer,2011,May,7,0,Wednesday,1,Clear,0.48,0.4697,0.72,0.194,25,293,318,600,318,318
3035,2011-05-11,Summer,2011,May,8,0,Wednesday,1,Clear,0.48,0.4697,0.77,0.2537,21,421,442,600,442,442
3036,2011-05-11,Summer,2011,May,9,0,Wednesday,1,Clear,0.52,0.5,0.72,0.1343,21,182,203,600,203,203
3037,2011-05-11,Summer,2011,May,10,0,Wednesday,1,Clear,0.54,0.5152,0.68,0.0896,30,124,154,600,154,154
3038,2011-05-11,Summer,2011,May,11,0,Wednesday,1,Clear,0.56,0.5303,0.64,0.0896,18,123,141,600,141,141
3039,2011-05-11,Summer,2011,May,12,0,Wednesday,1,Clear,0.6,0.6212,0.56,0.0,41,185,226,600,226,226
3040,2011-05-11,Summer,2011,May,13,0,Wednesday,1,Clear,0.62,0.6212,0.5,0.0,36,157,193,600,193,193
3041,2011-05-11,Summer,2011,May,14,0,Wednesday,1,Clear,0.62,0.6212,0.53,0.0896,36,141,177,600,177,177
3042,2011-05-11,Summer,2011,May,15,0,Wednesday,1,Clear,0.64,0.6212,0.41,0.0,48,131,179,600,179,179
3043,2011-05-11,Summer,2011,May,16,0,Wednesday,1,Clear,0.66,0.6212,0.39,0.0,49,240,289,600,289,289
3044,2011-05-11,Summer,2011,May,17,0,Wednesday,1,Clear,0.64,0.6212,0.47,0.1045,17,242,259,600,259,259
3045,2011-05-11,Summer,2011,May,18,0,Wednesday,1,Clear,0.62,0.6212,0.5,0.2985,40,234,274,600,274,274
3046,2011-05-11,Summer,2011,May,19,0,Wednesday,1,Clear,0.56,0.5303,0.52,0.1343,60,341,401,600,401,401
3047,2011-05-11,Summer,2011,May,20,0,Wednesday,1,Clear,0.54,0.5152,0.64,0.1343,28,245,273,600,273,273
3048,2011-05-11,Summer,2011,May,21,0,Wednesday,1,Clear,0.54,0.5152,0.6,0.0,32,202,234,600,234,234
3049,2011-05-11,Summer,2011,May,22,0,Wednesday,1,Clear,0.5,0.4848,0.72,0.2537,12,134,146,600,146,146
3050,2011-05-11,Summer,2011,May,23,0,Wednesday,1,Clear,0.46,0.4545,0.88,0.2537,12,69,81,600,81,81
3051,2011-05-12,Summer,2011,May,0,0,Thursday,1,Misty,0.46,0.4545,0.88,0.2239,5,39,44,599,44,44
3052,2011-05-12,Summer,2011,May,1,0,Thursday,1,Clear,0.46,0.4545,0.88,0.2239,1,16,17,599,17,17
3053,2011-05-12,Summer,2011,May,2,0,Thursday,1,Clear,0.44,0.4394,0.94,0.194,1,14,15,599,15,15
3054,2011-05-12,Summer,2011,May,3,0,Thursday,1,Clear,0.44,0.4394,0.88,0.1343,0,5,5,599,5,5
3055,2011-05-12,Summer,2011,May,4,0,Thursday,1,Clear,0.42,0.4242,0.94,0.0,1,5,6,599,6,6
3056,2011-05-12,Summer,2011,May,5,0,Thursday,1,Clear,0.42,0.4242,0.94,0.1343,2,27,29,599,29,29
3057,2011-05-12,Summer,2011,May,6,0,Thursday,1,Clear,0.44,0.4394,0.88,0.0,9,103,112,599,112,112
3058,2011-05-12,Summer,2011,May,7,0,Thursday,1,Clear,0.46,0.4545,0.88,0.1343,14,283,297,599,297,297
3059,2011-05-12,Summer,2011,May,8,0,Thursday,1,Clear,0.48,0.4697,0.82,0.194,27,394,421,599,421,421
3060,2011-05-12,Summer,2011,May,9,0,Thursday,1,Misty,0.5,0.4848,0.77,0.2836,21,191,212,599,212,212
3061,2011-05-12,Summer,2011,May,10,0,Thursday,1,Misty,0.54,0.5152,0.68,0.2239,28,119,147,599,147,147
3062,2011-05-12,Summer,2011,May,11,0,Thursday,1,Clear,0.58,0.5455,0.6,0.2239,43,136,179,599,179,179
3063,2011-05-12,Summer,2011,May,12,0,Thursday,1,Clear,0.58,0.5455,0.6,0.2239,43,164,207,599,207,207
3064,2011-05-12,Summer,2011,May,13,0,Thursday,1,Misty,0.62,0.6212,0.57,0.2985,48,170,218,599,218,218
3065,2011-05-12,Summer,2011,May,14,0,Thursday,1,Misty,0.62,0.6061,0.61,0.2239,43,148,191,599,191,191
3066,2011-05-12,Summer,2011,May,15,0,Thursday,1,Misty,0.64,0.6212,0.53,0.2537,54,163,217,599,217,217
3067,2011-05-12,Summer,2011,May,16,0,Thursday,1,Misty,0.64,0.6212,0.57,0.2537,50,238,288,599,288,288
3068,2011-05-12,Summer,2011,May,17,0,Thursday,1,Misty,0.64,0.6212,0.57,0.194,54,540,594,599,594,594
3069,2011-05-12,Summer,2011,May,18,0,Thursday,1,Clear,0.62,0.6061,0.69,0.2239,64,463,527,599,527,527
3070,2011-05-12,Summer,2011,May,19,0,Thursday,1,Misty,0.6,0.6061,0.64,0.194,59,305,364,599,364,364
3071,2011-05-12,Summer,2011,May,20,0,Thursday,1,Clear,0.6,0.6061,0.64,0.194,56,220,276,599,276,276
3072,2011-05-12,Summer,2011,May,21,0,Thursday,1,Clear,0.56,0.5303,0.83,0.1343,31,192,223,599,223,223
3073,2011-05-12,Summer,2011,May,22,0,Thursday,1,Clear,0.54,0.5152,0.83,0.194,25,147,172,599,172,172
3074,2011-05-12,Summer,2011,May,23,0,Thursday,1,Misty,0.54,0.5152,0.77,0.194,16,87,103,599,103,103
3075,2011-05-13,Summer,2011,May,0,0,Friday,1,Misty,0.52,0.5,0.83,0.1642,6,46,52,598,52,52
3076,2011-05-13,Summer,2011,May,1,0,Friday,1,Clear,0.52,0.5,0.83,0.1642,5,15,20,598,20,20
3077,2011-05-13,Summer,2011,May,2,0,Friday,1,Misty,0.5,0.4848,0.88,0.1343,3,8,11,598,11,11
3078,2011-05-13,Summer,2011,May,3,0,Friday,1,Misty,0.5,0.4848,0.88,0.1343,2,2,4,598,4,4
3079,2011-05-13,Summer,2011,May,4,0,Friday,1,Light_rainsnow,0.5,0.4848,0.88,0.1642,2,3,5,598,5,5
3080,2011-05-13,Summer,2011,May,5,0,Friday,1,Misty,0.5,0.4848,0.88,0.194,1,24,25,598,25,25
3081,2011-05-13,Summer,2011,May,6,0,Friday,1,Light_rainsnow,0.5,0.4848,0.88,0.1343,6,76,82,598,82,82
3082,2011-05-13,Summer,2011,May,7,0,Friday,1,Light_rainsnow,0.5,0.4848,0.88,0.1642,16,141,157,598,157,157
3083,2011-05-13,Summer,2011,May,8,0,Friday,1,Misty,0.5,0.4848,0.88,0.194,26,361,387,598,387,387
3084,2011-05-13,Summer,2011,May,9,0,Friday,1,Misty,0.5,0.4848,0.88,0.194,18,215,233,598,233,233
3085,2011-05-13,Summer,2011,May,10,0,Friday,1,Misty,0.52,0.5,0.83,0.1343,31,99,130,598,130,130
3086,2011-05-13,Summer,2011,May,11,0,Friday,1,Misty,0.52,0.5,0.83,0.1642,56,90,146,598,146,146
3087,2011-05-13,Summer,2011,May,12,0,Friday,1,Misty,0.52,0.5,0.88,0.194,53,170,223,598,223,223
3088,2011-05-13,Summer,2011,May,13,0,Friday,1,Misty,0.52,0.5,0.88,0.3881,69,157,226,598,226,226
3089,2011-05-13,Summer,2011,May,14,0,Friday,1,Misty,0.52,0.5,0.87,0.2836,70,120,190,598,190,190
3090,2011-05-13,Summer,2011,May,15,0,Friday,1,Misty,0.52,0.5,0.88,0.1642,56,142,198,598,198,198
3091,2011-05-13,Summer,2011,May,16,0,Friday,1,Misty,0.52,0.5,0.88,0.1343,44,256,300,598,300,300
3092,2011-05-13,Summer,2011,May,17,0,Friday,1,Light_rainsnow,0.52,0.5,0.88,0.1642,62,429,491,598,491,491
3093,2011-05-13,Summer,2011,May,18,0,Friday,1,Light_rainsnow,0.52,0.5,0.88,0.1642,39,359,398,598,398,398
3094,2011-05-13,Summer,2011,May,19,0,Friday,1,Misty,0.52,0.5,0.83,0.194,25,245,270,598,270,270
3095,2011-05-13,Summer,2011,May,20,0,Friday,1,Misty,0.52,0.5,0.83,0.1343,22,130,152,598,152,152
3096,2011-05-13,Summer,2011,May,21,0,Friday,1,Misty,0.52,0.5,0.84,0.1642,24,130,154,598,154,154
3097,2011-05-13,Summer,2011,May,22,0,Friday,1,Misty,0.52,0.5,0.83,0.2239,25,107,132,598,132,132
3098,2011-05-13,Summer,2011,May,23,0,Friday,1,Light_rainsnow,0.5,0.4848,0.88,0.1642,31,88,119,598,119,119
3099,2011-05-14,Summer,2011,May,0,0,Saturday,0,Misty,0.5,0.4848,0.88,0.1343,24,78,102,597,102,102
3100,2011-05-14,Summer,2011,May,1,0,Saturday,0,Misty,0.5,0.4848,0.88,0.1343,18,64,82,597,82,82
3101,2011-05-14,Summer,2011,May,2,0,Saturday,0,Misty,0.5,0.4848,0.88,0.1343,15,37,52,597,52,52
3102,2011-05-14,Summer,2011,May,3,0,Saturday,0,Misty,0.5,0.4848,0.88,0.1343,5,30,35,597,35,35
3103,2011-05-14,Summer,2011,May,4,0,Saturday,0,Misty,0.5,0.4848,0.82,0.1642,1,4,5,597,5,5
3104,2011-05-14,Summer,2011,May,5,0,Saturday,0,Misty,0.5,0.4848,0.82,0.1045,7,7,14,597,14,14
3105,2011-05-14,Summer,2011,May,6,0,Saturday,0,Misty,0.5,0.4848,0.88,0.1045,2,9,11,597,11,11
3106,2011-05-14,Summer,2011,May,7,0,Saturday,0,Light_rainsnow,0.48,0.4697,1.0,0.0,4,28,32,597,32,32
3107,2011-05-14,Summer,2011,May,8,0,Saturday,0,Light_rainsnow,0.5,0.4848,0.94,0.0,16,72,88,597,88,88
3108,2011-05-14,Summer,2011,May,9,0,Saturday,0,Misty,0.52,0.5,0.94,0.0896,14,86,100,597,100,100
3109,2011-05-14,Summer,2011,May,10,0,Saturday,0,Misty,0.52,0.5,0.94,0.1642,34,133,167,597,167,167
3110,2011-05-14,Summer,2011,May,11,0,Saturday,0,Misty,0.52,0.5,0.94,0.1343,72,207,279,597,279,279
3111,2011-05-14,Summer,2011,May,12,0,Saturday,0,Light_rainsnow,0.52,0.5,1.0,0.0896,75,204,279,597,279,279
3112,2011-05-14,Summer,2011,May,13,0,Saturday,0,Light_rainsnow,0.52,0.5,1.0,0.0896,68,180,248,597,248,248
3113,2011-05-14,Summer,2011,May,14,0,Saturday,0,Misty,0.54,0.5152,0.94,0.1343,57,159,216,597,216,216
3114,2011-05-14,Summer,2011,May,15,0,Saturday,0,Misty,0.54,0.5152,0.94,0.1642,73,221,294,597,294,294
3115,2011-05-14,Summer,2011,May,16,0,Saturday,0,Misty,0.54,0.5152,0.94,0.194,107,188,295,597,295,295
3116,2011-05-14,Summer,2011,May,17,0,Saturday,0,Misty,0.56,0.5303,0.88,0.194,78,194,272,597,272,272
3117,2011-05-14,Summer,2011,May,18,0,Saturday,0,Misty,0.56,0.5303,0.88,0.2239,88,216,304,597,304,304
3118,2011-05-14,Summer,2011,May,19,0,Saturday,0,Light_rainsnow,0.54,0.5152,0.94,0.1343,69,179,248,597,248,248
3119,2011-05-14,Summer,2011,May,20,0,Saturday,0,Light_rainsnow,0.54,0.5152,0.94,0.1343,42,115,157,597,157,157
3120,2011-05-14,Summer,2011,May,21,0,Saturday,0,Light_rainsnow,0.54,0.5152,0.94,0.2239,15,44,59,597,59,59
3121,2011-05-14,Summer,2011,May,22,0,Saturday,0,Light_rainsnow,0.54,0.5152,0.94,0.1642,7,19,26,597,26,26
3122,2011-05-14,Summer,2011,May,23,0,Saturday,0,Light_rainsnow,0.52,0.5,1.0,0.194,11,33,44,597,44,44
3123,2011-05-15,Summer,2011,May,0,0,Sunday,0,Misty,0.52,0.5,1.0,0.0,5,34,39,596,39,39
3124,2011-05-15,Summer,2011,May,1,0,Sunday,0,Misty,0.52,0.5,1.0,0.1045,4,43,47,596,47,47
3125,2011-05-15,Summer,2011,May,2,0,Sunday,0,Misty,0.52,0.5,1.0,0.1343,13,37,50,596,50,50
3126,2011-05-15,Summer,2011,May,3,0,Sunday,0,Misty,0.52,0.5,1.0,0.0,11,21,32,596,32,32
3127,2011-05-15,Summer,2011,May,4,0,Sunday,0,Misty,0.52,0.5,1.0,0.0,5,8,13,596,13,13
3128,2011-05-15,Summer,2011,May,5,0,Sunday,0,Light_rainsnow,0.52,0.5,1.0,0.1045,3,11,14,596,14,14
3129,2011-05-15,Summer,2011,May,6,0,Sunday,0,Misty,0.52,0.5,1.0,0.1343,3,14,17,596,17,17
3130,2011-05-15,Summer,2011,May,7,0,Sunday,0,Misty,0.52,0.5,1.0,0.1343,4,38,42,596,42,42
3131,2011-05-15,Summer,2011,May,8,0,Sunday,0,Misty,0.54,0.5152,0.94,0.1343,24,46,70,596,70,70
3132,2011-05-15,Summer,2011,May,9,0,Sunday,0,Clear,0.58,0.5455,0.83,0.2537,36,98,134,596,134,134
3133,2011-05-15,Summer,2011,May,10,0,Sunday,0,Clear,0.58,0.5455,0.83,0.2239,73,153,226,596,226,226
3134,2011-05-15,Summer,2011,May,11,0,Sunday,0,Clear,0.6,0.5758,0.78,0.2239,120,202,322,596,322,322
3135,2011-05-15,Summer,2011,May,12,0,Sunday,0,Clear,0.62,0.5909,0.73,0.2985,120,247,367,596,367,367
3136,2011-05-15,Summer,2011,May,13,0,Sunday,0,Clear,0.62,0.5909,0.73,0.2836,195,261,456,596,456,456
3137,2011-05-15,Summer,2011,May,14,0,Sunday,0,Clear,0.64,0.6061,0.73,0.194,183,254,437,596,437,437
3138,2011-05-15,Summer,2011,May,15,0,Sunday,0,Clear,0.66,0.6212,0.69,0.2537,206,253,459,596,459,459
3139,2011-05-15,Summer,2011,May,16,0,Sunday,0,Clear,0.64,0.6061,0.69,0.2537,158,282,440,596,440,440
3140,2011-05-15,Summer,2011,May,17,0,Sunday,0,Light_rainsnow,0.56,0.5303,0.78,0.3582,137,255,392,596,392,392
3141,2011-05-15,Summer,2011,May,18,0,Sunday,0,Clear,0.56,0.5303,0.78,0.2537,60,177,237,596,237,237
3142,2011-05-15,Summer,2011,May,19,0,Sunday,0,Clear,0.56,0.5303,0.83,0.1045,78,153,231,596,231,231
3143,2011-05-15,Summer,2011,May,20,0,Sunday,0,Clear,0.54,0.5152,0.88,0.0,53,138,191,596,191,191
3144,2011-05-15,Summer,2011,May,21,0,Sunday,0,Clear,0.54,0.5152,0.88,0.0,44,107,151,596,151,151
3145,2011-05-15,Summer,2011,May,22,0,Sunday,0,Clear,0.56,0.5303,0.83,0.0,29,88,117,596,117,117
3146,2011-05-15,Summer,2011,May,23,0,Sunday,0,Clear,0.54,0.5152,0.88,0.2239,18,51,69,596,69,69
3147,2011-05-16,Summer,2011,May,0,0,Monday,1,Clear,0.52,0.5,0.94,0.1045,17,21,38,595,38,38
3148,2011-05-16,Summer,2011,May,1,0,Monday,1,Clear,0.52,0.5,0.94,0.1343,6,8,14,595,14,14
3149,2011-05-16,Summer,2011,May,2,0,Monday,1,Clear,0.5,0.4848,1.0,0.0896,4,9,13,595,13,13
3150,2011-05-16,Summer,2011,May,3,0,Monday,1,Clear,0.5,0.4848,0.94,0.1642,1,3,4,595,4,4
3151,2011-05-16,Summer,2011,May,4,0,Monday,1,Clear,0.5,0.4848,1.0,0.1343,1,5,6,595,6,6
3152,2011-05-16,Summer,2011,May,5,0,Monday,1,Clear,0.5,0.4848,0.93,0.194,1,20,21,595,21,21
3153,2011-05-16,Summer,2011,May,6,0,Monday,1,Clear,0.52,0.5,0.88,0.1642,11,93,104,595,104,104
3154,2011-05-16,Summer,2011,May,7,0,Monday,1,Clear,0.52,0.5,0.83,0.2836,27,245,272,595,272,272
3155,2011-05-16,Summer,2011,May,8,0,Monday,1,Clear,0.56,0.5303,0.73,0.2985,28,366,394,595,394,394
3156,2011-05-16,Summer,2011,May,9,0,Monday,1,Clear,0.6,0.5909,0.69,0.194,38,156,194,595,194,194
3157,2011-05-16,Summer,2011,May,10,0,Monday,1,Clear,0.62,0.6061,0.65,0.0896,37,75,112,595,112,112
3158,2011-05-16,Summer,2011,May,11,0,Monday,1,Clear,0.64,0.6212,0.57,0.0,56,129,185,595,185,185
3159,2011-05-16,Summer,2011,May,12,0,Monday,1,Clear,0.66,0.6212,0.54,0.0896,72,137,209,595,209,209
3160,2011-05-16,Summer,2011,May,13,0,Monday,1,Clear,0.68,0.6364,0.51,0.0,61,153,214,595,214,214
3161,2011-05-16,Summer,2011,May,14,0,Monday,1,Clear,0.68,0.6364,0.51,0.0,76,117,193,595,193,193
3162,2011-05-16,Summer,2011,May,15,0,Monday,1,Clear,0.72,0.6667,0.51,0.0,55,110,165,595,165,165
3163,2011-05-16,Summer,2011,May,16,0,Monday,1,Light_rainsnow,0.6,0.5758,0.78,0.2537,45,181,226,595,226,226
3164,2011-05-16,Summer,2011,May,17,0,Monday,1,Clear,0.58,0.5455,0.88,0.2239,47,227,274,595,274,274
3165,2011-05-16,Summer,2011,May,18,0,Monday,1,Light_rainsnow,0.58,0.5455,0.83,0.194,55,398,453,595,453,453
3166,2011-05-16,Summer,2011,May,19,0,Monday,1,Clear,0.58,0.5455,0.83,0.2537,36,272,308,595,308,308
3167,2011-05-16,Summer,2011,May,20,0,Monday,1,Clear,0.58,0.5455,0.83,0.0,31,167,198,595,198,198
3168,2011-05-16,Summer,2011,May,21,0,Monday,1,Clear,0.58,0.5455,0.83,0.0,28,149,177,595,177,177
3169,2011-05-16,Summer,2011,May,22,0,Monday,1,Clear,0.56,0.5303,0.88,0.0896,22,105,127,595,127,127
3170,2011-05-16,Summer,2011,May,23,0,Monday,1,Clear,0.56,0.5303,0.88,0.0896,18,39,57,595,57,57
3171,2011-05-17,Summer,2011,May,0,0,Tuesday,1,Misty,0.56,0.5303,0.88,0.0,13,18,31,594,31,31
3172,2011-05-17,Summer,2011,May,1,0,Tuesday,1,Light_rainsnow,0.56,0.5303,0.88,0.0,7,6,13,594,13,13
3173,2011-05-17,Summer,2011,May,2,0,Tuesday,1,Light_rainsnow,0.56,0.5303,0.88,0.0,4,4,8,594,8,8
3174,2011-05-17,Summer,2011,May,3,0,Tuesday,1,Light_rainsnow,0.54,0.5152,0.94,0.2537,1,3,4,594,4,4
3175,2011-05-17,Summer,2011,May,4,0,Tuesday,1,Light_rainsnow,0.54,0.5152,0.94,0.2537,2,2,4,594,4,4
3176,2011-05-17,Summer,2011,May,5,0,Tuesday,1,Light_rainsnow,0.52,0.5,0.94,0.2537,0,22,22,594,22,22
3177,2011-05-17,Summer,2011,May,6,0,Tuesday,1,Light_rainsnow,0.52,0.5,0.94,0.2537,0,49,49,594,49,49
3178,2011-05-17,Summer,2011,May,7,0,Tuesday,1,Misty,0.52,0.5,0.94,0.2537,13,138,151,594,151,151
3179,2011-05-17,Summer,2011,May,8,0,Tuesday,1,Misty,0.52,0.5,0.94,0.2985,22,325,347,594,347,347
3180,2011-05-17,Summer,2011,May,9,0,Tuesday,1,Misty,0.54,0.5152,0.88,0.2537,17,190,207,594,207,207
3181,2011-05-17,Summer,2011,May,10,0,Tuesday,1,Light_rainsnow,0.54,0.5152,0.88,0.2537,31,73,104,594,104,104
3182,2011-05-17,Summer,2011,May,11,0,Tuesday,1,Misty,0.56,0.5303,0.83,0.4179,26,104,130,594,130,130
3183,2011-05-17,Summer,2011,May,12,0,Tuesday,1,Light_rainsnow,0.56,0.5303,0.83,0.4179,38,115,153,594,153,153
3184,2011-05-17,Summer,2011,May,13,0,Tuesday,1,Misty,0.56,0.5303,0.88,0.3284,31,141,172,594,172,172
3185,2011-05-17,Summer,2011,May,14,0,Tuesday,1,Clear,0.62,0.5909,0.73,0.4627,61,123,184,594,184,184
3186,2011-05-17,Summer,2011,May,15,0,Tuesday,1,Clear,0.62,0.6061,0.69,0.4478,79,131,210,594,210,210
3187,2011-05-17,Summer,2011,May,16,0,Tuesday,1,Clear,0.62,0.6061,0.61,0.3284,73,217,290,594,290,290
3188,2011-05-17,Summer,2011,May,17,0,Tuesday,1,Clear,0.62,0.6061,0.65,0.4179,83,521,604,594,604,604
3189,2011-05-17,Summer,2011,May,18,0,Tuesday,1,Clear,0.6,0.5909,0.69,0.2985,54,426,480,594,480,480
3190,2011-05-17,Summer,2011,May,19,0,Tuesday,1,Clear,0.6,0.5909,0.69,0.2537,51,298,349,594,349,349
3191,2011-05-17,Summer,2011,May,20,0,Tuesday,1,Clear,0.58,0.5455,0.83,0.4179,30,253,283,594,283,283
3192,2011-05-17,Summer,2011,May,21,0,Tuesday,1,Clear,0.54,0.5152,0.88,0.2537,23,151,174,594,174,174
3193,2011-05-17,Summer,2011,May,22,0,Tuesday,1,Misty,0.54,0.5152,0.88,0.2836,12,86,98,594,98,98
3194,2011-05-17,Summer,2011,May,23,0,Tuesday,1,Misty,0.54,0.5152,0.88,0.2537,7,49,56,594,56,56
3195,2011-05-18,Summer,2011,May,0,0,Wednesday,1,Misty,0.54,0.5152,0.88,0.2239,8,15,23,593,23,23
3196,2011-05-18,Summer,2011,May,1,0,Wednesday,1,Misty,0.54,0.5152,0.88,0.2537,3,9,12,593,12,12
3197,2011-05-18,Summer,2011,May,2,0,Wednesday,1,Light_rainsnow,0.52,0.5,0.94,0.2239,1,5,6,593,6,6
3198,2011-05-18,Summer,2011,May,3,0,Wednesday,1,Light_rainsnow,0.52,0.5,0.94,0.2985,6,3,9,593,9,9
3199,2011-05-18,Summer,2011,May,4,0,Wednesday,1,Light_rainsnow,0.52,0.5,0.94,0.2985,1,2,3,593,3,3
3200,2011-05-18,Summer,2011,May,5,0,Wednesday,1,Clear,0.52,0.5,1.0,0.2239,0,9,9,593,9,9
3201,2011-05-18,Summer,2011,May,6,0,Wednesday,1,Clear,0.52,0.5,1.0,0.1343,2,99,101,593,101,101
3202,2011-05-18,Summer,2011,May,7,0,Wednesday,1,Clear,0.54,0.5152,0.88,0.194,14,260,274,593,274,274
3203,2011-05-18,Summer,2011,May,8,0,Wednesday,1,Clear,0.56,0.5303,0.88,0.2836,25,428,453,593,453,453
3204,2011-05-18,Summer,2011,May,9,0,Wednesday,1,Light_rainsnow,0.56,0.5303,0.83,0.2537,26,176,202,593,202,202
3205,2011-05-18,Summer,2011,May,10,0,Wednesday,1,Light_rainsnow,0.54,0.5152,0.88,0.2836,33,73,106,593,106,106
3206,2011-05-18,Summer,2011,May,11,0,Wednesday,1,Misty,0.54,0.5152,0.94,0.0896,6,17,23,593,23,23
3207,2011-05-18,Summer,2011,May,12,0,Wednesday,1,Clear,0.56,0.5303,0.94,0.2985,12,42,54,593,54,54
3208,2011-05-18,Summer,2011,May,13,0,Wednesday,1,Misty,0.56,0.5303,0.83,0.3284,30,92,122,593,122,122
3209,2011-05-18,Summer,2011,May,14,0,Wednesday,1,Misty,0.58,0.5455,0.78,0.2836,44,94,138,593,138,138
3210,2011-05-18,Summer,2011,May,15,0,Wednesday,1,Clear,0.6,0.5758,0.78,0.2537,34,133,167,593,167,167
3211,2011-05-18,Summer,2011,May,16,0,Wednesday,1,Clear,0.6,0.5909,0.73,0.194,53,241,294,593,294,294
3212,2011-05-18,Summer,2011,May,17,0,Wednesday,1,Clear,0.6,0.5909,0.69,0.1343,78,487,565,593,565,565
3213,2011-05-18,Summer,2011,May,18,0,Wednesday,1,Clear,0.6,0.5909,0.73,0.2239,58,431,489,593,489,489
3214,2011-05-18,Summer,2011,May,19,0,Wednesday,1,Light_rainsnow,0.56,0.5303,0.88,0.1343,43,288,331,593,331,331
3215,2011-05-18,Summer,2011,May,20,0,Wednesday,1,Light_rainsnow,0.56,0.5303,0.88,0.1343,24,189,213,593,213,213
3216,2011-05-18,Summer,2011,May,21,0,Wednesday,1,Clear,0.52,0.5,0.88,0.0,11,74,85,593,85,85
3217,2011-05-18,Summer,2011,May,22,0,Wednesday,1,Clear,0.52,0.5,0.83,0.0,14,103,117,593,117,117
3218,2011-05-18,Summer,2011,May,23,0,Wednesday,1,Clear,0.52,0.5,0.94,0.0896,10,49,59,593,59,59
3219,2011-05-19,Summer,2011,May,0,0,Thursday,1,Clear,0.52,0.5,0.94,0.1045,6,23,29,592,29,29
3220,2011-05-19,Summer,2011,May,1,0,Thursday,1,Clear,0.5,0.4848,0.94,0.0,2,4,6,592,6,6
3221,2011-05-19,Summer,2011,May,2,0,Thursday,1,Clear,0.5,0.4848,0.94,0.0,3,12,15,592,15,15
3222,2011-05-19,Summer,2011,May,3,0,Thursday,1,Clear,0.48,0.4697,1.0,0.0,1,3,4,592,4,4
3223,2011-05-19,Summer,2011,May,4,0,Thursday,1,Clear,0.48,0.4697,0.94,0.0,2,3,5,592,5,5
3224,2011-05-19,Summer,2011,May,5,0,Thursday,1,Clear,0.48,0.4697,0.94,0.0,2,24,26,592,26,26
3225,2011-05-19,Summer,2011,May,6,0,Thursday,1,Misty,0.5,0.4848,0.94,0.0,17,86,103,592,103,103
3226,2011-05-19,Summer,2011,May,7,0,Thursday,1,Misty,0.5,0.4848,1.0,0.0,18,239,257,592,257,257
3227,2011-05-19,Summer,2011,May,8,0,Thursday,1,Misty,0.52,0.5,0.88,0.0,34,453,487,592,487,487
3228,2011-05-19,Summer,2011,May,9,0,Thursday,1,Misty,0.54,0.5152,0.88,0.0896,40,176,216,592,216,216
3229,2011-05-19,Summer,2011,May,10,0,Thursday,1,Misty,0.54,0.5152,0.83,0.0,35,95,130,592,130,130
3230,2011-05-19,Summer,2011,May,11,0,Thursday,1,Light_rainsnow,0.54,0.5152,0.88,0.1642,53,111,164,592,164,164
3231,2011-05-19,Summer,2011,May,12,0,Thursday,1,Misty,0.58,0.5455,0.78,0.1045,38,130,168,592,168,168
3232,2011-05-19,Summer,2011,May,13,0,Thursday,1,Light_rainsnow,0.58,0.5455,0.64,0.2537,44,139,183,592,183,183
3233,2011-05-19,Summer,2011,May,14,0,Thursday,1,Light_rainsnow,0.54,0.5152,0.73,0.194,43,137,180,592,180,180
3234,2011-05-19,Summer,2011,May,15,0,Thursday,1,Clear,0.56,0.5303,0.78,0.1642,63,125,188,592,188,188
3235,2011-05-19,Summer,2011,May,16,0,Thursday,1,Clear,0.58,0.5455,0.64,0.194,55,247,302,592,302,302
3236,2011-05-19,Summer,2011,May,17,0,Thursday,1,Clear,0.56,0.5303,0.78,0.1642,60,487,547,592,547,547
3237,2011-05-19,Summer,2011,May,18,0,Thursday,1,Clear,0.6,0.6212,0.55,0.1642,59,454,513,592,513,513
3238,2011-05-19,Summer,2011,May,19,0,Thursday,1,Clear,0.58,0.5455,0.6,0.1343,65,345,410,592,410,410
3239,2011-05-19,Summer,2011,May,20,0,Thursday,1,Clear,0.54,0.5152,0.77,0.2836,46,236,282,592,282,282
3240,2011-05-19,Summer,2011,May,21,0,Thursday,1,Clear,0.54,0.5152,0.77,0.2836,29,180,209,592,209,209
3241,2011-05-19,Summer,2011,May,22,0,Thursday,1,Light_rainsnow,0.5,0.4848,0.82,0.2985,11,68,79,592,79,79
3242,2011-05-19,Summer,2011,May,23,0,Thursday,1,Clear,0.48,0.4697,0.94,0.0,9,63,72,592,72,72
3243,2011-05-20,Summer,2011,May,0,0,Friday,1,Clear,0.46,0.4545,0.94,0.0896,15,33,48,591,48,48
3244,2011-05-20,Summer,2011,May,1,0,Friday,1,Clear,0.46,0.4545,1.0,0.0,8,17,25,591,25,25
3245,2011-05-20,Summer,2011,May,2,0,Friday,1,Clear,0.44,0.4394,1.0,0.0896,4,4,8,591,8,8
3246,2011-05-20,Summer,2011,May,3,0,Friday,1,Clear,0.44,0.4394,1.0,0.0,1,4,5,591,5,5
3247,2011-05-20,Summer,2011,May,4,0,Friday,1,Clear,0.44,0.4394,0.94,0.0896,1,4,5,591,5,5
3248,2011-05-20,Summer,2011,May,5,0,Friday,1,Clear,0.44,0.4394,0.94,0.1045,0,28,28,591,28,28
3249,2011-05-20,Summer,2011,May,6,0,Friday,1,Clear,0.46,0.4545,0.88,0.1045,15,102,117,591,117,117
3250,2011-05-20,Summer,2011,May,7,0,Friday,1,Clear,0.5,0.4848,0.77,0.1642,30,289,319,591,319,319
3251,2011-05-20,Summer,2011,May,8,0,Friday,1,Clear,0.54,0.5152,0.68,0.0,41,476,517,591,517,517
3252,2011-05-20,Summer,2011,May,9,0,Friday,1,Clear,0.54,0.5152,0.68,0.2239,35,199,234,591,234,234
3253,2011-05-20,Summer,2011,May,10,0,Friday,1,Clear,0.56,0.5303,0.64,0.194,44,104,148,591,148,148
3254,2011-05-20,Summer,2011,May,11,0,Friday,1,Misty,0.58,0.5455,0.6,0.194,63,133,196,591,196,196
3255,2011-05-20,Summer,2011,May,12,0,Friday,1,Misty,0.6,0.6212,0.56,0.2537,69,186,255,591,255,255
3256,2011-05-20,Summer,2011,May,13,0,Friday,1,Light_rainsnow,0.6,0.6212,0.56,0.2836,60,172,232,591,232,232
3257,2011-05-20,Summer,2011,May,14,0,Friday,1,Clear,0.62,0.6212,0.53,0.2239,66,131,197,591,197,197
3258,2011-05-20,Summer,2011,May,15,0,Friday,1,Misty,0.6,0.6212,0.56,0.194,74,168,242,591,242,242
3259,2011-05-20,Summer,2011,May,16,0,Friday,1,Misty,0.6,0.6212,0.53,0.1642,61,269,330,591,330,330
3260,2011-05-20,Summer,2011,May,17,0,Friday,1,Clear,0.62,0.6212,0.53,0.0,71,483,554,591,554,554
3261,2011-05-20,Summer,2011,May,18,0,Friday,1,Clear,0.6,0.6212,0.56,0.1642,79,394,473,591,473,473
3262,2011-05-20,Summer,2011,May,19,0,Friday,1,Clear,0.58,0.5455,0.64,0.0896,49,253,302,591,302,302
3263,2011-05-20,Summer,2011,May,20,0,Friday,1,Clear,0.58,0.5455,0.64,0.1045,40,180,220,591,220,220
3264,2011-05-20,Summer,2011,May,21,0,Friday,1,Clear,0.56,0.5303,0.64,0.1045,40,155,195,591,195,195
3265,2011-05-20,Summer,2011,May,22,0,Friday,1,Clear,0.54,0.5152,0.73,0.0,28,124,152,591,152,152
3266,2011-05-20,Summer,2011,May,23,0,Friday,1,Clear,0.52,0.5,0.72,0.1642,15,100,115,591,115,115
3267,2011-05-21,Summer,2011,May,0,0,Saturday,0,Clear,0.52,0.5,0.77,0.1045,20,78,98,590,98,98
3268,2011-05-21,Summer,2011,May,1,0,Saturday,0,Clear,0.52,0.5,0.72,0.0,8,64,72,590,72,72
3269,2011-05-21,Summer,2011,May,2,0,Saturday,0,Clear,0.52,0.5,0.72,0.1045,5,35,40,590,40,40
3270,2011-05-21,Summer,2011,May,3,0,Saturday,0,Clear,0.48,0.4697,0.82,0.1045,7,12,19,590,19,19
3271,2011-05-21,Summer,2011,May,4,0,Saturday,0,Clear,0.46,0.4545,0.88,0.1343,1,6,7,590,7,7
3272,2011-05-21,Summer,2011,May,5,0,Saturday,0,Clear,0.46,0.4545,0.88,0.1045,1,4,5,590,5,5
3273,2011-05-21,Summer,2011,May,6,0,Saturday,0,Clear,0.5,0.4848,0.82,0.1343,6,22,28,590,28,28
3274,2011-05-21,Summer,2011,May,7,0,Saturday,0,Clear,0.54,0.5152,0.73,0.1343,10,33,43,590,43,43
3275,2011-05-21,Summer,2011,May,8,0,Saturday,0,Clear,0.56,0.5303,0.68,0.2836,29,97,126,590,126,126
3276,2011-05-21,Summer,2011,May,9,0,Saturday,0,Clear,0.6,0.6061,0.64,0.2239,60,165,225,590,225,225
3277,2011-05-21,Summer,2011,May,10,0,Saturday,0,Clear,0.62,0.6061,0.61,0.1045,122,201,323,590,323,323
3278,2011-05-21,Summer,2011,May,11,0,Saturday,0,Clear,0.64,0.6212,0.53,0.1343,173,245,418,590,418,418
3279,2011-05-21,Summer,2011,May,12,0,Saturday,0,Clear,0.66,0.6212,0.5,0.0,222,271,493,590,493,493
3280,2011-05-21,Summer,2011,May,13,0,Saturday,0,Clear,0.7,0.6364,0.45,0.0,191,271,462,590,462,462
3281,2011-05-21,Summer,2011,May,14,0,Saturday,0,Clear,0.72,0.6515,0.42,0.0,187,269,456,590,456,456
3282,2011-05-21,Summer,2011,May,15,0,Saturday,0,Clear,0.72,0.6515,0.45,0.2537,232,274,506,590,506,506
3283,2011-05-21,Summer,2011,May,16,0,Saturday,0,Misty,0.72,0.6515,0.39,0.2537,204,267,471,590,471,471
3284,2011-05-21,Summer,2011,May,17,0,Saturday,0,Misty,0.72,0.6515,0.42,0.1642,191,253,444,590,444,444
3285,2011-05-21,Summer,2011,May,18,0,Saturday,0,Misty,0.7,0.6364,0.45,0.1642,191,253,444,590,444,444
3286,2011-05-21,Summer,2011,May,19,0,Saturday,0,Clear,0.68,0.6364,0.47,0.1642,117,184,301,590,301,301
3287,2011-05-21,Summer,2011,May,20,0,Saturday,0,Clear,0.62,0.6061,0.61,0.0,84,164,248,590,248,248
3288,2011-05-21,Summer,2011,May,21,0,Saturday,0,Clear,0.62,0.6061,0.61,0.1045,77,150,227,590,227,227
3289,2011-05-21,Summer,2011,May,22,0,Saturday,0,Clear,0.6,0.5909,0.69,0.1343,78,126,204,590,204,204
3290,2011-05-21,Summer,2011,May,23,0,Saturday,0,Clear,0.58,0.5455,0.78,0.0896,42,103,145,590,145,145
3291,2011-05-22,Summer,2011,May,0,0,Sunday,0,Clear,0.54,0.5152,0.88,0.1642,31,100,131,589,131,131
3292,2011-05-22,Summer,2011,May,1,0,Sunday,0,Clear,0.52,0.5,0.94,0.1343,17,81,98,589,98,98
3293,2011-05-22,Summer,2011,May,2,0,Sunday,0,Clear,0.52,0.5,0.94,0.1045,18,50,68,589,68,68
3294,2011-05-22,Summer,2011,May,3,0,Sunday,0,Clear,0.5,0.4848,1.0,0.1045,10,23,33,589,33,33
3295,2011-05-22,Summer,2011,May,4,0,Sunday,0,Clear,0.5,0.4848,1.0,0.0,3,9,12,589,12,12
3296,2011-05-22,Summer,2011,May,5,0,Sunday,0,Clear,0.5,0.4848,1.0,0.1045,1,5,6,589,6,6
3297,2011-05-22,Summer,2011,May,6,0,Sunday,0,Clear,0.52,0.5,0.94,0.1045,5,13,18,589,18,18
3298,2011-05-22,Summer,2011,May,7,0,Sunday,0,Clear,0.54,0.5152,0.88,0.1045,13,27,40,589,40,40
3299,2011-05-22,Summer,2011,May,8,0,Sunday,0,Clear,0.6,0.5909,0.73,0.0896,29,65,94,589,94,94
3300,2011-05-22,Summer,2011,May,9,0,Sunday,0,Clear,0.62,0.6061,0.69,0.1045,59,130,189,589,189,189
3301,2011-05-22,Summer,2011,May,10,0,Sunday,0,Clear,0.64,0.6061,0.65,0.1343,135,170,305,589,305,305
3302,2011-05-22,Summer,2011,May,11,0,Sunday,0,Clear,0.7,0.6515,0.54,0.194,164,209,373,589,373,373
3303,2011-05-22,Summer,2011,May,12,0,Sunday,0,Misty,0.72,0.6667,0.51,0.194,146,255,401,589,401,401
3304,2011-05-22,Summer,2011,May,13,0,Sunday,0,Misty,0.66,0.6212,0.54,0.2239,180,275,455,589,455,455
3305,2011-05-22,Summer,2011,May,14,0,Sunday,0,Light_rainsnow,0.62,0.6061,0.69,0.194,125,191,316,589,316,316
3306,2011-05-22,Summer,2011,May,15,0,Sunday,0,Misty,0.66,0.6212,0.61,0.1642,110,221,331,589,331,331
3307,2011-05-22,Summer,2011,May,16,0,Sunday,0,Clear,0.68,0.6364,0.61,0.1343,72,201,273,589,273,273
3308,2011-05-22,Summer,2011,May,17,0,Sunday,0,Clear,0.7,0.6515,0.58,0.2537,93,213,306,589,306,306
3309,2011-05-22,Summer,2011,May,18,0,Sunday,0,Clear,0.66,0.6212,0.61,0.2239,120,238,358,589,358,358
3310,2011-05-22,Summer,2011,May,19,0,Sunday,0,Clear,0.66,0.6212,0.61,0.194,107,193,300,589,300,300
3311,2011-05-22,Summer,2011,May,20,0,Sunday,0,Clear,0.64,0.6061,0.65,0.1642,57,174,231,589,231,231
3312,2011-05-22,Summer,2011,May,21,0,Sunday,0,Clear,0.62,0.5909,0.73,0.194,27,109,136,589,136,136
3313,2011-05-22,Summer,2011,May,22,0,Sunday,0,Clear,0.6,0.5606,0.83,0.1343,35,86,121,589,121,121
3314,2011-05-22,Summer,2011,May,23,0,Sunday,0,Misty,0.58,0.5455,0.83,0.1343,19,46,65,589,65,65
3315,2011-05-23,Summer,2011,May,0,0,Monday,1,Misty,0.56,0.5303,0.88,0.1343,23,18,41,588,41,41
3316,2011-05-23,Summer,2011,May,1,0,Monday,1,Clear,0.56,0.5303,0.88,0.1045,4,5,9,588,9,9
3317,2011-05-23,Summer,2011,May,2,0,Monday,1,Light_rainsnow,0.56,0.5303,0.88,0.1642,2,3,5,588,5,5
3318,2011-05-23,Summer,2011,May,3,0,Monday,1,Light_rainsnow,0.54,0.5152,0.94,0.1642,0,4,4,588,4,4
3319,2011-05-23,Summer,2011,May,4,0,Monday,1,Misty,0.54,0.5152,0.94,0.0,2,2,4,588,4,4
3320,2011-05-23,Summer,2011,May,5,0,Monday,1,Misty,0.54,0.5152,0.94,0.0,0,11,11,588,11,11
3321,2011-05-23,Summer,2011,May,6,0,Monday,1,Misty,0.54,0.5152,1.0,0.0,4,92,96,588,96,96
3322,2011-05-23,Summer,2011,May,7,0,Monday,1,Misty,0.56,0.5303,0.94,0.1045,13,223,236,588,236,236
3323,2011-05-23,Summer,2011,May,8,0,Monday,1,Clear,0.6,0.5455,0.88,0.194,50,359,409,588,409,409
3324,2011-05-23,Summer,2011,May,9,0,Monday,1,Clear,0.6,0.5455,0.88,0.2239,36,131,167,588,167,167
3325,2011-05-23,Summer,2011,May,10,0,Monday,1,Clear,0.66,0.6212,0.74,0.2985,49,72,121,588,121,121
3326,2011-05-23,Summer,2011,May,11,0,Monday,1,Clear,0.68,0.6364,0.69,0.3881,73,107,180,588,180,180
3327,2011-05-23,Summer,2011,May,12,0,Monday,1,Clear,0.68,0.6364,0.69,0.3881,65,139,204,588,204,204
3328,2011-05-23,Summer,2011,May,13,0,Monday,1,Misty,0.74,0.6818,0.58,0.4179,49,155,204,588,204,204
3329,2011-05-23,Summer,2011,May,14,0,Monday,1,Misty,0.72,0.6818,0.62,0.5224,57,130,187,588,187,187
3330,2011-05-23,Summer,2011,May,15,0,Monday,1,Misty,0.72,0.6818,0.62,0.4478,57,119,176,588,176,176
3331,2011-05-23,Summer,2011,May,16,0,Monday,1,Misty,0.72,0.6818,0.62,0.2985,56,223,279,588,279,279
3332,2011-05-23,Summer,2011,May,17,0,Monday,1,Light_rainsnow,0.72,0.6818,0.7,0.3881,56,373,429,588,429,429
3333,2011-05-23,Summer,2011,May,18,0,Monday,1,Clear,0.7,0.6667,0.74,0.2836,68,385,453,588,453,453
3334,2011-05-23,Summer,2011,May,19,0,Monday,1,Clear,0.7,0.6667,0.74,0.2239,56,302,358,588,358,358
3335,2011-05-23,Summer,2011,May,20,0,Monday,1,Clear,0.64,0.5758,0.83,0.2239,39,271,310,588,310,310
3336,2011-05-23,Summer,2011,May,21,0,Monday,1,Clear,0.64,0.5758,0.89,0.2239,33,155,188,588,188,188
3337,2011-05-23,Summer,2011,May,22,0,Monday,1,Clear,0.62,0.5455,0.94,0.2239,25,106,131,588,131,131
3338,2011-05-23,Summer,2011,May,23,0,Monday,1,Misty,0.62,0.5606,0.88,0.194,19,53,72,588,72,72
3339,2011-05-24,Summer,2011,May,0,0,Tuesday,1,Misty,0.6,0.5152,0.94,0.194,12,23,35,587,35,35
3340,2011-05-24,Summer,2011,May,1,0,Tuesday,1,Misty,0.6,0.5152,0.94,0.1642,6,9,15,587,15,15
3341,2011-05-24,Summer,2011,May,2,0,Tuesday,1,Misty,0.6,0.5152,0.94,0.194,2,8,10,587,10,10
3342,2011-05-24,Summer,2011,May,3,0,Tuesday,1,Misty,0.58,0.5455,0.94,0.1045,0,2,2,587,2,2
3343,2011-05-24,Summer,2011,May,4,0,Tuesday,1,Clear,0.6,0.5455,0.88,0.1045,1,3,4,587,4,4
3344,2011-05-24,Summer,2011,May,5,0,Tuesday,1,Misty,0.58,0.5455,0.94,0.2537,2,22,24,587,24,24
3345,2011-05-24,Summer,2011,May,6,0,Tuesday,1,Misty,0.58,0.5455,0.94,0.194,10,102,112,587,112,112
3346,2011-05-24,Summer,2011,May,7,0,Tuesday,1,Light_rainsnow,0.64,0.5909,0.78,0.194,26,288,314,587,314,314
3347,2011-05-24,Summer,2011,May,8,0,Tuesday,1,Light_rainsnow,0.62,0.5758,0.83,0.2239,31,403,434,587,434,434
3348,2011-05-24,Summer,2011,May,9,0,Tuesday,1,Misty,0.64,0.6061,0.73,0.194,27,111,138,587,138,138
3349,2011-05-24,Summer,2011,May,10,0,Tuesday,1,Clear,0.7,0.6515,0.61,0.3284,18,90,108,587,108,108
3350,2011-05-24,Summer,2011,May,11,0,Tuesday,1,Clear,0.74,0.6667,0.51,0.2239,33,142,175,587,175,175
3351,2011-05-24,Summer,2011,May,12,0,Tuesday,1,Clear,0.76,0.6818,0.45,0.3881,41,129,170,587,170,170
3352,2011-05-24,Summer,2011,May,13,0,Tuesday,1,Clear,0.78,0.697,0.46,0.2537,38,152,190,587,190,190
3353,2011-05-24,Summer,2011,May,14,0,Tuesday,1,Clear,0.78,0.697,0.46,0.2836,27,126,153,587,153,153
3354,2011-05-24,Summer,2011,May,15,0,Tuesday,1,Light_rainsnow,0.74,0.6818,0.55,0.4179,59,129,188,587,188,188
3355,2011-05-24,Summer,2011,May,16,0,Tuesday,1,Clear,0.66,0.6212,0.69,0.194,52,225,277,587,277,277
3356,2011-05-24,Summer,2011,May,17,0,Tuesday,1,Clear,0.7,0.6515,0.61,0.1045,56,492,548,587,548,548
3357,2011-05-24,Summer,2011,May,18,0,Tuesday,1,Clear,0.7,0.6515,0.7,0.194,74,490,564,587,564,564
3358,2011-05-24,Summer,2011,May,19,0,Tuesday,1,Clear,0.66,0.6212,0.74,0.194,45,310,355,587,355,355
3359,2011-05-24,Summer,2011,May,20,0,Tuesday,1,Clear,0.66,0.6212,0.74,0.0896,39,241,280,587,280,280
3360,2011-05-24,Summer,2011,May,21,0,Tuesday,1,Clear,0.64,0.5909,0.78,0.0896,21,168,189,587,189,189
3361,2011-05-24,Summer,2011,May,22,0,Tuesday,1,Light_rainsnow,0.62,0.5606,0.88,0.2239,26,115,141,587,141,141
3362,2011-05-24,Summer,2011,May,23,0,Tuesday,1,Light_rainsnow,0.66,0.6212,0.74,0.1642,13,53,66,587,66,66
3363,2011-05-25,Summer,2011,May,0,0,Wednesday,1,Light_rainsnow,0.6,0.5606,0.83,0.2239,3,32,35,586,35,35
3364,2011-05-25,Summer,2011,May,1,0,Wednesday,1,Light_rainsnow,0.58,0.5455,0.83,0.194,6,2,8,586,8,8
3365,2011-05-25,Summer,2011,May,2,0,Wednesday,1,Misty,0.56,0.5303,0.94,0.0,0,8,8,586,8,8
3366,2011-05-25,Summer,2011,May,3,0,Wednesday,1,Clear,0.54,0.5152,1.0,0.1343,0,9,9,586,9,9
3367,2011-05-25,Summer,2011,May,4,0,Wednesday,1,Clear,0.54,0.5152,1.0,0.1045,0,3,3,586,3,3
3368,2011-05-25,Summer,2011,May,5,0,Wednesday,1,Clear,0.56,0.5303,0.88,0.0896,2,23,25,586,25,25
3369,2011-05-25,Summer,2011,May,6,0,Wednesday,1,Clear,0.56,0.5303,0.94,0.0896,4,113,117,586,117,117
3370,2011-05-25,Summer,2011,May,7,0,Wednesday,1,Clear,0.62,0.5909,0.73,0.1343,29,284,313,586,313,313
3371,2011-05-25,Summer,2011,May,8,0,Wednesday,1,Clear,0.64,0.6061,0.69,0.2239,36,495,531,586,531,531
3372,2011-05-25,Summer,2011,May,9,0,Wednesday,1,Clear,0.68,0.6364,0.65,0.0896,27,207,234,586,234,234
3373,2011-05-25,Summer,2011,May,10,0,Wednesday,1,Clear,0.7,0.6515,0.61,0.0896,30,105,135,586,135,135
3374,2011-05-25,Summer,2011,May,11,0,Wednesday,1,Clear,0.74,0.6667,0.51,0.0896,36,104,140,586,140,140
3375,2011-05-25,Summer,2011,May,12,0,Wednesday,1,Clear,0.74,0.6818,0.55,0.1343,32,178,210,586,210,210
3376,2011-05-25,Summer,2011,May,13,0,Wednesday,1,Clear,0.74,0.6818,0.55,0.1343,39,163,202,586,202,202
3377,2011-05-25,Summer,2011,May,14,0,Wednesday,1,Clear,0.74,0.6818,0.55,0.1642,47,121,168,586,168,168
3378,2011-05-25,Summer,2011,May,15,0,Wednesday,1,Clear,0.76,0.697,0.52,0.2537,37,145,182,586,182,182
3379,2011-05-25,Summer,2011,May,16,0,Wednesday,1,Clear,0.74,0.6667,0.51,0.2836,61,238,299,586,299,299
3380,2011-05-25,Summer,2011,May,17,0,Wednesday,1,Clear,0.74,0.6667,0.51,0.2239,77,524,601,586,601,601
3381,2011-05-25,Summer,2011,May,18,0,Wednesday,1,Clear,0.72,0.6667,0.58,0.2239,66,451,517,586,517,517
3382,2011-05-25,Summer,2011,May,19,0,Wednesday,1,Clear,0.7,0.6515,0.61,0.1343,73,332,405,586,405,405
3383,2011-05-25,Summer,2011,May,20,0,Wednesday,1,Clear,0.7,0.6515,0.61,0.1642,56,284,340,586,340,340
3384,2011-05-25,Summer,2011,May,21,0,Wednesday,1,Clear,0.66,0.6212,0.69,0.1343,33,203,236,586,236,236
3385,2011-05-25,Summer,2011,May,22,0,Wednesday,1,Clear,0.66,0.6212,0.69,0.2537,34,140,174,586,174,174
3386,2011-05-25,Summer,2011,May,23,0,Wednesday,1,Clear,0.64,0.6061,0.73,0.1343,12,74,86,586,86,86
3387,2011-05-26,Summer,2011,May,0,0,Thursday,1,Clear,0.64,0.6061,0.73,0.1343,11,34,45,585,45,45
3388,2011-05-26,Summer,2011,May,1,0,Thursday,1,Clear,0.64,0.6061,0.73,0.1343,3,13,16,585,16,16
3389,2011-05-26,Summer,2011,May,2,0,Thursday,1,Clear,0.62,0.5758,0.83,0.1045,7,7,14,585,14,14
3390,2011-05-26,Summer,2011,May,3,0,Thursday,1,Clear,0.6,0.5455,0.88,0.0896,0,4,4,585,4,4
3391,2011-05-26,Summer,2011,May,4,0,Thursday,1,Clear,0.6,0.5455,0.88,0.0,0,2,2,585,2,2
3392,2011-05-26,Summer,2011,May,5,0,Thursday,1,Misty,0.6,0.5455,0.88,0.0896,2,25,27,585,27,27
3393,2011-05-26,Summer,2011,May,6,0,Thursday,1,Misty,0.6,0.5,1.0,0.0896,4,94,98,585,98,98
3394,2011-05-26,Summer,2011,May,7,0,Thursday,1,Misty,0.62,0.5455,0.94,0.2537,16,270,286,585,286,286
3395,2011-05-26,Summer,2011,May,8,0,Thursday,1,Misty,0.66,0.6061,0.83,0.1642,31,458,489,585,489,489
3396,2011-05-26,Summer,2011,May,9,0,Thursday,1,Clear,0.72,0.6818,0.7,0.1642,22,194,216,585,216,216
3397,2011-05-26,Summer,2011,May,10,0,Thursday,1,Clear,0.7,0.6667,0.74,0.2836,49,94,143,585,143,143
3398,2011-05-26,Summer,2011,May,11,0,Thursday,1,Clear,0.74,0.697,0.66,0.2239,36,124,160,585,160,160
3399,2011-05-26,Summer,2011,May,12,0,Thursday,1,Clear,0.78,0.7424,0.59,0.3284,53,141,194,585,194,194
3400,2011-05-26,Summer,2011,May,13,0,Thursday,1,Clear,0.82,0.7727,0.52,0.2836,52,145,197,585,197,197
3401,2011-05-26,Summer,2011,May,14,0,Thursday,1,Clear,0.82,0.7727,0.52,0.2836,44,145,189,585,189,189
3402,2011-05-26,Summer,2011,May,15,0,Thursday,1,Misty,0.82,0.7576,0.46,0.2836,40,101,141,585,141,141
3403,2011-05-26,Summer,2011,May,16,0,Thursday,1,Misty,0.8,0.7424,0.49,0.3582,58,233,291,585,291,291
3404,2011-05-26,Summer,2011,May,17,0,Thursday,1,Clear,0.8,0.7273,0.46,0.2836,49,445,494,585,494,494
3405,2011-05-26,Summer,2011,May,18,0,Thursday,1,Clear,0.8,0.7273,0.46,0.3284,74,404,478,585,478,478
3406,2011-05-26,Summer,2011,May,19,0,Thursday,1,Clear,0.78,0.697,0.46,0.3284,67,311,378,585,378,378
3407,2011-05-26,Summer,2011,May,20,0,Thursday,1,Clear,0.72,0.6667,0.58,0.1642,55,267,322,585,322,322
3408,2011-05-26,Summer,2011,May,21,0,Thursday,1,Clear,0.72,0.6818,0.62,0.0896,45,178,223,585,223,223
3409,2011-05-26,Summer,2011,May,22,0,Thursday,1,Clear,0.7,0.6515,0.65,0.1343,23,157,180,585,180,180
3410,2011-05-26,Summer,2011,May,23,0,Thursday,1,Clear,0.7,0.6515,0.65,0.194,17,73,90,585,90,90
3411,2011-05-27,Summer,2011,May,0,0,Friday,1,Clear,0.68,0.6364,0.69,0.2537,14,55,69,584,69,69
3412,2011-05-27,Summer,2011,May,1,0,Friday,1,Clear,0.7,0.6515,0.58,0.2985,14,36,50,584,50,50
3413,2011-05-27,Summer,2011,May,2,0,Friday,1,Clear,0.68,0.6364,0.61,0.2239,6,12,18,584,18,18
3414,2011-05-27,Summer,2011,May,3,0,Friday,1,Clear,0.66,0.6212,0.65,0.0896,1,11,12,584,12,12
3415,2011-05-27,Summer,2011,May,4,0,Friday,1,Clear,0.64,0.6061,0.69,0.1343,2,5,7,584,7,7
3416,2011-05-27,Summer,2011,May,5,0,Friday,1,Clear,0.64,0.6061,0.65,0.2836,2,29,31,584,31,31
3417,2011-05-27,Summer,2011,May,6,0,Friday,1,Clear,0.64,0.6061,0.69,0.0896,8,73,81,584,81,81
3418,2011-05-27,Summer,2011,May,7,0,Friday,1,Clear,0.64,0.6061,0.73,0.1642,20,229,249,584,249,249
3419,2011-05-27,Summer,2011,May,8,0,Friday,1,Clear,0.66,0.6212,0.74,0.2836,25,393,418,584,418,418
3420,2011-05-27,Summer,2011,May,9,0,Friday,1,Clear,0.7,0.6515,0.65,0.2836,37,190,227,584,227,227
3421,2011-05-27,Summer,2011,May,10,0,Friday,1,Clear,0.72,0.6667,0.54,0.3881,42,111,153,584,153,153
3422,2011-05-27,Summer,2011,May,11,0,Friday,1,Misty,0.74,0.6818,0.55,0.3284,40,126,166,584,166,166
3423,2011-05-27,Summer,2011,May,12,0,Friday,1,Misty,0.76,0.697,0.55,0.2985,53,190,243,584,243,243
3424,2011-05-27,Summer,2011,May,13,0,Friday,1,Clear,0.74,0.6818,0.58,0.194,51,158,209,584,209,209
3425,2011-05-27,Summer,2011,May,14,0,Friday,1,Clear,0.76,0.697,0.55,0.2537,51,188,239,584,239,239
3426,2011-05-27,Summer,2011,May,15,0,Friday,1,Clear,0.78,0.7121,0.49,0.2836,98,258,356,584,356,356
3427,2011-05-27,Summer,2011,May,16,0,Friday,1,Misty,0.76,0.697,0.55,0.3881,63,356,419,584,419,419
3428,2011-05-27,Summer,2011,May,17,0,Friday,1,Clear,0.74,0.6818,0.58,0.3881,77,414,491,584,491,491
3429,2011-05-27,Summer,2011,May,18,0,Friday,1,Misty,0.72,0.6818,0.62,0.2985,89,310,399,584,399,399
3430,2011-05-27,Summer,2011,May,19,0,Friday,1,Light_rainsnow,0.6,0.5758,0.78,0.2537,69,210,279,584,279,279
3431,2011-05-27,Summer,2011,May,20,0,Friday,1,Misty,0.62,0.5909,0.73,0.2239,24,120,144,584,144,144
3432,2011-05-27,Summer,2011,May,21,0,Friday,1,Clear,0.6,0.5606,0.83,0.1045,37,114,151,584,151,151
3433,2011-05-27,Summer,2011,May,22,0,Friday,1,Clear,0.6,0.5758,0.78,0.1343,25,116,141,584,141,141
3434,2011-05-27,Summer,2011,May,23,0,Friday,1,Clear,0.58,0.5455,0.88,0.1343,23,104,127,584,127,127
3435,2011-05-28,Summer,2011,May,0,0,Saturday,0,Clear,0.58,0.5455,0.88,0.1343,15,79,94,583,94,94
3436,2011-05-28,Summer,2011,May,1,0,Saturday,0,Clear,0.58,0.5455,0.88,0.194,8,47,55,583,55,55
3437,2011-05-28,Summer,2011,May,2,0,Saturday,0,Clear,0.56,0.5303,0.94,0.194,13,35,48,583,48,48
3438,2011-05-28,Summer,2011,May,3,0,Saturday,0,Clear,0.56,0.5303,0.88,0.2239,2,13,15,583,15,15
3439,2011-05-28,Summer,2011,May,4,0,Saturday,0,Clear,0.56,0.5303,0.88,0.2537,0,4,4,583,4,4
3440,2011-05-28,Summer,2011,May,5,0,Saturday,0,Clear,0.56,0.5303,0.88,0.2239,4,3,7,583,7,7
3441,2011-05-28,Summer,2011,May,6,0,Saturday,0,Clear,0.58,0.5455,0.83,0.2537,3,16,19,583,19,19
3442,2011-05-28,Summer,2011,May,7,0,Saturday,0,Clear,0.6,0.5606,0.83,0.2537,17,33,50,583,50,50
3443,2011-05-28,Summer,2011,May,8,0,Saturday,0,Clear,0.62,0.5909,0.78,0.194,27,75,102,583,102,102
3444,2011-05-28,Summer,2011,May,9,0,Saturday,0,Clear,0.64,0.6061,0.73,0.2537,61,116,177,583,177,177
3445,2011-05-28,Summer,2011,May,10,0,Saturday,0,Clear,0.7,0.6515,0.65,0.2239,110,166,276,583,276,276
3446,2011-05-28,Summer,2011,May,11,0,Saturday,0,Clear,0.7,0.6515,0.65,0.2239,171,178,349,583,349,349
3447,2011-05-28,Summer,2011,May,12,0,Saturday,0,Clear,0.72,0.6667,0.58,0.2537,145,213,358,583,358,358
3448,2011-05-28,Summer,2011,May,13,0,Saturday,0,Clear,0.72,0.6818,0.62,0.2239,168,217,385,583,385,385
3449,2011-05-28,Summer,2011,May,14,0,Saturday,0,Clear,0.74,0.6818,0.58,0.2239,172,210,382,583,382,382
3450,2011-05-28,Summer,2011,May,15,0,Saturday,0,Clear,0.74,0.6818,0.55,0.2239,187,187,374,583,374,374
3451,2011-05-28,Summer,2011,May,16,0,Saturday,0,Clear,0.76,0.697,0.55,0.2836,201,201,402,583,402,402
3452,2011-05-28,Summer,2011,May,17,0,Saturday,0,Clear,0.74,0.6818,0.55,0.2985,180,161,341,583,341,341
3453,2011-05-28,Summer,2011,May,18,0,Saturday,0,Clear,0.72,0.6818,0.62,0.2537,173,212,385,583,385,385
3454,2011-05-28,Summer,2011,May,19,0,Saturday,0,Clear,0.7,0.6515,0.65,0.194,99,153,252,583,252,252
3455,2011-05-28,Summer,2011,May,20,0,Saturday,0,Clear,0.7,0.6515,0.65,0.2239,68,128,196,583,196,196
3456,2011-05-28,Summer,2011,May,21,0,Saturday,0,Clear,0.66,0.6212,0.74,0.2985,87,114,201,583,201,201
3457,2011-05-28,Summer,2011,May,22,0,Saturday,0,Clear,0.66,0.6061,0.78,0.2239,46,115,161,583,161,161
3458,2011-05-28,Summer,2011,May,23,0,Saturday,0,Clear,0.64,0.5758,0.83,0.194,44,81,125,583,125,125
3459,2011-05-29,Summer,2011,May,0,0,Sunday,0,Clear,0.64,0.5758,0.83,0.2239,32,51,83,582,83,83
3460,2011-05-29,Summer,2011,May,1,0,Sunday,0,Clear,0.62,0.5606,0.88,0.1642,17,49,66,582,66,66
3461,2011-05-29,Summer,2011,May,2,0,Sunday,0,Clear,0.62,0.5606,0.88,0.1045,12,49,61,582,61,61
3462,2011-05-29,Summer,2011,May,3,0,Sunday,0,Clear,0.62,0.5606,0.88,0.1045,2,24,26,582,26,26
3463,2011-05-29,Summer,2011,May,4,0,Sunday,0,Clear,0.6,0.5455,0.88,0.0896,13,10,23,582,23,23
3464,2011-05-29,Summer,2011,May,5,0,Sunday,0,Clear,0.6,0.5152,0.94,0.1642,3,3,6,582,6,6
3465,2011-05-29,Summer,2011,May,6,0,Sunday,0,Misty,0.62,0.5606,0.88,0.194,5,10,15,582,15,15
3466,2011-05-29,Summer,2011,May,7,0,Sunday,0,Misty,0.62,0.5606,0.88,0.2537,13,17,30,582,30,30
3467,2011-05-29,Summer,2011,May,8,0,Sunday,0,Misty,0.62,0.5606,0.88,0.2239,34,62,96,582,96,96
3468,2011-05-29,Summer,2011,May,9,0,Sunday,0,Misty,0.62,0.5455,0.94,0.2537,74,78,152,582,152,152
3469,2011-05-29,Summer,2011,May,10,0,Sunday,0,Misty,0.66,0.6061,0.83,0.2239,130,121,251,582,251,251
3470,2011-05-29,Summer,2011,May,11,0,Sunday,0,Misty,0.66,0.6061,0.83,0.2836,139,180,319,582,319,319
3471,2011-05-29,Summer,2011,May,12,0,Sunday,0,Misty,0.7,0.6667,0.74,0.2239,216,186,402,582,402,402
3472,2011-05-29,Summer,2011,May,13,0,Sunday,0,Clear,0.72,0.6818,0.7,0.2836,237,181,418,582,418,418
3473,2011-05-29,Summer,2011,May,14,0,Sunday,0,Clear,0.74,0.697,0.7,0.2836,183,168,351,582,351,351
3474,2011-05-29,Summer,2011,May,15,0,Sunday,0,Clear,0.74,0.697,0.7,0.2985,221,155,376,582,376,376
3475,2011-05-29,Summer,2011,May,16,0,Sunday,0,Clear,0.74,0.697,0.7,0.2836,194,167,361,582,361,361
3476,2011-05-29,Summer,2011,May,17,0,Sunday,0,Clear,0.74,0.697,0.7,0.2836,214,169,383,582,383,383
3477,2011-05-29,Summer,2011,May,18,0,Sunday,0,Clear,0.72,0.697,0.74,0.2836,151,177,328,582,328,328
3478,2011-05-29,Summer,2011,May,19,0,Sunday,0,Clear,0.72,0.697,0.74,0.2537,141,146,287,582,287,287
3479,2011-05-29,Summer,2011,May,20,0,Sunday,0,Clear,0.7,0.6667,0.79,0.194,91,128,219,582,219,219
3480,2011-05-29,Summer,2011,May,21,0,Sunday,0,Clear,0.68,0.6364,0.83,0.1642,107,122,229,582,229,229
3481,2011-05-29,Summer,2011,May,22,0,Sunday,0,Clear,0.66,0.5909,0.89,0.1343,78,93,171,582,171,171
3482,2011-05-29,Summer,2011,May,23,0,Sunday,0,Clear,0.66,0.5909,0.89,0.1642,48,87,135,582,135,135
3483,2011-05-30,Summer,2011,May,0,1,Monday,0,Clear,0.64,0.5606,0.94,0.194,38,65,103,581,103,103
3484,2011-05-30,Summer,2011,May,1,1,Monday,0,Clear,0.64,0.5606,0.94,0.1343,26,53,79,581,79,79
3485,2011-05-30,Summer,2011,May,2,1,Monday,0,Clear,0.64,0.5606,0.94,0.194,17,28,45,581,45,45
3486,2011-05-30,Summer,2011,May,3,1,Monday,0,Clear,0.64,0.5606,0.94,0.194,10,8,18,581,18,18
3487,2011-05-30,Summer,2011,May,4,1,Monday,0,Clear,0.62,0.5455,0.94,0.1642,2,4,6,581,6,6
3488,2011-05-30,Summer,2011,May,5,1,Monday,0,Misty,0.62,0.5455,0.94,0.1045,1,6,7,581,7,7
3489,2011-05-30,Summer,2011,May,6,1,Monday,0,Misty,0.64,0.5606,0.94,0.0896,6,10,16,581,16,16
3490,2011-05-30,Summer,2011,May,7,1,Monday,0,Misty,0.64,0.5606,0.94,0.0,12,19,31,581,31,31
3491,2011-05-30,Summer,2011,May,8,1,Monday,0,Misty,0.66,0.5909,0.89,0.1045,36,58,94,581,94,94
3492,2011-05-30,Summer,2011,May,9,1,Monday,0,Clear,0.72,0.697,0.74,0.0896,47,81,128,581,128,128
3493,2011-05-30,Summer,2011,May,10,1,Monday,0,Clear,0.8,0.7576,0.55,0.2537,116,153,269,581,269,269
3494,2011-05-30,Summer,2011,May,11,1,Monday,0,Clear,0.82,0.7727,0.52,0.0,153,168,321,581,321,321
3495,2011-05-30,Summer,2011,May,12,1,Monday,0,Clear,0.86,0.803,0.47,0.1045,179,187,366,581,366,366
3496,2011-05-30,Summer,2011,May,13,1,Monday,0,Clear,0.86,0.7879,0.44,0.0896,133,217,350,581,350,350
3497,2011-05-30,Summer,2011,May,14,1,Monday,0,Clear,0.88,0.803,0.39,0.0,142,185,327,581,327,327
3498,2011-05-30,Summer,2011,May,15,1,Monday,0,Clear,0.88,0.803,0.39,0.2537,132,179,311,581,311,311
3499,2011-05-30,Summer,2011,May,16,1,Monday,0,Clear,0.88,0.7879,0.37,0.2836,101,208,309,581,309,309
3500,2011-05-30,Summer,2011,May,17,1,Monday,0,Clear,0.86,0.7879,0.41,0.2239,102,202,304,581,304,304
3501,2011-05-30,Summer,2011,May,18,1,Monday,0,Clear,0.86,0.7879,0.41,0.1642,77,172,249,581,249,249
3502,2011-05-30,Summer,2011,May,19,1,Monday,0,Misty,0.52,0.5,0.48,0.1045,68,157,225,581,225,225
3503,2011-05-30,Summer,2011,May,20,1,Monday,0,Clear,0.76,0.7121,0.58,0.0,69,168,237,581,237,237
3504,2011-05-30,Summer,2011,May,21,1,Monday,0,Clear,0.74,0.697,0.7,0.1343,42,107,149,581,149,149
3505,2011-05-30,Summer,2011,May,22,1,Monday,0,Clear,0.72,0.697,0.74,0.1642,26,80,106,581,106,106
3506,2011-05-30,Summer,2011,May,23,1,Monday,0,Clear,0.7,0.6667,0.84,0.1045,14,34,48,581,48,48
3507,2011-05-31,Summer,2011,May,0,0,Tuesday,1,Clear,0.7,0.6667,0.79,0.0896,9,20,29,580,29,29
3508,2011-05-31,Summer,2011,May,1,0,Tuesday,1,Clear,0.68,0.6364,0.89,0.0896,8,9,17,580,17,17
3509,2011-05-31,Summer,2011,May,2,0,Tuesday,1,Misty,0.66,0.5909,0.94,0.1343,5,7,12,580,12,12
3510,2011-05-31,Summer,2011,May,3,0,Tuesday,1,Misty,0.64,0.5606,0.94,0.0,1,3,4,580,4,4
3511,2011-05-31,Summer,2011,May,4,0,Tuesday,1,Clear,0.66,0.6061,0.83,0.0896,0,3,3,580,3,3
3512,2011-05-31,Summer,2011,May,5,0,Tuesday,1,Clear,0.66,0.6061,0.83,0.0896,0,26,26,580,26,26
3513,2011-05-31,Summer,2011,May,6,0,Tuesday,1,Clear,0.68,0.6364,0.79,0.0896,11,98,109,580,109,109
3514,2011-05-31,Summer,2011,May,7,0,Tuesday,1,Clear,0.74,0.697,0.66,0.1045,16,219,235,580,235,235
3515,2011-05-31,Summer,2011,May,8,0,Tuesday,1,Clear,0.78,0.7424,0.59,0.1343,34,372,406,580,406,406
3516,2011-05-31,Summer,2011,May,9,0,Tuesday,1,Clear,0.8,0.7576,0.55,0.1343,22,153,175,580,175,175
3517,2011-05-31,Summer,2011,May,10,0,Tuesday,1,Clear,0.82,0.7879,0.56,0.1343,37,72,109,580,109,109
3518,2011-05-31,Summer,2011,May,11,0,Tuesday,1,Clear,0.86,0.803,0.47,0.0,28,78,106,580,106,106
3519,2011-05-31,Summer,2011,May,12,0,Tuesday,1,Clear,0.86,0.803,0.47,0.1343,37,125,162,580,162,162
3520,2011-05-31,Summer,2011,May,13,0,Tuesday,1,Clear,0.9,0.8333,0.39,0.1642,37,110,147,580,147,147
3521,2011-05-31,Summer,2011,May,14,0,Tuesday,1,Clear,0.9,0.8182,0.37,0.0,41,99,140,580,140,140
3522,2011-05-31,Summer,2011,May,15,0,Tuesday,1,Clear,0.9,0.8182,0.37,0.1642,42,133,175,580,175,175
3523,2011-05-31,Summer,2011,May,16,0,Tuesday,1,Clear,0.9,0.8333,0.39,0.1343,44,205,249,580,249,249
3524,2011-05-31,Summer,2011,May,17,0,Tuesday,1,Clear,0.84,0.803,0.53,0.2239,67,428,495,580,495,495
3525,2011-05-31,Summer,2011,May,18,0,Tuesday,1,Clear,0.84,0.803,0.53,0.194,55,362,417,580,417,417
3526,2011-05-31,Summer,2011,May,19,0,Tuesday,1,Clear,0.78,0.7424,0.62,0.1045,39,246,285,580,285,285
3527,2011-05-31,Summer,2011,May,20,0,Tuesday,1,Clear,0.78,0.7424,0.62,0.1045,38,213,251,580,251,251
3528,2011-05-31,Summer,2011,May,21,0,Tuesday,1,Clear,0.76,0.7273,0.66,0.1045,45,165,210,580,210,210
3529,2011-05-31,Summer,2011,May,22,0,Tuesday,1,Clear,0.74,0.697,0.7,0.1642,42,117,159,580,159,159
3530,2011-05-31,Summer,2011,May,23,0,Tuesday,1,Clear,0.72,0.697,0.79,0.0896,15,46,61,580,61,61
3531,2011-06-01,Summer,2011,Jun,0,0,Wednesday,1,Clear,0.7,0.6667,0.79,0.1642,9,25,34,579,34,34
3532,2011-06-01,Summer,2011,Jun,1,0,Wednesday,1,Clear,0.7,0.6667,0.84,0.2537,8,9,17,579,17,17
3533,2011-06-01,Summer,2011,Jun,2,0,Wednesday,1,Clear,0.7,0.6667,0.79,0.1642,0,3,3,579,3,3
3534,2011-06-01,Summer,2011,Jun,3,0,Wednesday,1,Clear,0.68,0.6364,0.89,0.194,0,6,6,579,6,6
3535,2011-06-01,Summer,2011,Jun,4,0,Wednesday,1,Misty,0.68,0.6364,0.89,0.2239,0,4,4,579,4,4
3536,2011-06-01,Summer,2011,Jun,5,0,Wednesday,1,Misty,0.66,0.5909,0.89,0.0896,2,19,21,579,21,21
3537,2011-06-01,Summer,2011,Jun,6,0,Wednesday,1,Misty,0.68,0.6364,0.89,0.0896,7,121,128,579,128,128
3538,2011-06-01,Summer,2011,Jun,7,0,Wednesday,1,Misty,0.7,0.6667,0.79,0.1642,19,265,284,579,284,284
3539,2011-06-01,Summer,2011,Jun,8,0,Wednesday,1,Misty,0.72,0.697,0.79,0.194,37,417,454,579,454,454
3540,2011-06-01,Summer,2011,Jun,9,0,Wednesday,1,Misty,0.74,0.7121,0.74,0.2239,34,173,207,579,207,207
3541,2011-06-01,Summer,2011,Jun,10,0,Wednesday,1,Misty,0.76,0.7424,0.75,0.2537,31,84,115,579,115,115
3542,2011-06-01,Summer,2011,Jun,11,0,Wednesday,1,Misty,0.82,0.803,0.59,0.2239,26,86,112,579,112,112
3543,2011-06-01,Summer,2011,Jun,12,0,Wednesday,1,Clear,0.86,0.8333,0.53,0.0,32,137,169,579,169,169
3544,2011-06-01,Summer,2011,Jun,13,0,Wednesday,1,Clear,0.9,0.8182,0.37,0.194,29,125,154,579,154,154
3545,2011-06-01,Summer,2011,Jun,14,0,Wednesday,1,Clear,0.9,0.8182,0.37,0.2537,40,105,145,579,145,145
3546,2011-06-01,Summer,2011,Jun,15,0,Wednesday,1,Clear,0.9,0.8333,0.39,0.2985,25,127,152,579,152,152
3547,2011-06-01,Summer,2011,Jun,16,0,Wednesday,1,Clear,0.86,0.803,0.47,0.2985,39,227,266,579,266,266
3548,2011-06-01,Summer,2011,Jun,17,0,Wednesday,1,Clear,0.86,0.803,0.47,0.2985,52,434,486,579,486,486
3549,2011-06-01,Summer,2011,Jun,18,0,Wednesday,1,Light_rainsnow,0.82,0.7879,0.56,0.3881,31,278,309,579,309,309
3550,2011-06-01,Summer,2011,Jun,19,0,Wednesday,1,Misty,0.74,0.7121,0.79,0.1642,16,248,264,579,264,264
3551,2011-06-01,Summer,2011,Jun,20,0,Wednesday,1,Misty,0.74,0.7121,0.79,0.2537,23,233,256,579,256,256
3552,2011-06-01,Summer,2011,Jun,21,0,Wednesday,1,Clear,0.74,0.697,0.7,0.2836,29,161,190,579,190,190
3553,2011-06-01,Summer,2011,Jun,22,0,Wednesday,1,Clear,0.74,0.697,0.66,0.1343,14,115,129,579,129,129
3554,2011-06-01,Summer,2011,Jun,23,0,Wednesday,1,Clear,0.74,0.6667,0.51,0.1642,10,59,69,579,69,69
3555,2011-06-02,Summer,2011,Jun,0,0,Thursday,1,Clear,0.74,0.6515,0.4,0.3582,11,31,42,578,42,42
3556,2011-06-02,Summer,2011,Jun,1,0,Thursday,1,Clear,0.72,0.6515,0.38,0.1045,3,12,15,578,15,15
3557,2011-06-02,Summer,2011,Jun,2,0,Thursday,1,Clear,0.7,0.6364,0.39,0.0,0,6,6,578,6,6
3558,2011-06-02,Summer,2011,Jun,3,0,Thursday,1,Clear,0.66,0.6212,0.44,0.1045,0,4,4,578,4,4
3559,2011-06-02,Summer,2011,Jun,4,0,Thursday,1,Clear,0.66,0.6212,0.41,0.194,0,3,3,578,3,3
3560,2011-06-02,Summer,2011,Jun,5,0,Thursday,1,Clear,0.66,0.6212,0.39,0.2239,3,28,31,578,31,31
3561,2011-06-02,Summer,2011,Jun,6,0,Thursday,1,Clear,0.66,0.6212,0.39,0.1343,7,106,113,578,113,113
3562,2011-06-02,Summer,2011,Jun,7,0,Thursday,1,Clear,0.7,0.6364,0.34,0.2537,19,285,304,578,304,304
3563,2011-06-02,Summer,2011,Jun,8,0,Thursday,1,Clear,0.7,0.6364,0.32,0.2985,25,442,467,578,467,467
3564,2011-06-02,Summer,2011,Jun,9,0,Thursday,1,Clear,0.72,0.6364,0.26,0.3582,28,197,225,578,225,225
3565,2011-06-02,Summer,2011,Jun,10,0,Thursday,1,Clear,0.72,0.6515,0.28,0.4925,33,106,139,578,139,139
3566,2011-06-02,Summer,2011,Jun,11,0,Thursday,1,Clear,0.74,0.6515,0.28,0.3881,42,123,165,578,165,165
3567,2011-06-02,Summer,2011,Jun,12,0,Thursday,1,Clear,0.76,0.6667,0.25,0.4627,39,193,232,578,232,232
3568,2011-06-02,Summer,2011,Jun,13,0,Thursday,1,Clear,0.8,0.6818,0.24,0.3582,35,168,203,578,203,203
3569,2011-06-02,Summer,2011,Jun,14,0,Thursday,1,Clear,0.78,0.6667,0.24,0.3284,43,142,185,578,185,185
3570,2011-06-02,Summer,2011,Jun,15,0,Thursday,1,Clear,0.8,0.6818,0.21,0.3881,44,144,188,578,188,188
3571,2011-06-02,Summer,2011,Jun,16,0,Thursday,1,Clear,0.8,0.6818,0.22,0.4925,63,255,318,578,318,318
3572,2011-06-02,Summer,2011,Jun,17,0,Thursday,1,Clear,0.76,0.6515,0.2,0.5224,88,484,572,578,572,572
3573,2011-06-02,Summer,2011,Jun,18,0,Thursday,1,Clear,0.74,0.6515,0.22,0.3881,74,451,525,578,525,525
3574,2011-06-02,Summer,2011,Jun,19,0,Thursday,1,Clear,0.72,0.6364,0.23,0.2985,58,321,379,578,379,379
3575,2011-06-02,Summer,2011,Jun,20,0,Thursday,1,Clear,0.7,0.6364,0.24,0.194,51,286,337,578,337,337
3576,2011-06-02,Summer,2011,Jun,21,0,Thursday,1,Clear,0.66,0.6212,0.31,0.194,33,215,248,578,248,248
3577,2011-06-02,Summer,2011,Jun,22,0,Thursday,1,Clear,0.64,0.6212,0.33,0.2537,14,141,155,578,155,155
3578,2011-06-02,Summer,2011,Jun,23,0,Thursday,1,Clear,0.62,0.6212,0.35,0.2239,23,89,112,578,112,112
3579,2011-06-03,Summer,2011,Jun,0,0,Friday,1,Clear,0.62,0.6212,0.38,0.2836,15,53,68,577,68,68
3580,2011-06-03,Summer,2011,Jun,1,0,Friday,1,Clear,0.6,0.6212,0.38,0.3582,7,15,22,577,22,22
3581,2011-06-03,Summer,2011,Jun,2,0,Friday,1,Clear,0.56,0.5303,0.43,0.2239,0,12,12,577,12,12
3582,2011-06-03,Summer,2011,Jun,3,0,Friday,1,Clear,0.54,0.5152,0.49,0.2239,0,5,5,577,5,5
3583,2011-06-03,Summer,2011,Jun,4,0,Friday,1,Clear,0.52,0.5,0.48,0.3284,1,5,6,577,6,6
3584,2011-06-03,Summer,2011,Jun,5,0,Friday,1,Clear,0.52,0.5,0.48,0.3582,4,24,28,577,28,28
3585,2011-06-03,Summer,2011,Jun,6,0,Friday,1,Clear,0.54,0.5152,0.45,0.2985,8,98,106,577,106,106
3586,2011-06-03,Summer,2011,Jun,7,0,Friday,1,Clear,0.54,0.5152,0.45,0.2537,25,252,277,577,277,277
3587,2011-06-03,Summer,2011,Jun,8,0,Friday,1,Misty,0.56,0.5303,0.43,0.3284,31,471,502,577,502,502
3588,2011-06-03,Summer,2011,Jun,9,0,Friday,1,Clear,0.58,0.5455,0.4,0.1642,36,194,230,577,230,230
3589,2011-06-03,Summer,2011,Jun,10,0,Friday,1,Clear,0.62,0.6212,0.33,0.2537,54,107,161,577,161,161
3590,2011-06-03,Summer,2011,Jun,11,0,Friday,1,Clear,0.64,0.6212,0.31,0.3284,57,135,192,577,192,192
3591,2011-06-03,Summer,2011,Jun,12,0,Friday,1,Clear,0.66,0.6212,0.27,0.2836,51,208,259,577,259,259
3592,2011-06-03,Summer,2011,Jun,13,0,Friday,1,Clear,0.68,0.6212,0.26,0.2537,58,190,248,577,248,248
3593,2011-06-03,Summer,2011,Jun,14,0,Friday,1,Clear,0.7,0.6364,0.28,0.2836,66,174,240,577,240,240
3594,2011-06-03,Summer,2011,Jun,15,0,Friday,1,Clear,0.7,0.6364,0.28,0.2836,56,156,212,577,212,212
3595,2011-06-03,Summer,2011,Jun,16,0,Friday,1,Clear,0.72,0.6364,0.26,0.3284,63,286,349,577,349,349
3596,2011-06-03,Summer,2011,Jun,17,0,Friday,1,Clear,0.72,0.6364,0.25,0.2836,73,485,558,577,558,558
3597,2011-06-03,Summer,2011,Jun,18,0,Friday,1,Clear,0.7,0.6364,0.24,0.2985,76,488,564,577,564,564
3598,2011-06-03,Summer,2011,Jun,19,0,Friday,1,Clear,0.68,0.6212,0.26,0.2836,53,338,391,577,391,391
3599,2011-06-03,Summer,2011,Jun,20,0,Friday,1,Clear,0.64,0.6212,0.29,0.1642,57,236,293,577,293,293
3600,2011-06-03,Summer,2011,Jun,21,0,Friday,1,Clear,0.64,0.6212,0.29,0.1045,51,196,247,577,247,247
3601,2011-06-03,Summer,2011,Jun,22,0,Friday,1,Clear,0.62,0.6212,0.35,0.0,26,145,171,577,171,171
3602,2011-06-03,Summer,2011,Jun,23,0,Friday,1,Clear,0.58,0.5455,0.46,0.1045,30,141,171,577,171,171
3603,2011-06-04,Summer,2011,Jun,0,0,Saturday,0,Clear,0.56,0.5303,0.52,0.0,24,69,93,576,93,93
3604,2011-06-04,Summer,2011,Jun,1,0,Saturday,0,Clear,0.54,0.5152,0.64,0.1045,14,80,94,576,94,94
3605,2011-06-04,Summer,2011,Jun,2,0,Saturday,0,Clear,0.54,0.5152,0.56,0.194,18,41,59,576,59,59
3606,2011-06-04,Summer,2011,Jun,3,0,Saturday,0,Clear,0.52,0.5,0.59,0.1045,8,10,18,576,18,18
3607,2011-06-04,Summer,2011,Jun,4,0,Saturday,0,Clear,0.52,0.5,0.59,0.0896,4,11,15,576,15,15
3608,2011-06-04,Summer,2011,Jun,5,0,Saturday,0,Clear,0.5,0.4848,0.64,0.0,3,5,8,576,8,8
3609,2011-06-04,Summer,2011,Jun,6,0,Saturday,0,Clear,0.54,0.5152,0.6,0.0,11,17,28,576,28,28
3610,2011-06-04,Summer,2011,Jun,7,0,Saturday,0,Clear,0.56,0.5303,0.56,0.0,27,60,87,576,87,87
3611,2011-06-04,Summer,2011,Jun,8,0,Saturday,0,Clear,0.6,0.6212,0.46,0.0896,29,96,125,576,125,125
3612,2011-06-04,Summer,2011,Jun,9,0,Saturday,0,Clear,0.62,0.6212,0.43,0.1343,55,169,224,576,224,224
3613,2011-06-04,Summer,2011,Jun,10,0,Saturday,0,Clear,0.64,0.6212,0.38,0.1045,115,202,317,576,317,317
3614,2011-06-04,Summer,2011,Jun,11,0,Saturday,0,Clear,0.66,0.6212,0.36,0.1343,120,249,369,576,369,369
3615,2011-06-04,Summer,2011,Jun,12,0,Saturday,0,Clear,0.7,0.6364,0.32,0.1642,150,270,420,576,420,420
3616,2011-06-04,Summer,2011,Jun,13,0,Saturday,0,Clear,0.74,0.6515,0.28,0.1343,188,268,456,576,456,456
3617,2011-06-04,Summer,2011,Jun,14,0,Saturday,0,Clear,0.74,0.6515,0.33,0.2239,193,258,451,576,451,451
3618,2011-06-04,Summer,2011,Jun,15,0,Saturday,0,Misty,0.74,0.6515,0.27,0.4179,180,224,404,576,404,404
3619,2011-06-04,Summer,2011,Jun,16,0,Saturday,0,Misty,0.72,0.6515,0.3,0.1343,168,272,440,576,440,440
3620,2011-06-04,Summer,2011,Jun,17,0,Saturday,0,Misty,0.72,0.6515,0.34,0.2537,142,202,344,576,344,344
3621,2011-06-04,Summer,2011,Jun,18,0,Saturday,0,Misty,0.74,0.6515,0.3,0.1642,127,214,341,576,341,341
3622,2011-06-04,Summer,2011,Jun,19,0,Saturday,0,Misty,0.7,0.6364,0.39,0.0896,79,206,285,576,285,285
3623,2011-06-04,Summer,2011,Jun,20,0,Saturday,0,Misty,0.7,0.6515,0.48,0.0896,90,149,239,576,239,239
3624,2011-06-04,Summer,2011,Jun,21,0,Saturday,0,Misty,0.66,0.6212,0.47,0.1045,46,139,185,576,185,185
3625,2011-06-04,Summer,2011,Jun,22,0,Saturday,0,Clear,0.64,0.6212,0.57,0.2239,49,141,190,576,190,190
3626,2011-06-04,Summer,2011,Jun,23,0,Saturday,0,Misty,0.64,0.6212,0.57,0.0,29,121,150,576,150,150
3627,2011-06-05,Summer,2011,Jun,0,0,Sunday,0,Clear,0.64,0.6212,0.57,0.0896,23,90,113,575,113,113
3628,2011-06-05,Summer,2011,Jun,1,0,Sunday,0,Misty,0.64,0.6212,0.61,0.1642,26,70,96,575,96,96
3629,2011-06-05,Summer,2011,Jun,2,0,Sunday,0,Misty,0.64,0.6212,0.61,0.1642,16,48,64,575,64,64
3630,2011-06-05,Summer,2011,Jun,3,0,Sunday,0,Misty,0.62,0.6061,0.65,0.1642,22,25,47,575,47,47
3631,2011-06-05,Summer,2011,Jun,4,0,Sunday,0,Misty,0.62,0.6061,0.65,0.1642,4,8,12,575,12,12
3632,2011-06-05,Summer,2011,Jun,5,0,Sunday,0,Misty,0.62,0.6061,0.61,0.1343,1,5,6,575,6,6
3633,2011-06-05,Summer,2011,Jun,6,0,Sunday,0,Misty,0.62,0.6061,0.61,0.1045,10,11,21,575,21,21
3634,2011-06-05,Summer,2011,Jun,7,0,Sunday,0,Misty,0.6,0.5909,0.73,0.2537,8,19,27,575,27,27
3635,2011-06-05,Summer,2011,Jun,8,0,Sunday,0,Misty,0.6,0.5909,0.73,0.2537,24,74,98,575,98,98
3636,2011-06-05,Summer,2011,Jun,9,0,Sunday,0,Misty,0.6,0.5758,0.78,0.194,53,111,164,575,164,164
3637,2011-06-05,Summer,2011,Jun,10,0,Sunday,0,Misty,0.62,0.5909,0.73,0.0896,83,168,251,575,251,251
3638,2011-06-05,Summer,2011,Jun,11,0,Sunday,0,Misty,0.64,0.6061,0.69,0.1045,121,214,335,575,335,335
3639,2011-06-05,Summer,2011,Jun,12,0,Sunday,0,Misty,0.64,0.6061,0.69,0.1045,123,212,335,575,335,335
3640,2011-06-05,Summer,2011,Jun,13,0,Sunday,0,Clear,0.66,0.6212,0.65,0.1045,154,213,367,575,367,367
3641,2011-06-05,Summer,2011,Jun,14,0,Sunday,0,Clear,0.7,0.6515,0.58,0.1642,161,224,385,575,385,385
3642,2011-06-05,Summer,2011,Jun,15,0,Sunday,0,Clear,0.7,0.6515,0.54,0.0,161,256,417,575,417,417
3643,2011-06-05,Summer,2011,Jun,16,0,Sunday,0,Clear,0.72,0.6667,0.51,0.0896,138,260,398,575,398,398
3644,2011-06-05,Summer,2011,Jun,17,0,Sunday,0,Clear,0.74,0.6667,0.51,0.0,126,264,390,575,390,390
3645,2011-06-05,Summer,2011,Jun,18,0,Sunday,0,Clear,0.7,0.6515,0.58,0.1045,124,239,363,575,363,363
3646,2011-06-05,Summer,2011,Jun,19,0,Sunday,0,Clear,0.68,0.6364,0.65,0.1642,108,249,357,575,357,357
3647,2011-06-05,Summer,2011,Jun,20,0,Sunday,0,Clear,0.66,0.6212,0.69,0.194,84,195,279,575,279,279
3648,2011-06-05,Summer,2011,Jun,21,0,Sunday,0,Clear,0.64,0.6061,0.73,0.1642,54,111,165,575,165,165
3649,2011-06-05,Summer,2011,Jun,22,0,Sunday,0,Clear,0.64,0.5909,0.78,0.2239,36,94,130,575,130,130
3650,2011-06-05,Summer,2011,Jun,23,0,Sunday,0,Clear,0.62,0.5909,0.78,0.1343,25,61,86,575,86,86
3651,2011-06-06,Summer,2011,Jun,0,0,Monday,1,Clear,0.62,0.5909,0.78,0.1343,11,18,29,574,29,29
3652,2011-06-06,Summer,2011,Jun,1,0,Monday,1,Clear,0.6,0.5606,0.83,0.1343,9,5,14,574,14,14
3653,2011-06-06,Summer,2011,Jun,2,0,Monday,1,Clear,0.58,0.5455,0.88,0.1045,4,4,8,574,8,8
3654,2011-06-06,Summer,2011,Jun,3,0,Monday,1,Clear,0.58,0.5455,0.88,0.0,2,3,5,574,5,5
3655,2011-06-06,Summer,2011,Jun,4,0,Monday,1,Clear,0.56,0.5303,0.94,0.1045,4,4,8,574,8,8
3656,2011-06-06,Summer,2011,Jun,5,0,Monday,1,Clear,0.56,0.5303,0.88,0.0896,7,24,31,574,31,31
3657,2011-06-06,Summer,2011,Jun,6,0,Monday,1,Clear,0.58,0.5455,0.88,0.0,11,101,112,574,112,112
3658,2011-06-06,Summer,2011,Jun,7,0,Monday,1,Clear,0.62,0.5909,0.78,0.1045,18,281,299,574,299,299
3659,2011-06-06,Summer,2011,Jun,8,0,Monday,1,Clear,0.64,0.6061,0.73,0.0896,28,410,438,574,438,438
3660,2011-06-06,Summer,2011,Jun,9,0,Monday,1,Clear,0.7,0.6515,0.58,0.1642,26,162,188,574,188,188
3661,2011-06-06,Summer,2011,Jun,10,0,Monday,1,Clear,0.72,0.6667,0.51,0.2239,31,64,95,574,95,95
3662,2011-06-06,Summer,2011,Jun,11,0,Monday,1,Clear,0.74,0.6667,0.42,0.1343,39,72,111,574,111,111
3663,2011-06-06,Summer,2011,Jun,12,0,Monday,1,Clear,0.76,0.6667,0.37,0.1642,25,128,153,574,153,153
3664,2011-06-06,Summer,2011,Jun,13,0,Monday,1,Clear,0.78,0.6818,0.35,0.0,28,152,180,574,180,180
3665,2011-06-06,Summer,2011,Jun,14,0,Monday,1,Clear,0.78,0.6818,0.31,0.1343,46,99,145,574,145,145
3666,2011-06-06,Summer,2011,Jun,15,0,Monday,1,Clear,0.8,0.697,0.29,0.194,38,127,165,574,165,165
3667,2011-06-06,Summer,2011,Jun,16,0,Monday,1,Clear,0.76,0.6667,0.33,0.1343,34,233,267,574,267,267
3668,2011-06-06,Summer,2011,Jun,17,0,Monday,1,Clear,0.78,0.6818,0.33,0.2836,63,516,579,574,579,579
3669,2011-06-06,Summer,2011,Jun,18,0,Monday,1,Clear,0.76,0.6667,0.31,0.1343,56,500,556,574,556,556
3670,2011-06-06,Summer,2011,Jun,19,0,Monday,1,Clear,0.72,0.6667,0.54,0.194,64,343,407,574,407,407
3671,2011-06-06,Summer,2011,Jun,20,0,Monday,1,Clear,0.68,0.6364,0.61,0.1343,59,277,336,574,336,336
3672,2011-06-06,Summer,2011,Jun,21,0,Monday,1,Clear,0.66,0.6212,0.57,0.0896,29,160,189,574,189,189
3673,2011-06-06,Summer,2011,Jun,22,0,Monday,1,Clear,0.66,0.6212,0.61,0.0896,36,137,173,574,173,173
3674,2011-06-06,Summer,2011,Jun,23,0,Monday,1,Clear,0.64,0.6061,0.69,0.0896,5,55,60,574,60,60
3675,2011-06-07,Summer,2011,Jun,0,0,Tuesday,1,Clear,0.64,0.6061,0.65,0.0896,5,15,20,573,20,20
3676,2011-06-07,Summer,2011,Jun,1,0,Tuesday,1,Clear,0.62,0.6061,0.69,0.1343,2,2,4,573,4,4
3677,2011-06-07,Summer,2011,Jun,2,0,Tuesday,1,Clear,0.6,0.5909,0.73,0.0896,3,2,5,573,5,5
3678,2011-06-07,Summer,2011,Jun,3,0,Tuesday,1,Clear,0.6,0.5909,0.73,0.0896,1,1,2,573,2,2
3679,2011-06-07,Summer,2011,Jun,4,0,Tuesday,1,Clear,0.58,0.5455,0.83,0.1343,2,3,5,573,5,5
3680,2011-06-07,Summer,2011,Jun,5,0,Tuesday,1,Clear,0.58,0.5455,0.88,0.1642,2,30,32,573,32,32
3681,2011-06-07,Summer,2011,Jun,6,0,Tuesday,1,Clear,0.6,0.5758,0.78,0.1343,10,116,126,573,126,126
3682,2011-06-07,Summer,2011,Jun,7,0,Tuesday,1,Misty,0.64,0.6061,0.69,0.194,23,311,334,573,334,334
3683,2011-06-07,Summer,2011,Jun,8,0,Tuesday,1,Misty,0.68,0.6364,0.61,0.1343,45,432,477,573,477,477
3684,2011-06-07,Summer,2011,Jun,9,0,Tuesday,1,Misty,0.72,0.6667,0.58,0.2239,27,190,217,573,217,217
3685,2011-06-07,Summer,2011,Jun,10,0,Tuesday,1,Misty,0.76,0.6818,0.48,0.194,37,86,123,573,123,123
3686,2011-06-07,Summer,2011,Jun,11,0,Tuesday,1,Misty,0.76,0.697,0.52,0.2537,38,113,151,573,151,151
3687,2011-06-07,Summer,2011,Jun,12,0,Tuesday,1,Misty,0.8,0.7273,0.46,0.2836,42,141,183,573,183,183
3688,2011-06-07,Summer,2011,Jun,13,0,Tuesday,1,Misty,0.8,0.7273,0.43,0.2537,55,141,196,573,196,196
3689,2011-06-07,Summer,2011,Jun,14,0,Tuesday,1,Misty,0.8,0.7273,0.43,0.2836,34,112,146,573,146,146
3690,2011-06-07,Summer,2011,Jun,15,0,Tuesday,1,Misty,0.82,0.7424,0.41,0.3284,56,127,183,573,183,183
3691,2011-06-07,Summer,2011,Jun,16,0,Tuesday,1,Clear,0.8,0.7121,0.38,0.2239,55,253,308,573,308,308
3692,2011-06-07,Summer,2011,Jun,17,0,Tuesday,1,Clear,0.8,0.7273,0.43,0.2537,64,475,539,573,539,539
3693,2011-06-07,Summer,2011,Jun,18,0,Tuesday,1,Clear,0.78,0.697,0.46,0.2836,72,479,551,573,551,551
3694,2011-06-07,Summer,2011,Jun,19,0,Tuesday,1,Clear,0.76,0.6818,0.48,0.2537,69,355,424,573,424,424
3695,2011-06-07,Summer,2011,Jun,20,0,Tuesday,1,Clear,0.74,0.6818,0.56,0.1343,45,301,346,573,346,346
3696,2011-06-07,Summer,2011,Jun,21,0,Tuesday,1,Clear,0.72,0.6818,0.7,0.1343,31,187,218,573,218,218
3697,2011-06-07,Summer,2011,Jun,22,0,Tuesday,1,Clear,0.7,0.6515,0.65,0.1343,27,126,153,573,153,153
3698,2011-06-07,Summer,2011,Jun,23,0,Tuesday,1,Clear,0.68,0.6364,0.79,0.1045,18,72,90,573,90,90
3699,2011-06-08,Summer,2011,Jun,0,0,Wednesday,1,Clear,0.66,0.5909,0.89,0.1343,12,29,41,572,41,41
3700,2011-06-08,Summer,2011,Jun,1,0,Wednesday,1,Clear,0.66,0.6061,0.78,0.0,3,20,23,572,23,23
3701,2011-06-08,Summer,2011,Jun,2,0,Wednesday,1,Clear,0.64,0.5758,0.89,0.0896,0,7,7,572,7,7
3702,2011-06-08,Summer,2011,Jun,3,0,Wednesday,1,Clear,0.64,0.5758,0.89,0.0896,2,1,3,572,3,3
3703,2011-06-08,Summer,2011,Jun,4,0,Wednesday,1,Clear,0.62,0.5758,0.83,0.0,0,6,6,572,6,6
3704,2011-06-08,Summer,2011,Jun,5,0,Wednesday,1,Clear,0.62,0.5606,0.88,0.0,0,21,21,572,21,21
3705,2011-06-08,Summer,2011,Jun,6,0,Wednesday,1,Clear,0.64,0.5758,0.89,0.1343,13,103,116,572,116,116
3706,2011-06-08,Summer,2011,Jun,7,0,Wednesday,1,Clear,0.66,0.6212,0.74,0.1045,24,329,353,572,353,353
3707,2011-06-08,Summer,2011,Jun,8,0,Wednesday,1,Clear,0.76,0.7121,0.58,0.1642,46,435,481,572,481,481
3708,2011-06-08,Summer,2011,Jun,9,0,Wednesday,1,Clear,0.76,0.7121,0.58,0.1642,34,168,202,572,202,202
3709,2011-06-08,Summer,2011,Jun,10,0,Wednesday,1,Clear,0.82,0.7424,0.43,0.2239,27,63,90,572,90,90
3710,2011-06-08,Summer,2011,Jun,11,0,Wednesday,1,Clear,0.84,0.7576,0.41,0.194,28,106,134,572,134,134
3711,2011-06-08,Summer,2011,Jun,12,0,Wednesday,1,Clear,0.88,0.8182,0.42,0.1343,15,134,149,572,149,149
3712,2011-06-08,Summer,2011,Jun,13,0,Wednesday,1,Clear,0.9,0.8485,0.42,0.0,20,116,136,572,136,136
3713,2011-06-08,Summer,2011,Jun,14,0,Wednesday,1,Clear,0.92,0.8788,0.4,0.2537,44,111,155,572,155,155
3714,2011-06-08,Summer,2011,Jun,15,0,Wednesday,1,Clear,0.92,0.8788,0.4,0.1642,28,100,128,572,128,128
3715,2011-06-08,Summer,2011,Jun,16,0,Wednesday,1,Clear,0.92,0.8788,0.4,0.2239,34,199,233,572,233,233
3716,2011-06-08,Summer,2011,Jun,17,0,Wednesday,1,Clear,0.92,0.8485,0.35,0.2239,80,426,506,572,506,506
3717,2011-06-08,Summer,2011,Jun,18,0,Wednesday,1,Clear,0.9,0.8182,0.37,0.2239,61,398,459,572,459,459
3718,2011-06-08,Summer,2011,Jun,19,0,Wednesday,1,Clear,0.82,0.803,0.59,0.1343,61,323,384,572,384,384
3719,2011-06-08,Summer,2011,Jun,20,0,Wednesday,1,Clear,0.8,0.7879,0.63,0.1343,55,225,280,572,280,280
3720,2011-06-08,Summer,2011,Jun,21,0,Wednesday,1,Clear,0.8,0.803,0.66,0.1343,34,168,202,572,202,202
3721,2011-06-08,Summer,2011,Jun,22,0,Wednesday,1,Clear,0.76,0.7424,0.75,0.1642,37,139,176,572,176,176
3722,2011-06-08,Summer,2011,Jun,23,0,Wednesday,1,Clear,0.76,0.7424,0.75,0.194,18,98,116,572,116,116
3723,2011-06-09,Summer,2011,Jun,0,0,Thursday,1,Misty,0.74,0.7121,0.79,0.1343,7,40,47,571,47,47
3724,2011-06-09,Summer,2011,Jun,1,0,Thursday,1,Clear,0.74,0.7121,0.79,0.1045,3,13,16,571,16,16
3725,2011-06-09,Summer,2011,Jun,2,0,Thursday,1,Misty,0.72,0.7121,0.84,0.1642,0,6,6,571,6,6
3726,2011-06-09,Summer,2011,Jun,3,0,Thursday,1,Misty,0.72,0.7121,0.84,0.1045,0,2,2,571,2,2
3727,2011-06-09,Summer,2011,Jun,4,0,Thursday,1,Misty,0.72,0.697,0.79,0.0896,2,4,6,571,6,6
3728,2011-06-09,Summer,2011,Jun,5,0,Thursday,1,Misty,0.7,0.6667,0.84,0.0,1,19,20,571,20,20
3729,2011-06-09,Summer,2011,Jun,6,0,Thursday,1,Misty,0.72,0.7121,0.84,0.0896,13,105,118,571,118,118
3730,2011-06-09,Summer,2011,Jun,7,0,Thursday,1,Misty,0.72,0.697,0.79,0.1343,31,283,314,571,314,314
3731,2011-06-09,Summer,2011,Jun,8,0,Thursday,1,Misty,0.76,0.7273,0.7,0.1045,32,400,432,571,432,432
3732,2011-06-09,Summer,2011,Jun,9,0,Thursday,1,Clear,0.84,0.7879,0.49,0.0,20,148,168,571,168,168
3733,2011-06-09,Summer,2011,Jun,10,0,Thursday,1,Clear,0.86,0.8182,0.5,0.2836,20,74,94,571,94,94
3734,2011-06-09,Summer,2011,Jun,11,0,Thursday,1,Clear,0.9,0.8485,0.42,0.2239,36,82,118,571,118,118
3735,2011-06-09,Summer,2011,Jun,12,0,Thursday,1,Clear,0.92,0.8485,0.35,0.194,40,100,140,571,140,140
3736,2011-06-09,Summer,2011,Jun,13,0,Thursday,1,Clear,0.9,0.8182,0.37,0.0896,18,118,136,571,136,136
3737,2011-06-09,Summer,2011,Jun,14,0,Thursday,1,Clear,0.92,0.8788,0.4,0.194,25,93,118,571,118,118
3738,2011-06-09,Summer,2011,Jun,15,0,Thursday,1,Clear,0.94,0.8333,0.31,0.1642,18,86,104,571,104,104
3739,2011-06-09,Summer,2011,Jun,16,0,Thursday,1,Clear,0.92,0.8333,0.33,0.1343,30,170,200,571,200,200
3740,2011-06-09,Summer,2011,Jun,17,0,Thursday,1,Clear,0.9,0.8182,0.37,0.2537,54,355,409,571,409,409
3741,2011-06-09,Summer,2011,Jun,18,0,Thursday,1,Clear,0.88,0.803,0.39,0.2836,52,414,466,571,466,466
3742,2011-06-09,Summer,2011,Jun,19,0,Thursday,1,Misty,0.84,0.7424,0.39,0.3284,55,271,326,571,326,326
3743,2011-06-09,Summer,2011,Jun,20,0,Thursday,1,Misty,0.8,0.7273,0.43,0.194,40,214,254,571,254,254
3744,2011-06-09,Summer,2011,Jun,21,0,Thursday,1,Light_rainsnow,0.76,0.697,0.52,0.0,29,142,171,571,171,171
3745,2011-06-09,Summer,2011,Jun,22,0,Thursday,1,Misty,0.74,0.6818,0.58,0.1642,22,131,153,571,153,153
3746,2011-06-09,Summer,2011,Jun,23,0,Thursday,1,Misty,0.74,0.697,0.57,0.1642,15,82,97,571,97,97
3747,2011-06-10,Summer,2011,Jun,0,0,Friday,1,Light_rainsnow,0.7,0.6515,0.65,0.2239,8,61,69,570,69,69
3748,2011-06-10,Summer,2011,Jun,1,0,Friday,1,Light_rainsnow,0.7,0.6515,0.65,0.2239,5,18,23,570,23,23
3749,2011-06-10,Summer,2011,Jun,2,0,Friday,1,Clear,0.68,0.6364,0.69,0.1642,6,7,13,570,13,13
3750,2011-06-10,Summer,2011,Jun,3,0,Friday,1,Clear,0.68,0.6364,0.69,0.1642,3,3,6,570,6,6
3751,2011-06-10,Summer,2011,Jun,4,0,Friday,1,Clear,0.66,0.6061,0.78,0.1642,0,4,4,570,4,4
3752,2011-06-10,Summer,2011,Jun,5,0,Friday,1,Clear,0.66,0.6061,0.78,0.1642,0,28,28,570,28,28
3753,2011-06-10,Summer,2011,Jun,6,0,Friday,1,Clear,0.66,0.6061,0.78,0.0896,10,94,104,570,104,104
3754,2011-06-10,Summer,2011,Jun,7,0,Friday,1,Clear,0.72,0.6818,0.66,0.1045,25,242,267,570,267,267
3755,2011-06-10,Summer,2011,Jun,8,0,Friday,1,Clear,0.74,0.6818,0.58,0.1343,29,423,452,570,452,452
3756,2011-06-10,Summer,2011,Jun,9,0,Friday,1,Clear,0.76,0.697,0.55,0.0,37,176,213,570,213,213
3757,2011-06-10,Summer,2011,Jun,10,0,Friday,1,Clear,0.78,0.7121,0.52,0.0,23,88,111,570,111,111
3758,2011-06-10,Summer,2011,Jun,11,0,Friday,1,Clear,0.82,0.7576,0.46,0.0,46,107,153,570,153,153
3759,2011-06-10,Summer,2011,Jun,12,0,Friday,1,Clear,0.84,0.7576,0.44,0.1343,40,167,207,570,207,207
3760,2011-06-10,Summer,2011,Jun,13,0,Friday,1,Clear,0.84,0.7576,0.44,0.1045,40,149,189,570,189,189
3761,2011-06-10,Summer,2011,Jun,14,0,Friday,1,Clear,0.86,0.7727,0.39,0.0,44,121,165,570,165,165
3762,2011-06-10,Summer,2011,Jun,15,0,Friday,1,Clear,0.84,0.7576,0.44,0.1045,49,163,212,570,212,212
3763,2011-06-10,Summer,2011,Jun,16,0,Friday,1,Clear,0.82,0.7879,0.56,0.2985,46,239,285,570,285,285
3764,2011-06-10,Summer,2011,Jun,17,0,Friday,1,Clear,0.82,0.7727,0.52,0.2239,63,454,517,570,517,517
3765,2011-06-10,Summer,2011,Jun,18,0,Friday,1,Clear,0.8,0.7727,0.59,0.2239,96,367,463,570,463,463
3766,2011-06-10,Summer,2011,Jun,19,0,Friday,1,Clear,0.78,0.7424,0.59,0.194,61,245,306,570,306,306
3767,2011-06-10,Summer,2011,Jun,20,0,Friday,1,Clear,0.76,0.7121,0.62,0.1045,53,197,250,570,250,250
3768,2011-06-10,Summer,2011,Jun,21,0,Friday,1,Clear,0.76,0.7273,0.66,0.1343,55,163,218,570,218,218
3769,2011-06-10,Summer,2011,Jun,22,0,Friday,1,Clear,0.72,0.697,0.74,0.2537,40,145,185,570,185,185
3770,2011-06-10,Summer,2011,Jun,23,0,Friday,1,Clear,0.72,0.697,0.74,0.1642,36,110,146,570,146,146
3771,2011-06-11,Summer,2011,Jun,0,0,Saturday,0,Clear,0.7,0.6667,0.79,0.1343,28,89,117,569,117,117
3772,2011-06-11,Summer,2011,Jun,1,0,Saturday,0,Clear,0.7,0.6667,0.79,0.0896,10,67,77,569,77,77
3773,2011-06-11,Summer,2011,Jun,2,0,Saturday,0,Clear,0.7,0.6667,0.79,0.1045,10,50,60,569,60,60
3774,2011-06-11,Summer,2011,Jun,3,0,Saturday,0,Clear,0.68,0.6364,0.83,0.0896,10,18,28,569,28,28
3775,2011-06-11,Summer,2011,Jun,4,0,Saturday,0,Clear,0.68,0.6364,0.79,0.0896,4,9,13,569,13,13
3776,2011-06-11,Summer,2011,Jun,5,0,Saturday,0,Clear,0.68,0.6364,0.74,0.1343,4,12,16,569,16,16
3777,2011-06-11,Summer,2011,Jun,6,0,Saturday,0,Clear,0.7,0.6515,0.61,0.1343,9,31,40,569,40,40
3778,2011-06-11,Summer,2011,Jun,7,0,Saturday,0,Clear,0.72,0.6667,0.58,0.194,18,50,68,569,68,68
3779,2011-06-11,Summer,2011,Jun,8,0,Saturday,0,Clear,0.74,0.6818,0.58,0.194,32,111,143,569,143,143
3780,2011-06-11,Summer,2011,Jun,9,0,Saturday,0,Clear,0.74,0.6818,0.62,0.1343,59,171,230,569,230,230
3781,2011-06-11,Summer,2011,Jun,10,0,Saturday,0,Clear,0.74,0.6818,0.58,0.1642,91,173,264,569,264,264
3782,2011-06-11,Summer,2011,Jun,11,0,Saturday,0,Clear,0.76,0.7121,0.62,0.1343,110,215,325,569,325,325
3783,2011-06-11,Summer,2011,Jun,12,0,Saturday,0,Clear,0.8,0.7576,0.55,0.2239,112,235,347,569,347,347
3784,2011-06-11,Summer,2011,Jun,13,0,Saturday,0,Clear,0.8,0.7576,0.55,0.194,150,237,387,569,387,387
3785,2011-06-11,Summer,2011,Jun,14,0,Saturday,0,Clear,0.82,0.7727,0.49,0.1045,148,232,380,569,380,380
3786,2011-06-11,Summer,2011,Jun,15,0,Saturday,0,Clear,0.82,0.7727,0.49,0.1045,142,232,374,569,374,374
3787,2011-06-11,Summer,2011,Jun,16,0,Saturday,0,Misty,0.8,0.7273,0.46,0.194,169,225,394,569,394,394
3788,2011-06-11,Summer,2011,Jun,17,0,Saturday,0,Misty,0.74,0.6818,0.58,0.1642,147,190,337,569,337,337
3789,2011-06-11,Summer,2011,Jun,18,0,Saturday,0,Misty,0.72,0.6818,0.62,0.1343,131,155,286,569,286,286
3790,2011-06-11,Summer,2011,Jun,19,0,Saturday,0,Clear,0.7,0.6515,0.65,0.194,97,167,264,569,264,264
3791,2011-06-11,Summer,2011,Jun,20,0,Saturday,0,Clear,0.68,0.6364,0.74,0.2537,95,180,275,569,275,275
3792,2011-06-11,Summer,2011,Jun,21,0,Saturday,0,Clear,0.66,0.6212,0.74,0.2239,76,144,220,569,220,220
3793,2011-06-11,Summer,2011,Jun,22,0,Saturday,0,Clear,0.66,0.6061,0.78,0.2239,53,137,190,569,190,190
3794,2011-06-11,Summer,2011,Jun,23,0,Saturday,0,Clear,0.66,0.6212,0.74,0.1045,24,107,131,569,131,131
3795,2011-06-12,Summer,2011,Jun,0,0,Sunday,0,Clear,0.66,0.6061,0.78,0.2239,19,100,119,568,119,119
3796,2011-06-12,Summer,2011,Jun,1,0,Sunday,0,Clear,0.64,0.5758,0.83,0.1045,19,74,93,568,93,93
3797,2011-06-12,Summer,2011,Jun,2,0,Sunday,0,Clear,0.64,0.5758,0.89,0.2537,9,57,66,568,66,66
3798,2011-06-12,Summer,2011,Jun,3,0,Sunday,0,Clear,0.64,0.5758,0.89,0.2836,8,20,28,568,28,28
3799,2011-06-12,Summer,2011,Jun,4,0,Sunday,0,Clear,0.62,0.5606,0.88,0.1642,8,6,14,568,14,14
3800,2011-06-12,Summer,2011,Jun,5,0,Sunday,0,Clear,0.62,0.5606,0.88,0.2239,5,5,10,568,10,10
3801,2011-06-12,Summer,2011,Jun,6,0,Sunday,0,Clear,0.62,0.5606,0.88,0.1045,5,9,14,568,14,14
3802,2011-06-12,Summer,2011,Jun,7,0,Sunday,0,Clear,0.64,0.5909,0.78,0.1045,7,27,34,568,34,34
3803,2011-06-12,Summer,2011,Jun,8,0,Sunday,0,Clear,0.7,0.6667,0.74,0.0,28,64,92,568,92,92
3804,2011-06-12,Summer,2011,Jun,9,0,Sunday,0,Clear,0.72,0.6818,0.66,0.0,75,107,182,568,182,182
3805,2011-06-12,Summer,2011,Jun,10,0,Sunday,0,Clear,0.76,0.7121,0.58,0.0896,120,191,311,568,311,311
3806,2011-06-12,Summer,2011,Jun,11,0,Sunday,0,Clear,0.78,0.7273,0.55,0.1045,131,236,367,568,367,367
3807,2011-06-12,Summer,2011,Jun,12,0,Sunday,0,Clear,0.82,0.7576,0.46,0.0,176,244,420,568,420,420
3808,2011-06-12,Summer,2011,Jun,13,0,Sunday,0,Clear,0.78,0.7424,0.59,0.2836,109,264,373,568,373,373
3809,2011-06-12,Summer,2011,Jun,14,0,Sunday,0,Clear,0.82,0.7879,0.56,0.2537,96,219,315,568,315,315
3810,2011-06-12,Summer,2011,Jun,15,0,Sunday,0,Clear,0.8,0.7727,0.59,0.2985,142,218,360,568,360,360
3811,2011-06-12,Summer,2011,Jun,16,0,Sunday,0,Light_rainsnow,0.68,0.6364,0.83,0.2836,115,235,350,568,350,350
3812,2011-06-12,Summer,2011,Jun,17,0,Sunday,0,Light_rainsnow,0.68,0.6364,0.83,0.2836,94,158,252,568,252,252
3813,2011-06-12,Summer,2011,Jun,18,0,Sunday,0,Clear,0.7,0.6667,0.74,0.1642,69,187,256,568,256,256
3814,2011-06-12,Summer,2011,Jun,19,0,Sunday,0,Clear,0.7,0.6667,0.74,0.1045,67,156,223,568,223,223
3815,2011-06-12,Summer,2011,Jun,20,0,Sunday,0,Clear,0.66,0.6061,0.83,0.1642,62,144,206,568,206,206
3816,2011-06-12,Summer,2011,Jun,21,0,Sunday,0,Clear,0.66,0.6061,0.83,0.1045,39,101,140,568,140,140
3817,2011-06-12,Summer,2011,Jun,22,0,Sunday,0,Clear,0.64,0.5758,0.83,0.1343,31,97,128,568,128,128
3818,2011-06-12,Summer,2011,Jun,23,0,Sunday,0,Clear,0.64,0.5909,0.78,0.194,33,74,107,568,107,107
3819,2011-06-13,Summer,2011,Jun,0,0,Monday,1,Clear,0.64,0.5909,0.78,0.1343,8,20,28,567,28,28
3820,2011-06-13,Summer,2011,Jun,1,0,Monday,1,Clear,0.64,0.6061,0.73,0.2239,6,10,16,567,16,16
3821,2011-06-13,Summer,2011,Jun,2,0,Monday,1,Clear,0.62,0.5909,0.73,0.2836,2,8,10,567,10,10
3822,2011-06-13,Summer,2011,Jun,3,0,Monday,1,Clear,0.6,0.6061,0.6,0.4925,1,6,7,567,7,7
3823,2011-06-13,Summer,2011,Jun,4,0,Monday,1,Clear,0.56,0.5303,0.64,0.2985,1,3,4,567,4,4
3824,2011-06-13,Summer,2011,Jun,5,0,Monday,1,Clear,0.54,0.5152,0.64,0.3881,2,27,29,567,29,29
3825,2011-06-13,Summer,2011,Jun,6,0,Monday,1,Clear,0.54,0.5152,0.64,0.4179,7,98,105,567,105,105
3826,2011-06-13,Summer,2011,Jun,7,0,Monday,1,Clear,0.56,0.5303,0.56,0.3582,26,302,328,567,328,328
3827,2011-06-13,Summer,2011,Jun,8,0,Monday,1,Clear,0.58,0.5455,0.49,0.4478,44,432,476,567,476,476
3828,2011-06-13,Summer,2011,Jun,9,0,Monday,1,Clear,0.62,0.6212,0.46,0.3582,35,189,224,567,224,224
3829,2011-06-13,Summer,2011,Jun,10,0,Monday,1,Clear,0.64,0.6212,0.41,0.3284,38,80,118,567,118,118
3830,2011-06-13,Summer,2011,Jun,11,0,Monday,1,Clear,0.66,0.6212,0.41,0.2985,53,106,159,567,159,159
3831,2011-06-13,Summer,2011,Jun,12,0,Monday,1,Clear,0.66,0.6212,0.41,0.2836,35,161,196,567,196,196
3832,2011-06-13,Summer,2011,Jun,13,0,Monday,1,Clear,0.7,0.6364,0.37,0.0,53,174,227,567,227,227
3833,2011-06-13,Summer,2011,Jun,14,0,Monday,1,Clear,0.7,0.6364,0.34,0.2537,55,145,200,567,200,200
3834,2011-06-13,Summer,2011,Jun,15,0,Monday,1,Clear,0.7,0.6364,0.37,0.4478,58,127,185,567,185,185
3835,2011-06-13,Summer,2011,Jun,16,0,Monday,1,Clear,0.7,0.6364,0.37,0.4179,64,262,326,567,326,326
3836,2011-06-13,Summer,2011,Jun,17,0,Monday,1,Clear,0.7,0.6364,0.39,0.3284,72,529,601,567,601,601
3837,2011-06-13,Summer,2011,Jun,18,0,Monday,1,Clear,0.7,0.6364,0.37,0.3582,76,510,586,567,586,586
3838,2011-06-13,Summer,2011,Jun,19,0,Monday,1,Clear,0.66,0.6212,0.39,0.2836,75,348,423,567,423,423
3839,2011-06-13,Summer,2011,Jun,20,0,Monday,1,Clear,0.64,0.6212,0.44,0.2537,78,253,331,567,331,331
3840,2011-06-13,Summer,2011,Jun,21,0,Monday,1,Clear,0.64,0.6212,0.41,0.2537,40,178,218,567,218,218
3841,2011-06-13,Summer,2011,Jun,22,0,Monday,1,Clear,0.62,0.6212,0.46,0.2239,20,114,134,567,134,134
3842,2011-06-13,Summer,2011,Jun,23,0,Monday,1,Clear,0.62,0.6212,0.46,0.194,14,75,89,567,89,89
3843,2011-06-14,Summer,2011,Jun,0,0,Tuesday,1,Clear,0.6,0.6212,0.49,0.194,13,18,31,566,31,31
3844,2011-06-14,Summer,2011,Jun,1,0,Tuesday,1,Clear,0.6,0.6212,0.49,0.2537,3,10,13,566,13,13
3845,2011-06-14,Summer,2011,Jun,2,0,Tuesday,1,Clear,0.6,0.6212,0.49,0.2836,2,8,10,566,10,10
3846,2011-06-14,Summer,2011,Jun,3,0,Tuesday,1,Clear,0.58,0.5455,0.53,0.3284,1,1,2,566,2,2
3847,2011-06-14,Summer,2011,Jun,4,0,Tuesday,1,Clear,0.54,0.5152,0.6,0.2537,0,3,3,566,3,3
3848,2011-06-14,Summer,2011,Jun,5,0,Tuesday,1,Clear,0.54,0.5152,0.56,0.3284,3,23,26,566,26,26
3849,2011-06-14,Summer,2011,Jun,6,0,Tuesday,1,Clear,0.54,0.5152,0.56,0.2985,6,107,113,566,113,113
3850,2011-06-14,Summer,2011,Jun,7,0,Tuesday,1,Clear,0.56,0.5303,0.52,0.4179,19,346,365,566,365,365
3851,2011-06-14,Summer,2011,Jun,8,0,Tuesday,1,Clear,0.58,0.5455,0.49,0.3881,45,441,486,566,486,486
3852,2011-06-14,Summer,2011,Jun,9,0,Tuesday,1,Clear,0.62,0.6212,0.46,0.194,19,174,193,566,193,193
3853,2011-06-14,Summer,2011,Jun,10,0,Tuesday,1,Clear,0.62,0.6212,0.46,0.2239,33,97,130,566,130,130
3854,2011-06-14,Summer,2011,Jun,11,0,Tuesday,1,Clear,0.64,0.6212,0.41,0.2836,40,103,143,566,143,143
3855,2011-06-14,Summer,2011,Jun,12,0,Tuesday,1,Clear,0.64,0.6212,0.41,0.3582,30,139,169,566,169,169
3856,2011-06-14,Summer,2011,Jun,13,0,Tuesday,1,Clear,0.64,0.6212,0.44,0.2239,33,176,209,566,209,209
3857,2011-06-14,Summer,2011,Jun,14,0,Tuesday,1,Misty,0.64,0.6212,0.47,0.194,41,118,159,566,159,159
3858,2011-06-14,Summer,2011,Jun,15,0,Tuesday,1,Clear,0.64,0.6212,0.47,0.1642,42,136,178,566,178,178
3859,2011-06-14,Summer,2011,Jun,16,0,Tuesday,1,Clear,0.68,0.6364,0.41,0.194,51,279,330,566,330,330
3860,2011-06-14,Summer,2011,Jun,17,0,Tuesday,1,Light_rainsnow,0.64,0.6212,0.5,0.2836,85,484,569,566,569,569
3861,2011-06-14,Summer,2011,Jun,18,0,Tuesday,1,Clear,0.62,0.6212,0.51,0.3284,65,473,538,566,538,538
3862,2011-06-14,Summer,2011,Jun,19,0,Tuesday,1,Clear,0.64,0.6212,0.5,0.3582,51,335,386,566,386,386
3863,2011-06-14,Summer,2011,Jun,20,0,Tuesday,1,Clear,0.6,0.6212,0.56,0.1642,60,237,297,566,297,297
3864,2011-06-14,Summer,2011,Jun,21,0,Tuesday,1,Clear,0.6,0.6212,0.56,0.2985,37,206,243,566,243,243
3865,2011-06-14,Summer,2011,Jun,22,0,Tuesday,1,Clear,0.58,0.5455,0.6,0.2239,29,159,188,566,188,188
3866,2011-06-14,Summer,2011,Jun,23,0,Tuesday,1,Clear,0.56,0.5303,0.68,0.2239,19,91,110,566,110,110
3867,2011-06-15,Summer,2011,Jun,0,0,Wednesday,1,Clear,0.56,0.5303,0.64,0.3582,8,44,52,565,52,52
3868,2011-06-15,Summer,2011,Jun,1,0,Wednesday,1,Clear,0.54,0.5152,0.64,0.2836,0,14,14,565,14,14
3869,2011-06-15,Summer,2011,Jun,2,0,Wednesday,1,Clear,0.52,0.5,0.63,0.2239,0,9,9,565,9,9
3870,2011-06-15,Summer,2011,Jun,3,0,Wednesday,1,Clear,0.5,0.4848,0.68,0.2537,0,1,1,565,1,1
3871,2011-06-15,Summer,2011,Jun,4,0,Wednesday,1,Clear,0.5,0.4848,0.63,0.2836,0,4,4,565,4,4
3872,2011-06-15,Summer,2011,Jun,5,0,Wednesday,1,Clear,0.48,0.4697,0.67,0.2836,1,20,21,565,21,21
3873,2011-06-15,Summer,2011,Jun,6,0,Wednesday,1,Clear,0.5,0.4848,0.63,0.2537,11,110,121,565,121,121
3874,2011-06-15,Summer,2011,Jun,7,0,Wednesday,1,Clear,0.54,0.5152,0.6,0.1343,22,348,370,565,370,370
3875,2011-06-15,Summer,2011,Jun,8,0,Wednesday,1,Clear,0.58,0.5455,0.53,0.1343,53,445,498,565,498,498
3876,2011-06-15,Summer,2011,Jun,9,0,Wednesday,1,Clear,0.6,0.6212,0.49,0.0,22,185,207,565,207,207
3877,2011-06-15,Summer,2011,Jun,10,0,Wednesday,1,Clear,0.64,0.6212,0.47,0.1642,27,108,135,565,135,135
3878,2011-06-15,Summer,2011,Jun,11,0,Wednesday,1,Clear,0.68,0.6364,0.36,0.0,49,115,164,565,164,164
3879,2011-06-15,Summer,2011,Jun,12,0,Wednesday,1,Clear,0.7,0.6364,0.34,0.2239,33,178,211,565,211,211
3880,2011-06-15,Summer,2011,Jun,13,0,Wednesday,1,Clear,0.74,0.6515,0.28,0.2836,43,146,189,565,189,189
3881,2011-06-15,Summer,2011,Jun,14,0,Wednesday,1,Clear,0.74,0.6515,0.28,0.0,50,128,178,565,178,178
3882,2011-06-15,Summer,2011,Jun,15,0,Wednesday,1,Clear,0.76,0.6667,0.27,0.0,33,131,164,565,164,164
3883,2011-06-15,Summer,2011,Jun,16,0,Wednesday,1,Clear,0.76,0.6667,0.27,0.1343,47,265,312,565,312,312
3884,2011-06-15,Summer,2011,Jun,17,0,Wednesday,1,Clear,0.74,0.6515,0.28,0.1045,83,555,638,565,638,638
3885,2011-06-15,Summer,2011,Jun,18,0,Wednesday,1,Clear,0.72,0.6515,0.32,0.1343,80,527,607,565,607,607
3886,2011-06-15,Summer,2011,Jun,19,0,Wednesday,1,Clear,0.7,0.6364,0.37,0.2836,54,362,416,565,416,416
3887,2011-06-15,Summer,2011,Jun,20,0,Wednesday,1,Clear,0.66,0.6212,0.44,0.1642,57,273,330,565,330,330
3888,2011-06-15,Summer,2011,Jun,21,0,Wednesday,1,Clear,0.64,0.6212,0.47,0.2239,48,209,257,565,257,257
3889,2011-06-15,Summer,2011,Jun,22,0,Wednesday,1,Clear,0.62,0.6212,0.5,0.1045,31,144,175,565,175,175
3890,2011-06-15,Summer,2011,Jun,23,0,Wednesday,1,Clear,0.62,0.6212,0.53,0.0,17,90,107,565,107,107
3891,2011-06-16,Summer,2011,Jun,0,0,Thursday,1,Clear,0.6,0.6212,0.56,0.1045,9,38,47,564,47,47
3892,2011-06-16,Summer,2011,Jun,1,0,Thursday,1,Clear,0.58,0.5455,0.6,0.0,4,13,17,564,17,17
3893,2011-06-16,Summer,2011,Jun,2,0,Thursday,1,Clear,0.6,0.6212,0.56,0.0896,1,4,5,564,5,5
3894,2011-06-16,Summer,2011,Jun,3,0,Thursday,1,Misty,0.56,0.5303,0.73,0.0896,0,4,4,564,4,4
3895,2011-06-16,Summer,2011,Jun,4,0,Thursday,1,Misty,0.56,0.5303,0.68,0.1045,0,6,6,564,6,6
3896,2011-06-16,Summer,2011,Jun,5,0,Thursday,1,Clear,0.6,0.6061,0.64,0.194,7,18,25,564,25,25
3897,2011-06-16,Summer,2011,Jun,6,0,Thursday,1,Light_rainsnow,0.58,0.5455,0.73,0.1642,8,104,112,564,112,112
3898,2011-06-16,Summer,2011,Jun,7,0,Thursday,1,Light_rainsnow,0.56,0.5303,0.78,0.1642,16,172,188,564,188,188
3899,2011-06-16,Summer,2011,Jun,8,0,Thursday,1,Misty,0.6,0.5909,0.69,0.1343,24,364,388,564,388,388
3900,2011-06-16,Summer,2011,Jun,9,0,Thursday,1,Misty,0.62,0.6061,0.65,0.194,29,232,261,564,261,261
3901,2011-06-16,Summer,2011,Jun,10,0,Thursday,1,Misty,0.66,0.6212,0.61,0.2537,18,103,121,564,121,121
3902,2011-06-16,Summer,2011,Jun,11,0,Thursday,1,Misty,0.68,0.6364,0.61,0.2985,33,117,150,564,150,150
3903,2011-06-16,Summer,2011,Jun,12,0,Thursday,1,Clear,0.72,0.6667,0.54,0.3881,41,165,206,564,206,206
3904,2011-06-16,Summer,2011,Jun,13,0,Thursday,1,Misty,0.72,0.6667,0.54,0.2537,37,114,151,564,151,151
3905,2011-06-16,Summer,2011,Jun,14,0,Thursday,1,Misty,0.72,0.6667,0.54,0.3284,39,114,153,564,153,153
3906,2011-06-16,Summer,2011,Jun,15,0,Thursday,1,Misty,0.7,0.6515,0.61,0.2985,32,127,159,564,159,159
3907,2011-06-16,Summer,2011,Jun,16,0,Thursday,1,Light_rainsnow,0.66,0.6212,0.69,0.194,36,258,294,564,294,294
3908,2011-06-16,Summer,2011,Jun,17,0,Thursday,1,Misty,0.64,0.5909,0.78,0.1045,42,230,272,564,272,272
3909,2011-06-16,Summer,2011,Jun,18,0,Thursday,1,Clear,0.64,0.5758,0.83,0.2239,26,299,325,564,325,325
3910,2011-06-16,Summer,2011,Jun,19,0,Thursday,1,Clear,0.62,0.5758,0.83,0.2836,58,269,327,564,327,327
3911,2011-06-16,Summer,2011,Jun,20,0,Thursday,1,Clear,0.62,0.5758,0.83,0.3284,25,176,201,564,201,201
3912,2011-06-16,Summer,2011,Jun,21,0,Thursday,1,Light_rainsnow,0.62,0.5758,0.83,0.2537,34,154,188,564,188,188
3913,2011-06-16,Summer,2011,Jun,22,0,Thursday,1,Light_rainsnow,0.62,0.5758,0.83,0.2537,24,127,151,564,151,151
3914,2011-06-16,Summer,2011,Jun,23,0,Thursday,1,Light_rainsnow,0.6,0.5606,0.83,0.2537,2,14,16,564,16,16
3915,2011-06-17,Summer,2011,Jun,0,0,Friday,1,Clear,0.56,0.5303,0.88,0.0896,3,21,24,563,24,24
3916,2011-06-17,Summer,2011,Jun,1,0,Friday,1,Clear,0.56,0.5303,0.94,0.1343,4,19,23,563,23,23
3917,2011-06-17,Summer,2011,Jun,2,0,Friday,1,Clear,0.56,0.5303,0.94,0.1045,2,11,13,563,13,13
3918,2011-06-17,Summer,2011,Jun,3,0,Friday,1,Clear,0.56,0.5303,0.94,0.1045,1,5,6,563,6,6
3919,2011-06-17,Summer,2011,Jun,4,0,Friday,1,Clear,0.54,0.5152,0.94,0.1343,1,5,6,563,6,6
3920,2011-06-17,Summer,2011,Jun,5,0,Friday,1,Clear,0.54,0.5152,1.0,0.0,1,12,13,563,13,13
3921,2011-06-17,Summer,2011,Jun,6,0,Friday,1,Clear,0.56,0.5303,0.94,0.0,8,89,97,563,97,97
3922,2011-06-17,Summer,2011,Jun,7,0,Friday,1,Clear,0.6,0.5606,0.83,0.0,25,225,250,563,250,250
3923,2011-06-17,Summer,2011,Jun,8,0,Friday,1,Misty,0.6,0.5606,0.83,0.0,28,426,454,563,454,454
3924,2011-06-17,Summer,2011,Jun,9,0,Friday,1,Clear,0.7,0.6515,0.58,0.194,28,196,224,563,224,224
3925,2011-06-17,Summer,2011,Jun,10,0,Friday,1,Clear,0.7,0.6515,0.58,0.194,44,126,170,563,170,170
3926,2011-06-17,Summer,2011,Jun,11,0,Friday,1,Clear,0.68,0.6364,0.69,0.2537,43,138,181,563,181,181
3927,2011-06-17,Summer,2011,Jun,12,0,Friday,1,Clear,0.7,0.6515,0.65,0.2537,49,194,243,563,243,243
3928,2011-06-17,Summer,2011,Jun,13,0,Friday,1,Clear,0.74,0.6818,0.62,0.2836,48,156,204,563,204,204
3929,2011-06-17,Summer,2011,Jun,14,0,Friday,1,Clear,0.76,0.697,0.52,0.194,73,142,215,563,215,215
3930,2011-06-17,Summer,2011,Jun,15,0,Friday,1,Clear,0.78,0.697,0.43,0.2239,62,181,243,563,243,243
3931,2011-06-17,Summer,2011,Jun,16,0,Friday,1,Clear,0.76,0.6818,0.45,0.1642,69,286,355,563,355,355
3932,2011-06-17,Summer,2011,Jun,17,0,Friday,1,Light_rainsnow,0.76,0.6818,0.4,0.194,85,467,552,563,552,552
3933,2011-06-17,Summer,2011,Jun,18,0,Friday,1,Light_rainsnow,0.76,0.6818,0.4,0.194,62,388,450,563,450,450
3934,2011-06-17,Summer,2011,Jun,19,0,Friday,1,Light_rainsnow,0.64,0.5758,0.83,0.2537,53,275,328,563,328,328
3935,2011-06-17,Summer,2011,Jun,20,0,Friday,1,Clear,0.64,0.5909,0.78,0.1045,40,192,232,563,232,232
3936,2011-06-17,Summer,2011,Jun,21,0,Friday,1,Clear,0.64,0.5909,0.78,0.0896,49,159,208,563,208,208
3937,2011-06-17,Summer,2011,Jun,22,0,Friday,1,Clear,0.62,0.5606,0.88,0.1343,48,127,175,563,175,175
3938,2011-06-17,Summer,2011,Jun,23,0,Friday,1,Clear,0.62,0.5758,0.83,0.1343,37,141,178,563,178,178
3939,2011-06-18,Summer,2011,Jun,0,0,Saturday,0,Clear,0.62,0.5606,0.88,0.1343,21,83,104,562,104,104
3940,2011-06-18,Summer,2011,Jun,1,0,Saturday,0,Clear,0.62,0.5758,0.83,0.1045,15,80,95,562,95,95
3941,2011-06-18,Summer,2011,Jun,2,0,Saturday,0,Clear,0.6,0.5455,0.88,0.0,16,37,53,562,53,53
3942,2011-06-18,Summer,2011,Jun,3,0,Saturday,0,Clear,0.6,0.5455,0.88,0.0896,4,16,20,562,20,20
3943,2011-06-18,Summer,2011,Jun,4,0,Saturday,0,Clear,0.6,0.5455,0.88,0.0896,1,4,5,562,5,5
3944,2011-06-18,Summer,2011,Jun,5,0,Saturday,0,Clear,0.62,0.5758,0.83,0.0,1,6,7,562,7,7
3945,2011-06-18,Summer,2011,Jun,6,0,Saturday,0,Clear,0.62,0.5758,0.83,0.1045,9,18,27,562,27,27
3946,2011-06-18,Summer,2011,Jun,7,0,Saturday,0,Clear,0.64,0.5909,0.78,0.1343,12,45,57,562,57,57
3947,2011-06-18,Summer,2011,Jun,8,0,Saturday,0,Clear,0.66,0.6061,0.78,0.0896,28,103,131,562,131,131
3948,2011-06-18,Summer,2011,Jun,9,0,Saturday,0,Clear,0.7,0.6515,0.61,0.2239,62,156,218,562,218,218
3949,2011-06-18,Summer,2011,Jun,10,0,Saturday,0,Clear,0.72,0.6818,0.62,0.194,68,176,244,562,244,244
3950,2011-06-18,Summer,2011,Jun,11,0,Saturday,0,Clear,0.72,0.6818,0.62,0.1343,134,270,404,562,404,404
3951,2011-06-18,Summer,2011,Jun,12,0,Saturday,0,Clear,0.74,0.697,0.66,0.0896,162,258,420,562,420,420
3952,2011-06-18,Summer,2011,Jun,13,0,Saturday,0,Clear,0.76,0.697,0.55,0.0,135,192,327,562,327,327
3953,2011-06-18,Summer,2011,Jun,14,0,Saturday,0,Misty,0.8,0.7273,0.46,0.2836,138,196,334,562,334,334
3954,2011-06-18,Summer,2011,Jun,15,0,Saturday,0,Misty,0.82,0.7576,0.46,0.1343,153,214,367,562,367,367
3955,2011-06-18,Summer,2011,Jun,16,0,Saturday,0,Misty,0.76,0.697,0.52,0.2239,193,275,468,562,468,468
3956,2011-06-18,Summer,2011,Jun,17,0,Saturday,0,Misty,0.76,0.6818,0.48,0.1642,210,239,449,562,449,449
3957,2011-06-18,Summer,2011,Jun,18,0,Saturday,0,Misty,0.74,0.6818,0.55,0.194,118,263,381,562,381,381
3958,2011-06-18,Summer,2011,Jun,19,0,Saturday,0,Misty,0.74,0.6667,0.51,0.1045,99,227,326,562,326,326
3959,2011-06-18,Summer,2011,Jun,20,0,Saturday,0,Misty,0.72,0.6667,0.58,0.1343,61,127,188,562,188,188
3960,2011-06-18,Summer,2011,Jun,21,0,Saturday,0,Misty,0.72,0.6818,0.66,0.1045,58,125,183,562,183,183
3961,2011-06-18,Summer,2011,Jun,22,0,Saturday,0,Misty,0.72,0.6818,0.62,0.1343,56,105,161,562,161,161
3962,2011-06-18,Summer,2011,Jun,23,0,Saturday,0,Misty,0.72,0.6818,0.62,0.0,53,97,150,562,150,150
3963,2011-06-19,Summer,2011,Jun,0,0,Sunday,0,Clear,0.7,0.6515,0.65,0.0,18,71,89,561,89,89
3964,2011-06-19,Summer,2011,Jun,1,0,Sunday,0,Misty,0.7,0.6515,0.65,0.0896,17,59,76,561,76,76
3965,2011-06-19,Summer,2011,Jun,2,0,Sunday,0,Clear,0.68,0.6364,0.74,0.0896,13,59,72,561,72,72
3966,2011-06-19,Summer,2011,Jun,3,0,Sunday,0,Misty,0.66,0.6061,0.78,0.1343,14,16,30,561,30,30
3967,2011-06-19,Summer,2011,Jun,4,0,Sunday,0,Misty,0.66,0.6212,0.74,0.1343,7,10,17,561,17,17
3968,2011-06-19,Summer,2011,Jun,5,0,Sunday,0,Misty,0.66,0.6061,0.78,0.0,7,12,19,561,19,19
3969,2011-06-19,Summer,2011,Jun,6,0,Sunday,0,Misty,0.66,0.6061,0.78,0.1642,11,22,33,561,33,33
3970,2011-06-19,Summer,2011,Jun,7,0,Sunday,0,Misty,0.66,0.6061,0.78,0.1642,35,36,71,561,71,71
3971,2011-06-19,Summer,2011,Jun,8,0,Sunday,0,Light_rainsnow,0.68,0.6364,0.74,0.1045,25,59,84,561,84,84
3972,2011-06-19,Summer,2011,Jun,9,0,Sunday,0,Misty,0.68,0.6364,0.74,0.1045,58,111,169,561,169,169
3973,2011-06-19,Summer,2011,Jun,10,0,Sunday,0,Misty,0.7,0.6515,0.61,0.1045,86,158,244,561,244,244
3974,2011-06-19,Summer,2011,Jun,11,0,Sunday,0,Misty,0.72,0.6667,0.58,0.0896,141,236,377,561,377,377
3975,2011-06-19,Summer,2011,Jun,12,0,Sunday,0,Misty,0.74,0.6818,0.55,0.0896,141,255,396,561,396,396
3976,2011-06-19,Summer,2011,Jun,13,0,Sunday,0,Misty,0.74,0.6667,0.51,0.0,149,214,363,561,363,363
3977,2011-06-19,Summer,2011,Jun,14,0,Sunday,0,Light_rainsnow,0.74,0.6818,0.58,0.1045,124,193,317,561,317,317
3978,2011-06-19,Summer,2011,Jun,15,0,Sunday,0,Misty,0.74,0.6818,0.55,0.1045,146,216,362,561,362,362
3979,2011-06-19,Summer,2011,Jun,16,0,Sunday,0,Misty,0.76,0.6818,0.48,0.0,121,257,378,561,378,378
3980,2011-06-19,Summer,2011,Jun,17,0,Sunday,0,Clear,0.74,0.6667,0.51,0.0,159,238,397,561,397,397
3981,2011-06-19,Summer,2011,Jun,18,0,Sunday,0,Misty,0.74,0.6818,0.58,0.0896,78,218,296,561,296,296
3982,2011-06-19,Summer,2011,Jun,19,0,Sunday,0,Clear,0.72,0.6818,0.62,0.1343,94,217,311,561,311,311
3983,2011-06-19,Summer,2011,Jun,20,0,Sunday,0,Clear,0.7,0.6515,0.7,0.194,86,146,232,561,232,232
3984,2011-06-19,Summer,2011,Jun,21,0,Sunday,0,Clear,0.68,0.6364,0.79,0.1343,57,110,167,561,167,167
3985,2011-06-19,Summer,2011,Jun,22,0,Sunday,0,Clear,0.66,0.6061,0.78,0.2239,38,114,152,561,152,152
3986,2011-06-19,Summer,2011,Jun,23,0,Sunday,0,Clear,0.66,0.6061,0.78,0.194,14,78,92,561,92,92
3987,2011-06-20,Summer,2011,Jun,0,0,Monday,1,Clear,0.66,0.6061,0.83,0.1642,7,19,26,560,26,26
3988,2011-06-20,Summer,2011,Jun,1,0,Monday,1,Clear,0.64,0.5758,0.89,0.0896,9,3,12,560,12,12
3989,2011-06-20,Summer,2011,Jun,2,0,Monday,1,Clear,0.64,0.5758,0.89,0.0896,2,0,2,560,2,2
3990,2011-06-20,Summer,2011,Jun,3,0,Monday,1,Light_rainsnow,0.64,0.5758,0.89,0.0,1,0,1,560,1,1
3991,2011-06-20,Summer,2011,Jun,4,0,Monday,1,Light_rainsnow,0.62,0.5606,0.88,0.1642,1,2,3,560,3,3
3992,2011-06-20,Summer,2011,Jun,5,0,Monday,1,Light_rainsnow,0.62,0.5758,0.83,0.1343,0,3,3,560,3,3
3993,2011-06-20,Summer,2011,Jun,6,0,Monday,1,Light_rainsnow,0.6,0.5758,0.78,0.1343,1,25,26,560,26,26
3994,2011-06-20,Summer,2011,Jun,7,0,Monday,1,Light_rainsnow,0.56,0.5303,0.88,0.194,0,46,46,560,46,46
3995,2011-06-20,Summer,2011,Jun,8,0,Monday,1,Light_rainsnow,0.56,0.5303,0.83,0.194,12,209,221,560,221,221
3996,2011-06-20,Summer,2011,Jun,9,0,Monday,1,Misty,0.6,0.5758,0.78,0.2537,19,200,219,560,219,219
3997,2011-06-20,Summer,2011,Jun,10,0,Monday,1,Misty,0.6,0.5758,0.78,0.2537,33,58,91,560,91,91
3998,2011-06-20,Summer,2011,Jun,11,0,Monday,1,Misty,0.6,0.5758,0.78,0.1045,27,67,94,560,94,94
3999,2011-06-20,Summer,2011,Jun,12,0,Monday,1,Misty,0.62,0.6061,0.69,0.1045,33,129,162,560,162,162
4000,2011-06-20,Summer,2011,Jun,13,0,Monday,1,Clear,0.64,0.6061,0.65,0.1045,50,129,179,560,179,179
4001,2011-06-20,Summer,2011,Jun,14,0,Monday,1,Clear,0.66,0.6212,0.61,0.1045,45,130,175,560,175,175
4002,2011-06-20,Summer,2011,Jun,15,0,Monday,1,Clear,0.66,0.6212,0.61,0.1343,66,139,205,560,205,205
4003,2011-06-20,Summer,2011,Jun,16,0,Monday,1,Clear,0.7,0.6515,0.58,0.1642,61,238,299,560,299,299
4004,2011-06-20,Summer,2011,Jun,17,0,Monday,1,Clear,0.7,0.6515,0.54,0.0,81,484,565,560,565,565
4005,2011-06-20,Summer,2011,Jun,18,0,Monday,1,Clear,0.7,0.6515,0.61,0.2537,64,474,538,560,538,538
4006,2011-06-20,Summer,2011,Jun,19,0,Monday,1,Clear,0.66,0.6212,0.65,0.2239,62,369,431,560,431,431
4007,2011-06-20,Summer,2011,Jun,20,0,Monday,1,Clear,0.66,0.6212,0.69,0.2239,52,264,316,560,316,316
4008,2011-06-20,Summer,2011,Jun,21,0,Monday,1,Clear,0.64,0.6061,0.73,0.1642,39,167,206,560,206,206
4009,2011-06-20,Summer,2011,Jun,22,0,Monday,1,Misty,0.64,0.6061,0.73,0.2239,24,106,130,560,130,130
4010,2011-06-20,Summer,2011,Jun,23,0,Monday,1,Clear,0.62,0.5909,0.78,0.2537,10,50,60,560,60,60
4011,2011-06-21,Fall,2011,Jun,0,0,Tuesday,1,Clear,0.62,0.5909,0.78,0.1642,10,23,33,559,33,33
4012,2011-06-21,Fall,2011,Jun,1,0,Tuesday,1,Light_rainsnow,0.62,0.5909,0.78,0.1642,2,12,14,559,14,14
4013,2011-06-21,Fall,2011,Jun,2,0,Tuesday,1,Light_rainsnow,0.62,0.5758,0.83,0.1642,1,5,6,559,6,6
4014,2011-06-21,Fall,2011,Jun,3,0,Tuesday,1,Light_rainsnow,0.62,0.5758,0.83,0.1642,0,2,2,559,2,2
4015,2011-06-21,Fall,2011,Jun,4,0,Tuesday,1,Misty,0.6,0.5455,0.88,0.1045,2,7,9,559,9,9
4016,2011-06-21,Fall,2011,Jun,5,0,Tuesday,1,Misty,0.6,0.5455,0.88,0.1343,3,22,25,559,25,25
4017,2011-06-21,Fall,2011,Jun,6,0,Tuesday,1,Misty,0.6,0.5455,0.88,0.1343,8,107,115,559,115,115
4018,2011-06-21,Fall,2011,Jun,7,0,Tuesday,1,Misty,0.6,0.5152,0.94,0.0,21,288,309,559,309,309
4019,2011-06-21,Fall,2011,Jun,8,0,Tuesday,1,Misty,0.62,0.5606,0.88,0.1045,33,368,401,559,401,401
4020,2011-06-21,Fall,2011,Jun,9,0,Tuesday,1,Misty,0.62,0.5606,0.88,0.2537,32,243,275,559,275,275
4021,2011-06-21,Fall,2011,Jun,10,0,Tuesday,1,Misty,0.64,0.5758,0.83,0.194,41,120,161,559,161,161
4022,2011-06-21,Fall,2011,Jun,11,0,Tuesday,1,Clear,0.66,0.6061,0.83,0.1642,52,119,171,559,171,171
4023,2011-06-21,Fall,2011,Jun,12,0,Tuesday,1,Clear,0.7,0.6667,0.74,0.1642,40,149,189,559,189,189
4024,2011-06-21,Fall,2011,Jun,13,0,Tuesday,1,Clear,0.74,0.697,0.66,0.1642,49,158,207,559,207,207
4025,2011-06-21,Fall,2011,Jun,14,0,Tuesday,1,Clear,0.76,0.7121,0.62,0.2239,44,108,152,559,152,152
4026,2011-06-21,Fall,2011,Jun,15,0,Tuesday,1,Clear,0.78,0.7424,0.59,0.2537,42,128,170,559,170,170
4027,2011-06-21,Fall,2011,Jun,16,0,Tuesday,1,Clear,0.8,0.7727,0.59,0.2239,62,273,335,559,335,335
4028,2011-06-21,Fall,2011,Jun,17,0,Tuesday,1,Clear,0.78,0.7576,0.66,0.2239,65,507,572,559,572,572
4029,2011-06-21,Fall,2011,Jun,18,0,Tuesday,1,Misty,0.76,0.7273,0.7,0.2537,67,469,536,559,536,536
4030,2011-06-21,Fall,2011,Jun,19,0,Tuesday,1,Misty,0.74,0.7121,0.74,0.2239,67,358,425,559,425,425
4031,2011-06-21,Fall,2011,Jun,20,0,Tuesday,1,Light_rainsnow,0.74,0.697,0.7,0.2239,72,254,326,559,326,326
4032,2011-06-21,Fall,2011,Jun,21,0,Tuesday,1,Clear,0.72,0.697,0.74,0.194,38,191,229,559,229,229
4033,2011-06-21,Fall,2011,Jun,22,0,Tuesday,1,Clear,0.7,0.6667,0.79,0.1045,12,97,109,559,109,109
4034,2011-06-21,Fall,2011,Jun,23,0,Tuesday,1,Clear,0.7,0.6667,0.74,0.1045,11,53,64,559,64,64
4035,2011-06-22,Fall,2011,Jun,0,0,Wednesday,1,Clear,0.66,0.6061,0.78,0.194,15,18,33,558,33,33
4036,2011-06-22,Fall,2011,Jun,1,0,Wednesday,1,Clear,0.66,0.6061,0.78,0.1343,2,19,21,558,21,21
4037,2011-06-22,Fall,2011,Jun,2,0,Wednesday,1,Clear,0.66,0.6061,0.78,0.0,2,5,7,558,7,7
4038,2011-06-22,Fall,2011,Jun,3,0,Wednesday,1,Clear,0.66,0.6061,0.78,0.1343,0,7,7,558,7,7
4039,2011-06-22,Fall,2011,Jun,4,0,Wednesday,1,Clear,0.64,0.5758,0.83,0.0,3,8,11,558,11,11
4040,2011-06-22,Fall,2011,Jun,5,0,Wednesday,1,Clear,0.64,0.5758,0.89,0.0,2,21,23,558,23,23
4041,2011-06-22,Fall,2011,Jun,6,0,Wednesday,1,Clear,0.66,0.6061,0.83,0.0,12,110,122,558,122,122
4042,2011-06-22,Fall,2011,Jun,7,0,Wednesday,1,Clear,0.7,0.6667,0.79,0.0,23,288,311,558,311,311
4043,2011-06-22,Fall,2011,Jun,8,0,Wednesday,1,Clear,0.72,0.697,0.74,0.1045,27,396,423,558,423,423
4044,2011-06-22,Fall,2011,Jun,9,0,Wednesday,1,Clear,0.72,0.697,0.79,0.1642,14,205,219,558,219,219
4045,2011-06-22,Fall,2011,Jun,10,0,Wednesday,1,Clear,0.74,0.697,0.7,0.2537,31,104,135,558,135,135
4046,2011-06-22,Fall,2011,Jun,11,0,Wednesday,1,Clear,0.74,0.697,0.7,0.1642,37,108,145,558,145,145
4047,2011-06-22,Fall,2011,Jun,12,0,Wednesday,1,Misty,0.8,0.7727,0.59,0.2239,44,144,188,558,188,188
4048,2011-06-22,Fall,2011,Jun,13,0,Wednesday,1,Misty,0.82,0.7879,0.56,0.2537,34,113,147,558,147,147
4049,2011-06-22,Fall,2011,Jun,14,0,Wednesday,1,Misty,0.82,0.7727,0.52,0.2836,32,113,145,558,145,145
4050,2011-06-22,Fall,2011,Jun,15,0,Wednesday,1,Misty,0.82,0.7879,0.56,0.2836,32,114,146,558,146,146
4051,2011-06-22,Fall,2011,Jun,16,0,Wednesday,1,Misty,0.82,0.803,0.59,0.3284,34,224,258,558,258,258
4052,2011-06-22,Fall,2011,Jun,17,0,Wednesday,1,Misty,0.8,0.7576,0.55,0.3881,67,462,529,558,529,529
4053,2011-06-22,Fall,2011,Jun,18,0,Wednesday,1,Misty,0.8,0.7727,0.59,0.2537,66,447,513,558,513,513
4054,2011-06-22,Fall,2011,Jun,19,0,Wednesday,1,Misty,0.8,0.7424,0.52,0.2537,62,280,342,558,342,342
4055,2011-06-22,Fall,2011,Jun,20,0,Wednesday,1,Clear,0.74,0.7121,0.74,0.1343,52,230,282,558,282,282
4056,2011-06-22,Fall,2011,Jun,21,0,Wednesday,1,Clear,0.74,0.7121,0.79,0.1642,31,216,247,558,247,247
4057,2011-06-22,Fall,2011,Jun,22,0,Wednesday,1,Misty,0.72,0.697,0.79,0.194,25,123,148,558,148,148
4058,2011-06-22,Fall,2011,Jun,23,0,Wednesday,1,Misty,0.72,0.697,0.79,0.2239,14,91,105,558,105,105
4059,2011-06-23,Fall,2011,Jun,0,0,Thursday,1,Clear,0.72,0.697,0.79,0.2239,5,44,49,557,49,49
4060,2011-06-23,Fall,2011,Jun,1,0,Thursday,1,Clear,0.72,0.697,0.74,0.2239,5,26,31,557,31,31
4061,2011-06-23,Fall,2011,Jun,2,0,Thursday,1,Clear,0.72,0.697,0.74,0.2239,0,4,4,557,4,4
4062,2011-06-23,Fall,2011,Jun,3,0,Thursday,1,Misty,0.72,0.697,0.74,0.1642,1,4,5,557,5,5
4063,2011-06-23,Fall,2011,Jun,4,0,Thursday,1,Misty,0.7,0.6667,0.79,0.1343,0,7,7,557,7,7
4064,2011-06-23,Fall,2011,Jun,5,0,Thursday,1,Clear,0.72,0.697,0.74,0.1642,2,22,24,557,24,24
4065,2011-06-23,Fall,2011,Jun,6,0,Thursday,1,Clear,0.72,0.697,0.74,0.1642,8,92,100,557,100,100
4066,2011-06-23,Fall,2011,Jun,7,0,Thursday,1,Misty,0.72,0.697,0.74,0.1343,26,301,327,557,327,327
4067,2011-06-23,Fall,2011,Jun,8,0,Thursday,1,Misty,0.74,0.697,0.7,0.194,20,412,432,557,432,432
4068,2011-06-23,Fall,2011,Jun,9,0,Thursday,1,Misty,0.74,0.697,0.7,0.1343,33,194,227,557,227,227
4069,2011-06-23,Fall,2011,Jun,10,0,Thursday,1,Misty,0.76,0.7273,0.66,0.1343,39,88,127,557,127,127
4070,2011-06-23,Fall,2011,Jun,11,0,Thursday,1,Light_rainsnow,0.76,0.7273,0.66,0.2537,28,108,136,557,136,136
4071,2011-06-23,Fall,2011,Jun,12,0,Thursday,1,Misty,0.76,0.7273,0.66,0.2836,30,130,160,557,160,160
4072,2011-06-23,Fall,2011,Jun,13,0,Thursday,1,Misty,0.76,0.7121,0.62,0.2836,37,149,186,557,186,186
4073,2011-06-23,Fall,2011,Jun,14,0,Thursday,1,Misty,0.76,0.7273,0.66,0.2985,46,103,149,557,149,149
4074,2011-06-23,Fall,2011,Jun,15,0,Thursday,1,Misty,0.76,0.697,0.52,0.3582,62,127,189,557,189,189
4075,2011-06-23,Fall,2011,Jun,16,0,Thursday,1,Misty,0.74,0.6818,0.62,0.2985,58,217,275,557,275,275
4076,2011-06-23,Fall,2011,Jun,17,0,Thursday,1,Misty,0.72,0.6818,0.7,0.3582,74,495,569,557,569,569
4077,2011-06-23,Fall,2011,Jun,18,0,Thursday,1,Clear,0.72,0.6818,0.7,0.4179,57,483,540,557,540,540
4078,2011-06-23,Fall,2011,Jun,19,0,Thursday,1,Clear,0.72,0.6818,0.7,0.3582,56,344,400,557,400,400
4079,2011-06-23,Fall,2011,Jun,20,0,Thursday,1,Clear,0.7,0.6667,0.74,0.2239,75,277,352,557,352,352
4080,2011-06-23,Fall,2011,Jun,21,0,Thursday,1,Clear,0.7,0.6667,0.74,0.194,46,188,234,557,234,234
4081,2011-06-23,Fall,2011,Jun,22,0,Thursday,1,Misty,0.7,0.6667,0.74,0.2239,23,139,162,557,162,162
4082,2011-06-23,Fall,2011,Jun,23,0,Thursday,1,Clear,0.7,0.6667,0.74,0.2836,15,90,105,557,105,105
4083,2011-06-24,Fall,2011,Jun,0,0,Friday,1,Clear,0.68,0.6364,0.79,0.194,10,53,63,556,63,63
4084,2011-06-24,Fall,2011,Jun,1,0,Friday,1,Clear,0.66,0.6061,0.83,0.3284,8,20,28,556,28,28
4085,2011-06-24,Fall,2011,Jun,2,0,Friday,1,Clear,0.66,0.6061,0.83,0.3284,4,10,14,556,14,14
4086,2011-06-24,Fall,2011,Jun,3,0,Friday,1,Clear,0.66,0.6061,0.83,0.1642,1,4,5,556,5,5
4087,2011-06-24,Fall,2011,Jun,4,0,Friday,1,Clear,0.66,0.6061,0.83,0.0896,1,8,9,556,9,9
4088,2011-06-24,Fall,2011,Jun,5,0,Friday,1,Clear,0.64,0.5758,0.89,0.0896,2,18,20,556,20,20
4089,2011-06-24,Fall,2011,Jun,6,0,Friday,1,Clear,0.66,0.6061,0.83,0.1343,4,87,91,556,91,91
4090,2011-06-24,Fall,2011,Jun,7,0,Friday,1,Misty,0.66,0.6061,0.83,0.2239,21,247,268,556,268,268
4091,2011-06-24,Fall,2011,Jun,8,0,Friday,1,Clear,0.7,0.6667,0.74,0.2239,27,439,466,556,466,466
4092,2011-06-24,Fall,2011,Jun,9,0,Friday,1,Clear,0.74,0.6818,0.62,0.1343,28,203,231,556,231,231
4093,2011-06-24,Fall,2011,Jun,10,0,Friday,1,Clear,0.8,0.7273,0.43,0.2836,43,102,145,556,145,145
4094,2011-06-24,Fall,2011,Jun,11,0,Friday,1,Clear,0.8,0.7121,0.38,0.3284,56,147,203,556,203,203
4095,2011-06-24,Fall,2011,Jun,12,0,Friday,1,Clear,0.8,0.7121,0.41,0.2836,51,150,201,556,201,201
4096,2011-06-24,Fall,2011,Jun,13,0,Friday,1,Clear,0.8,0.7121,0.36,0.2239,43,178,221,556,221,221
4097,2011-06-24,Fall,2011,Jun,14,0,Friday,1,Clear,0.78,0.697,0.43,0.2836,67,162,229,556,229,229
4098,2011-06-24,Fall,2011,Jun,15,0,Friday,1,Clear,0.82,0.7273,0.34,0.3881,69,147,216,556,216,216
4099,2011-06-24,Fall,2011,Jun,16,0,Friday,1,Clear,0.8,0.697,0.33,0.4179,80,247,327,556,327,327
4100,2011-06-24,Fall,2011,Jun,17,0,Friday,1,Clear,0.76,0.6667,0.37,0.2537,85,472,557,556,557,557
4101,2011-06-24,Fall,2011,Jun,18,0,Friday,1,Clear,0.76,0.6667,0.37,0.2985,87,365,452,556,452,452
4102,2011-06-24,Fall,2011,Jun,19,0,Friday,1,Clear,0.74,0.6515,0.4,0.2239,92,293,385,556,385,385
4103,2011-06-24,Fall,2011,Jun,20,0,Friday,1,Clear,0.72,0.6515,0.45,0.1642,66,222,288,556,288,288
4104,2011-06-24,Fall,2011,Jun,21,0,Friday,1,Clear,0.7,0.6515,0.48,0.1343,50,183,233,556,233,233
4105,2011-06-24,Fall,2011,Jun,22,0,Friday,1,Clear,0.7,0.6515,0.48,0.0,41,126,167,556,167,167
4106,2011-06-24,Fall,2011,Jun,23,0,Friday,1,Clear,0.68,0.6364,0.51,0.1343,33,139,172,556,172,172
4107,2011-06-25,Fall,2011,Jun,0,0,Saturday,0,Clear,0.68,0.6364,0.47,0.1642,19,97,116,555,116,116
4108,2011-06-25,Fall,2011,Jun,1,0,Saturday,0,Clear,0.66,0.6212,0.5,0.1642,20,75,95,555,95,95
4109,2011-06-25,Fall,2011,Jun,2,0,Saturday,0,Misty,0.66,0.6212,0.5,0.194,8,51,59,555,59,59
4110,2011-06-25,Fall,2011,Jun,3,0,Saturday,0,Clear,0.64,0.6212,0.57,0.194,18,21,39,555,39,39
4111,2011-06-25,Fall,2011,Jun,4,0,Saturday,0,Clear,0.64,0.6212,0.57,0.194,7,4,11,555,11,11
4112,2011-06-25,Fall,2011,Jun,5,0,Saturday,0,Clear,0.62,0.6061,0.61,0.1343,6,8,14,555,14,14
4113,2011-06-25,Fall,2011,Jun,6,0,Saturday,0,Clear,0.64,0.6212,0.57,0.2239,12,17,29,555,29,29
4114,2011-06-25,Fall,2011,Jun,7,0,Saturday,0,Clear,0.64,0.6212,0.57,0.2836,7,35,42,555,42,42
4115,2011-06-25,Fall,2011,Jun,8,0,Saturday,0,Clear,0.7,0.6515,0.48,0.2537,27,85,112,555,112,112
4116,2011-06-25,Fall,2011,Jun,9,0,Saturday,0,Clear,0.72,0.6515,0.45,0.2537,47,139,186,555,186,186
4117,2011-06-25,Fall,2011,Jun,10,0,Saturday,0,Clear,0.72,0.6515,0.45,0.194,99,203,302,555,302,302
4118,2011-06-25,Fall,2011,Jun,11,0,Saturday,0,Clear,0.74,0.6667,0.42,0.0,122,209,331,555,331,331
4119,2011-06-25,Fall,2011,Jun,12,0,Saturday,0,Clear,0.74,0.6515,0.4,0.2836,140,252,392,555,392,392
4120,2011-06-25,Fall,2011,Jun,13,0,Saturday,0,Clear,0.74,0.6515,0.4,0.2836,140,231,371,555,371,371
4121,2011-06-25,Fall,2011,Jun,14,0,Saturday,0,Clear,0.74,0.6667,0.45,0.2985,151,232,383,555,383,383
4122,2011-06-25,Fall,2011,Jun,15,0,Saturday,0,Clear,0.74,0.6667,0.45,0.0,157,235,392,555,392,392
4123,2011-06-25,Fall,2011,Jun,16,0,Saturday,0,Clear,0.76,0.6818,0.43,0.2985,175,235,410,555,410,410
4124,2011-06-25,Fall,2011,Jun,17,0,Saturday,0,Clear,0.74,0.6667,0.42,0.2239,152,247,399,555,399,399
4125,2011-06-25,Fall,2011,Jun,18,0,Saturday,0,Clear,0.72,0.6515,0.45,0.2537,108,199,307,555,307,307
4126,2011-06-25,Fall,2011,Jun,19,0,Saturday,0,Clear,0.72,0.6667,0.48,0.2836,121,254,375,555,375,375
4127,2011-06-25,Fall,2011,Jun,20,0,Saturday,0,Clear,0.7,0.6515,0.48,0.194,74,195,269,555,269,269
4128,2011-06-25,Fall,2011,Jun,21,0,Saturday,0,Clear,0.68,0.6364,0.51,0.1642,62,140,202,555,202,202
4129,2011-06-25,Fall,2011,Jun,22,0,Saturday,0,Clear,0.68,0.6364,0.47,0.194,61,126,187,555,187,187
4130,2011-06-25,Fall,2011,Jun,23,0,Saturday,0,Misty,0.66,0.6212,0.5,0.2985,49,130,179,555,179,179
4131,2011-06-26,Fall,2011,Jun,0,0,Sunday,0,Clear,0.64,0.6212,0.53,0.0,30,85,115,554,115,115
4132,2011-06-26,Fall,2011,Jun,1,0,Sunday,0,Clear,0.64,0.6212,0.53,0.1045,17,73,90,554,90,90
4133,2011-06-26,Fall,2011,Jun,2,0,Sunday,0,Clear,0.62,0.6212,0.57,0.1045,17,70,87,554,87,87
4134,2011-06-26,Fall,2011,Jun,3,0,Sunday,0,Clear,0.6,0.6061,0.64,0.1045,12,22,34,554,34,34
4135,2011-06-26,Fall,2011,Jun,4,0,Sunday,0,Clear,0.6,0.6061,0.64,0.0896,3,8,11,554,11,11
4136,2011-06-26,Fall,2011,Jun,5,0,Sunday,0,Clear,0.6,0.6061,0.64,0.0,3,9,12,554,12,12
4137,2011-06-26,Fall,2011,Jun,6,0,Sunday,0,Clear,0.6,0.6061,0.64,0.0,7,13,20,554,20,20
4138,2011-06-26,Fall,2011,Jun,7,0,Sunday,0,Clear,0.62,0.6061,0.61,0.0,24,27,51,554,51,51
4139,2011-06-26,Fall,2011,Jun,8,0,Sunday,0,Clear,0.64,0.6212,0.61,0.194,29,78,107,554,107,107
4140,2011-06-26,Fall,2011,Jun,9,0,Sunday,0,Clear,0.66,0.6212,0.54,0.0896,75,131,206,554,206,206
4141,2011-06-26,Fall,2011,Jun,10,0,Sunday,0,Clear,0.72,0.6667,0.48,0.1045,136,196,332,554,332,332
4142,2011-06-26,Fall,2011,Jun,11,0,Sunday,0,Clear,0.72,0.6515,0.45,0.1343,127,219,346,554,346,346
4143,2011-06-26,Fall,2011,Jun,12,0,Sunday,0,Clear,0.74,0.6515,0.4,0.1642,175,268,443,554,443,443
4144,2011-06-26,Fall,2011,Jun,13,0,Sunday,0,Clear,0.74,0.6515,0.4,0.0,197,245,442,554,442,442
4145,2011-06-26,Fall,2011,Jun,14,0,Sunday,0,Clear,0.74,0.6515,0.4,0.1343,197,246,443,554,443,443
4146,2011-06-26,Fall,2011,Jun,15,0,Sunday,0,Clear,0.74,0.6515,0.4,0.0,174,229,403,554,403,403
4147,2011-06-26,Fall,2011,Jun,16,0,Sunday,0,Clear,0.74,0.6667,0.42,0.194,177,278,455,554,455,455
4148,2011-06-26,Fall,2011,Jun,17,0,Sunday,0,Misty,0.72,0.6515,0.42,0.1642,178,243,421,554,421,421
4149,2011-06-26,Fall,2011,Jun,18,0,Sunday,0,Misty,0.72,0.6515,0.45,0.2537,117,265,382,554,382,382
4150,2011-06-26,Fall,2011,Jun,19,0,Sunday,0,Misty,0.72,0.6667,0.48,0.1343,89,228,317,554,317,317
4151,2011-06-26,Fall,2011,Jun,20,0,Sunday,0,Misty,0.7,0.6515,0.48,0.1045,55,158,213,554,213,213
4152,2011-06-26,Fall,2011,Jun,21,0,Sunday,0,Misty,0.7,0.6515,0.54,0.1045,48,135,183,554,183,183
4153,2011-06-26,Fall,2011,Jun,22,0,Sunday,0,Clear,0.7,0.6515,0.51,0.0,19,95,114,554,114,114
4154,2011-06-26,Fall,2011,Jun,23,0,Sunday,0,Clear,0.7,0.6515,0.54,0.0896,14,64,78,554,78,78
4155,2011-06-27,Fall,2011,Jun,0,0,Monday,1,Light_rainsnow,0.64,0.6061,0.73,0.2836,7,25,32,553,32,32
4156,2011-06-27,Fall,2011,Jun,1,0,Monday,1,Misty,0.62,0.5909,0.78,0.1343,4,11,15,553,15,15
4157,2011-06-27,Fall,2011,Jun,2,0,Monday,1,Light_rainsnow,0.62,0.5909,0.78,0.1343,3,3,6,553,6,6
4158,2011-06-27,Fall,2011,Jun,3,0,Monday,1,Light_rainsnow,0.62,0.5909,0.78,0.1343,0,2,2,553,2,2
4159,2011-06-27,Fall,2011,Jun,4,0,Monday,1,Misty,0.6,0.5606,0.83,0.1642,1,8,9,553,9,9
4160,2011-06-27,Fall,2011,Jun,5,0,Monday,1,Misty,0.62,0.5758,0.83,0.1642,1,21,22,553,22,22
4161,2011-06-27,Fall,2011,Jun,6,0,Monday,1,Misty,0.62,0.5909,0.78,0.1642,4,90,94,553,94,94
4162,2011-06-27,Fall,2011,Jun,7,0,Monday,1,Misty,0.64,0.6061,0.73,0.2239,14,247,261,553,261,261
4163,2011-06-27,Fall,2011,Jun,8,0,Monday,1,Clear,0.66,0.6212,0.74,0.194,29,418,447,553,447,447
4164,2011-06-27,Fall,2011,Jun,9,0,Monday,1,Misty,0.72,0.6667,0.54,0.0,37,150,187,553,187,187
4165,2011-06-27,Fall,2011,Jun,10,0,Monday,1,Misty,0.72,0.6667,0.54,0.1343,55,95,150,553,150,150
4166,2011-06-27,Fall,2011,Jun,11,0,Monday,1,Misty,0.7,0.6515,0.58,0.0,55,95,150,553,150,150
4167,2011-06-27,Fall,2011,Jun,12,0,Monday,1,Misty,0.72,0.6667,0.54,0.0,40,130,170,553,170,170
4168,2011-06-27,Fall,2011,Jun,13,0,Monday,1,Misty,0.72,0.6667,0.58,0.2239,37,127,164,553,164,164
4169,2011-06-27,Fall,2011,Jun,14,0,Monday,1,Misty,0.72,0.6667,0.58,0.0896,58,100,158,553,158,158
4170,2011-06-27,Fall,2011,Jun,15,0,Monday,1,Misty,0.74,0.6818,0.55,0.0,76,126,202,553,202,202
4171,2011-06-27,Fall,2011,Jun,16,0,Monday,1,Clear,0.74,0.6818,0.55,0.1045,53,222,275,553,275,275
4172,2011-06-27,Fall,2011,Jun,17,0,Monday,1,Clear,0.74,0.6818,0.55,0.1343,90,514,604,553,604,604
4173,2011-06-27,Fall,2011,Jun,18,0,Monday,1,Clear,0.74,0.6667,0.51,0.0,79,512,591,553,591,591
4174,2011-06-27,Fall,2011,Jun,19,0,Monday,1,Clear,0.72,0.6818,0.62,0.194,56,340,396,553,396,396
4175,2011-06-27,Fall,2011,Jun,20,0,Monday,1,Clear,0.7,0.6515,0.65,0.1045,54,251,305,553,305,305
4176,2011-06-27,Fall,2011,Jun,21,0,Monday,1,Clear,0.7,0.6515,0.65,0.0,52,190,242,553,242,242
4177,2011-06-27,Fall,2011,Jun,22,0,Monday,1,Clear,0.68,0.6364,0.69,0.0,33,112,145,553,145,145
4178,2011-06-27,Fall,2011,Jun,23,0,Monday,1,Clear,0.68,0.6364,0.69,0.0,16,65,81,553,81,81
4179,2011-06-28,Fall,2011,Jun,0,0,Tuesday,1,Misty,0.66,0.6061,0.78,0.1343,5,25,30,552,30,30
4180,2011-06-28,Fall,2011,Jun,1,0,Tuesday,1,Clear,0.66,0.6212,0.74,0.0,5,8,13,552,13,13
4181,2011-06-28,Fall,2011,Jun,2,0,Tuesday,1,Misty,0.66,0.6212,0.74,0.0,2,9,11,552,11,11
4182,2011-06-28,Fall,2011,Jun,3,0,Tuesday,1,Misty,0.66,0.6212,0.74,0.0,0,2,2,552,2,2
4183,2011-06-28,Fall,2011,Jun,4,0,Tuesday,1,Clear,0.66,0.6212,0.74,0.0,1,7,8,552,8,8
4184,2011-06-28,Fall,2011,Jun,5,0,Tuesday,1,Clear,0.66,0.6061,0.78,0.0,1,20,21,552,21,21
4185,2011-06-28,Fall,2011,Jun,6,0,Tuesday,1,Clear,0.66,0.6061,0.83,0.1642,7,117,124,552,124,124
4186,2011-06-28,Fall,2011,Jun,7,0,Tuesday,1,Clear,0.68,0.6364,0.83,0.194,27,320,347,552,347,347
4187,2011-06-28,Fall,2011,Jun,8,0,Tuesday,1,Clear,0.7,0.6667,0.79,0.1642,39,417,456,552,456,456
4188,2011-06-28,Fall,2011,Jun,9,0,Tuesday,1,Clear,0.74,0.697,0.7,0.0,38,208,246,552,246,246
4189,2011-06-28,Fall,2011,Jun,10,0,Tuesday,1,Clear,0.8,0.7424,0.49,0.1642,45,112,157,552,157,157
4190,2011-06-28,Fall,2011,Jun,11,0,Tuesday,1,Clear,0.82,0.7576,0.46,0.0,49,118,167,552,167,167
4191,2011-06-28,Fall,2011,Jun,12,0,Tuesday,1,Clear,0.84,0.7727,0.47,0.2239,41,161,202,552,202,202
4192,2011-06-28,Fall,2011,Jun,13,0,Tuesday,1,Clear,0.84,0.7576,0.44,0.0,33,156,189,552,189,189
4193,2011-06-28,Fall,2011,Jun,14,0,Tuesday,1,Clear,0.86,0.7879,0.44,0.2239,43,117,160,552,160,160
4194,2011-06-28,Fall,2011,Jun,15,0,Tuesday,1,Clear,0.86,0.7879,0.41,0.0,39,127,166,552,166,166
4195,2011-06-28,Fall,2011,Jun,16,0,Tuesday,1,Clear,0.86,0.803,0.47,0.2836,41,220,261,552,261,261
4196,2011-06-28,Fall,2011,Jun,17,0,Tuesday,1,Light_rainsnow,0.82,0.7879,0.56,0.2836,70,509,579,552,579,579
4197,2011-06-28,Fall,2011,Jun,18,0,Tuesday,1,Light_rainsnow,0.8,0.7576,0.55,0.2985,68,436,504,552,504,504
4198,2011-06-28,Fall,2011,Jun,19,0,Tuesday,1,Misty,0.74,0.6818,0.58,0.4627,44,255,299,552,299,299
4199,2011-06-28,Fall,2011,Jun,20,0,Tuesday,1,Clear,0.74,0.6818,0.62,0.0,50,246,296,552,296,296
4200,2011-06-28,Fall,2011,Jun,21,0,Tuesday,1,Clear,0.74,0.697,0.66,0.2836,31,164,195,552,195,195
4201,2011-06-28,Fall,2011,Jun,22,0,Tuesday,1,Clear,0.7,0.6515,0.7,0.2985,30,104,134,552,134,134
4202,2011-06-28,Fall,2011,Jun,23,0,Tuesday,1,Clear,0.7,0.6515,0.7,0.2836,23,58,81,552,81,81
4203,2011-06-29,Fall,2011,Jun,0,0,Wednesday,1,Misty,0.68,0.6364,0.79,0.2836,11,25,36,551,36,36
4204,2011-06-29,Fall,2011,Jun,1,0,Wednesday,1,Clear,0.68,0.6364,0.79,0.2985,10,18,28,551,28,28
4205,2011-06-29,Fall,2011,Jun,2,0,Wednesday,1,Clear,0.66,0.6061,0.83,0.2239,7,9,16,551,16,16
4206,2011-06-29,Fall,2011,Jun,3,0,Wednesday,1,Misty,0.66,0.6061,0.83,0.1045,2,3,5,551,5,5
4207,2011-06-29,Fall,2011,Jun,4,0,Wednesday,1,Clear,0.66,0.6061,0.83,0.1045,0,5,5,551,5,5
4208,2011-06-29,Fall,2011,Jun,5,0,Wednesday,1,Clear,0.64,0.5758,0.83,0.194,3,19,22,551,22,22
4209,2011-06-29,Fall,2011,Jun,6,0,Wednesday,1,Clear,0.66,0.6212,0.69,0.2985,12,104,116,551,116,116
4210,2011-06-29,Fall,2011,Jun,7,0,Wednesday,1,Clear,0.7,0.6515,0.54,0.2239,18,318,336,551,336,336
4211,2011-06-29,Fall,2011,Jun,8,0,Wednesday,1,Clear,0.7,0.6515,0.48,0.2836,41,499,540,551,540,540
4212,2011-06-29,Fall,2011,Jun,9,0,Wednesday,1,Clear,0.72,0.6515,0.45,0.3881,32,189,221,551,221,221
4213,2011-06-29,Fall,2011,Jun,10,0,Wednesday,1,Clear,0.74,0.6667,0.42,0.2836,31,95,126,551,126,126
4214,2011-06-29,Fall,2011,Jun,11,0,Wednesday,1,Clear,0.76,0.6667,0.35,0.2239,53,117,170,551,170,170
4215,2011-06-29,Fall,2011,Jun,12,0,Wednesday,1,Clear,0.76,0.6667,0.35,0.2537,55,188,243,551,243,243
4216,2011-06-29,Fall,2011,Jun,13,0,Wednesday,1,Clear,0.8,0.697,0.31,0.3284,45,186,231,551,231,231
4217,2011-06-29,Fall,2011,Jun,14,0,Wednesday,1,Clear,0.8,0.697,0.31,0.194,50,138,188,551,188,188
4218,2011-06-29,Fall,2011,Jun,15,0,Wednesday,1,Clear,0.82,0.7121,0.3,0.1642,43,146,189,551,189,189
4219,2011-06-29,Fall,2011,Jun,16,0,Wednesday,1,Clear,0.82,0.7121,0.3,0.4179,60,268,328,551,328,328
4220,2011-06-29,Fall,2011,Jun,17,0,Wednesday,1,Clear,0.82,0.7121,0.26,0.4179,78,492,570,551,570,570
4221,2011-06-29,Fall,2011,Jun,18,0,Wednesday,1,Clear,0.8,0.697,0.29,0.2985,78,510,588,551,588,588
4222,2011-06-29,Fall,2011,Jun,19,0,Wednesday,1,Clear,0.76,0.6667,0.35,0.3881,60,341,401,551,401,401
4223,2011-06-29,Fall,2011,Jun,20,0,Wednesday,1,Clear,0.74,0.6515,0.37,0.2985,69,264,333,551,333,333
4224,2011-06-29,Fall,2011,Jun,21,0,Wednesday,1,Clear,0.72,0.6515,0.39,0.2239,26,195,221,551,221,221
4225,2011-06-29,Fall,2011,Jun,22,0,Wednesday,1,Clear,0.7,0.6364,0.42,0.194,32,151,183,551,183,183
4226,2011-06-29,Fall,2011,Jun,23,0,Wednesday,1,Clear,0.68,0.6364,0.47,0.194,32,97,129,551,129,129
4227,2011-06-30,Fall,2011,Jun,0,0,Thursday,1,Clear,0.66,0.6212,0.5,0.1642,15,39,54,550,54,54
4228,2011-06-30,Fall,2011,Jun,1,0,Thursday,1,Clear,0.64,0.6212,0.53,0.1343,13,19,32,550,32,32
4229,2011-06-30,Fall,2011,Jun,2,0,Thursday,1,Clear,0.62,0.6212,0.57,0.1343,2,6,8,550,8,8
4230,2011-06-30,Fall,2011,Jun,3,0,Thursday,1,Clear,0.6,0.6061,0.6,0.1642,2,7,9,550,9,9
4231,2011-06-30,Fall,2011,Jun,4,0,Thursday,1,Clear,0.58,0.5455,0.64,0.1343,2,4,6,550,6,6
4232,2011-06-30,Fall,2011,Jun,5,0,Thursday,1,Clear,0.58,0.5455,0.64,0.2537,1,24,25,550,25,25
4233,2011-06-30,Fall,2011,Jun,6,0,Thursday,1,Clear,0.6,0.6061,0.64,0.2537,4,119,123,550,123,123
4234,2011-06-30,Fall,2011,Jun,7,0,Thursday,1,Clear,0.62,0.6061,0.61,0.2239,29,291,320,550,320,320
4235,2011-06-30,Fall,2011,Jun,8,0,Thursday,1,Clear,0.68,0.6364,0.47,0.2239,44,511,555,550,555,555
4236,2011-06-30,Fall,2011,Jun,9,0,Thursday,1,Clear,0.7,0.6364,0.42,0.2239,33,227,260,550,260,260
4237,2011-06-30,Fall,2011,Jun,10,0,Thursday,1,Clear,0.72,0.6515,0.42,0.194,35,97,132,550,132,132
4238,2011-06-30,Fall,2011,Jun,11,0,Thursday,1,Clear,0.74,0.6515,0.37,0.1343,47,122,169,550,169,169
4239,2011-06-30,Fall,2011,Jun,12,0,Thursday,1,Clear,0.76,0.6667,0.35,0.1642,50,183,233,550,233,233
4240,2011-06-30,Fall,2011,Jun,13,0,Thursday,1,Clear,0.76,0.6667,0.33,0.194,70,162,232,550,232,232
4241,2011-06-30,Fall,2011,Jun,14,0,Thursday,1,Clear,0.78,0.6818,0.31,0.194,46,117,163,550,163,163
4242,2011-06-30,Fall,2011,Jun,15,0,Thursday,1,Clear,0.78,0.6667,0.25,0.2537,64,176,240,550,240,240
4243,2011-06-30,Fall,2011,Jun,16,0,Thursday,1,Clear,0.8,0.697,0.26,0.1343,63,260,323,550,323,323
4244,2011-06-30,Fall,2011,Jun,17,0,Thursday,1,Clear,0.78,0.6818,0.27,0.3582,98,496,594,550,594,594
4245,2011-06-30,Fall,2011,Jun,18,0,Thursday,1,Clear,0.76,0.6667,0.29,0.2537,114,472,586,550,586,586
4246,2011-06-30,Fall,2011,Jun,19,0,Thursday,1,Clear,0.74,0.6515,0.33,0.194,89,366,455,550,455,455
4247,2011-06-30,Fall,2011,Jun,20,0,Thursday,1,Clear,0.74,0.6515,0.33,0.194,55,285,340,550,340,340
4248,2011-06-30,Fall,2011,Jun,21,0,Thursday,1,Clear,0.72,0.6515,0.37,0.1045,81,242,323,550,323,323
4249,2011-06-30,Fall,2011,Jun,22,0,Thursday,1,Clear,0.7,0.6364,0.42,0.1642,43,164,207,550,207,207
4250,2011-06-30,Fall,2011,Jun,23,0,Thursday,1,Clear,0.66,0.6212,0.5,0.0,27,99,126,550,126,126
4251,2011-07-01,Fall,2011,Jul,0,0,Friday,1,Clear,0.66,0.6212,0.5,0.0,20,48,68,549,68,68
4252,2011-07-01,Fall,2011,Jul,1,0,Friday,1,Clear,0.66,0.6212,0.5,0.0,15,16,31,549,31,31
4253,2011-07-01,Fall,2011,Jul,2,0,Friday,1,Clear,0.62,0.6061,0.69,0.0,6,7,13,549,13,13
4254,2011-07-01,Fall,2011,Jul,3,0,Friday,1,Clear,0.64,0.6212,0.53,0.0,5,6,11,549,11,11
4255,2011-07-01,Fall,2011,Jul,4,0,Friday,1,Clear,0.62,0.6212,0.57,0.0,1,5,6,549,6,6
4256,2011-07-01,Fall,2011,Jul,5,0,Friday,1,Clear,0.6,0.6061,0.64,0.1343,3,27,30,549,30,30
4257,2011-07-01,Fall,2011,Jul,6,0,Friday,1,Clear,0.62,0.6061,0.61,0.1343,11,97,108,549,108,108
4258,2011-07-01,Fall,2011,Jul,7,0,Friday,1,Clear,0.66,0.6212,0.54,0.1045,25,218,243,549,243,243
4259,2011-07-01,Fall,2011,Jul,8,0,Friday,1,Clear,0.7,0.6364,0.42,0.1642,39,453,492,549,492,492
4260,2011-07-01,Fall,2011,Jul,9,0,Friday,1,Clear,0.74,0.6515,0.35,0.1642,58,202,260,549,260,260
4261,2011-07-01,Fall,2011,Jul,10,0,Friday,1,Clear,0.76,0.6667,0.33,0.1642,61,109,170,549,170,170
4262,2011-07-01,Fall,2011,Jul,11,0,Friday,1,Clear,0.8,0.697,0.26,0.0,68,146,214,549,214,214
4263,2011-07-01,Fall,2011,Jul,12,0,Friday,1,Clear,0.8,0.697,0.26,0.0,83,180,263,549,263,263
4264,2011-07-01,Fall,2011,Jul,13,0,Friday,1,Clear,0.8,0.6818,0.24,0.0,83,209,292,549,292,292
4265,2011-07-01,Fall,2011,Jul,14,0,Friday,1,Clear,0.82,0.697,0.23,0.194,78,225,303,549,303,303
4266,2011-07-01,Fall,2011,Jul,15,0,Friday,1,Clear,0.82,0.697,0.21,0.2537,82,299,381,549,381,381
4267,2011-07-01,Fall,2011,Jul,16,0,Friday,1,Clear,0.82,0.697,0.17,0.0,85,342,427,549,427,427
4268,2011-07-01,Fall,2011,Jul,17,0,Friday,1,Clear,0.82,0.697,0.21,0.194,99,362,461,549,461,461
4269,2011-07-01,Fall,2011,Jul,18,0,Friday,1,Clear,0.8,0.6818,0.24,0.2537,98,324,422,549,422,422
4270,2011-07-01,Fall,2011,Jul,19,0,Friday,1,Clear,0.78,0.6667,0.25,0.194,80,238,318,549,318,318
4271,2011-07-01,Fall,2011,Jul,20,0,Friday,1,Clear,0.72,0.6515,0.42,0.2239,84,185,269,549,269,269
4272,2011-07-01,Fall,2011,Jul,21,0,Friday,1,Clear,0.7,0.6364,0.45,0.194,69,149,218,549,218,218
4273,2011-07-01,Fall,2011,Jul,22,0,Friday,1,Clear,0.7,0.6364,0.42,0.0,49,173,222,549,222,222
4274,2011-07-01,Fall,2011,Jul,23,0,Friday,1,Clear,0.68,0.6364,0.47,0.0896,44,96,140,549,140,140
4275,2011-07-02,Fall,2011,Jul,0,0,Saturday,0,Clear,0.68,0.6364,0.47,0.0896,31,84,115,548,115,115
4276,2011-07-02,Fall,2011,Jul,1,0,Saturday,0,Clear,0.66,0.6212,0.54,0.0,20,58,78,548,78,78
4277,2011-07-02,Fall,2011,Jul,2,0,Saturday,0,Clear,0.64,0.6212,0.53,0.0,9,43,52,548,52,52
4278,2011-07-02,Fall,2011,Jul,3,0,Saturday,0,Clear,0.64,0.6212,0.53,0.0,5,21,26,548,26,26
4279,2011-07-02,Fall,2011,Jul,4,0,Saturday,0,Clear,0.62,0.6061,0.61,0.0,3,8,11,548,11,11
4280,2011-07-02,Fall,2011,Jul,5,0,Saturday,0,Clear,0.58,0.5455,0.73,0.1045,1,13,14,548,14,14
4281,2011-07-02,Fall,2011,Jul,6,0,Saturday,0,Clear,0.62,0.6061,0.69,0.1045,11,21,32,548,32,32
4282,2011-07-02,Fall,2011,Jul,7,0,Saturday,0,Clear,0.64,0.6061,0.65,0.0,10,35,45,548,45,45
4283,2011-07-02,Fall,2011,Jul,8,0,Saturday,0,Clear,0.68,0.6364,0.57,0.0,38,94,132,548,132,132
4284,2011-07-02,Fall,2011,Jul,9,0,Saturday,0,Clear,0.74,0.6667,0.51,0.0896,55,124,179,548,179,179
4285,2011-07-02,Fall,2011,Jul,10,0,Saturday,0,Clear,0.8,0.7121,0.36,0.0,103,168,271,548,271,271
4286,2011-07-02,Fall,2011,Jul,11,0,Saturday,0,Clear,0.8,0.7121,0.36,0.0896,144,213,357,548,357,357
4287,2011-07-02,Fall,2011,Jul,12,0,Saturday,0,Clear,0.82,0.7121,0.3,0.1343,142,232,374,548,374,374
4288,2011-07-02,Fall,2011,Jul,13,0,Saturday,0,Clear,0.82,0.7121,0.3,0.1045,178,226,404,548,404,404
4289,2011-07-02,Fall,2011,Jul,14,0,Saturday,0,Clear,0.84,0.7121,0.2,0.0,177,215,392,548,392,392
4290,2011-07-02,Fall,2011,Jul,15,0,Saturday,0,Clear,0.86,0.7273,0.19,0.1642,168,163,331,548,331,331
4291,2011-07-02,Fall,2011,Jul,16,0,Saturday,0,Clear,0.88,0.7424,0.22,0.2239,206,192,398,548,398,398
4292,2011-07-02,Fall,2011,Jul,17,0,Saturday,0,Clear,0.84,0.7273,0.3,0.2239,179,170,349,548,349,349
4293,2011-07-02,Fall,2011,Jul,18,0,Saturday,0,Clear,0.82,0.7121,0.3,0.2836,193,190,383,548,383,383
4294,2011-07-02,Fall,2011,Jul,19,0,Saturday,0,Clear,0.8,0.697,0.33,0.2239,156,149,305,548,305,305
4295,2011-07-02,Fall,2011,Jul,20,0,Saturday,0,Clear,0.76,0.6818,0.45,0.2836,136,148,284,548,284,284
4296,2011-07-02,Fall,2011,Jul,21,0,Saturday,0,Clear,0.74,0.6667,0.48,0.194,95,137,232,548,232,232
4297,2011-07-02,Fall,2011,Jul,22,0,Saturday,0,Clear,0.72,0.6667,0.51,0.1642,78,123,201,548,201,201
4298,2011-07-02,Fall,2011,Jul,23,0,Saturday,0,Clear,0.72,0.6667,0.54,0.2836,66,88,154,548,154,154
4299,2011-07-03,Fall,2011,Jul,0,0,Sunday,0,Clear,0.7,0.6515,0.58,0.2239,47,97,144,547,144,144
4300,2011-07-03,Fall,2011,Jul,1,0,Sunday,0,Misty,0.7,0.6515,0.61,0.1642,23,55,78,547,78,78
4301,2011-07-03,Fall,2011,Jul,2,0,Sunday,0,Clear,0.7,0.6515,0.58,0.194,19,50,69,547,69,69
4302,2011-07-03,Fall,2011,Jul,3,0,Sunday,0,Light_rainsnow,0.68,0.6364,0.65,0.0896,8,25,33,547,33,33
4303,2011-07-03,Fall,2011,Jul,4,0,Sunday,0,Light_rainsnow,0.68,0.6364,0.65,0.0896,3,2,5,547,5,5
4304,2011-07-03,Fall,2011,Jul,5,0,Sunday,0,Light_rainsnow,0.62,0.5758,0.83,0.194,0,1,1,547,1,1
4305,2011-07-03,Fall,2011,Jul,6,0,Sunday,0,Misty,0.62,0.5455,0.94,0.0896,0,3,3,547,3,3
4306,2011-07-03,Fall,2011,Jul,7,0,Sunday,0,Misty,0.64,0.5758,0.89,0.194,3,22,25,547,25,25
4307,2011-07-03,Fall,2011,Jul,8,0,Sunday,0,Clear,0.68,0.6364,0.79,0.2239,39,53,92,547,92,92
4308,2011-07-03,Fall,2011,Jul,9,0,Sunday,0,Clear,0.7,0.6667,0.74,0.2537,82,99,181,547,181,181
4309,2011-07-03,Fall,2011,Jul,10,0,Sunday,0,Clear,0.74,0.697,0.66,0.1642,131,133,264,547,264,264
4310,2011-07-03,Fall,2011,Jul,11,0,Sunday,0,Clear,0.76,0.7121,0.62,0.1045,215,175,390,547,390,390
4311,2011-07-03,Fall,2011,Jul,12,0,Sunday,0,Clear,0.8,0.7576,0.55,0.1045,198,206,404,547,404,404
4312,2011-07-03,Fall,2011,Jul,13,0,Sunday,0,Clear,0.8,0.7727,0.59,0.2239,248,173,421,547,421,421
4313,2011-07-03,Fall,2011,Jul,14,0,Sunday,0,Clear,0.82,0.7879,0.56,0.2537,225,150,375,547,375,375
4314,2011-07-03,Fall,2011,Jul,15,0,Sunday,0,Clear,0.84,0.803,0.53,0.2985,194,182,376,547,376,376
4315,2011-07-03,Fall,2011,Jul,16,0,Sunday,0,Clear,0.84,0.803,0.53,0.2985,195,219,414,547,414,414
4316,2011-07-03,Fall,2011,Jul,17,0,Sunday,0,Light_rainsnow,0.8,0.7424,0.49,0.8507,181,177,358,547,358,358
4317,2011-07-03,Fall,2011,Jul,18,0,Sunday,0,Light_rainsnow,0.8,0.7424,0.49,0.8507,74,107,181,547,181,181
4318,2011-07-03,Fall,2011,Jul,19,0,Sunday,0,Misty,0.66,0.6061,0.83,0.194,100,83,183,547,183,183
4319,2011-07-03,Fall,2011,Jul,20,0,Sunday,0,Light_rainsnow,0.66,0.6061,0.83,0.0,83,93,176,547,176,176
4320,2011-07-03,Fall,2011,Jul,21,0,Sunday,0,Misty,0.66,0.6061,0.83,0.1642,75,92,167,547,167,167
4321,2011-07-03,Fall,2011,Jul,22,0,Sunday,0,Misty,0.66,0.6061,0.78,0.1045,69,93,162,547,162,162
4322,2011-07-03,Fall,2011,Jul,23,0,Sunday,0,Clear,0.64,0.5758,0.83,0.1642,70,77,147,547,147,147
4323,2011-07-04,Fall,2011,Jul,0,1,Monday,0,Clear,0.64,0.5758,0.83,0.1343,63,77,140,546,140,140
4324,2011-07-04,Fall,2011,Jul,1,1,Monday,0,Clear,0.64,0.5758,0.83,0.0896,43,76,119,546,119,119
4325,2011-07-04,Fall,2011,Jul,2,1,Monday,0,Clear,0.64,0.5758,0.83,0.0,33,30,63,546,63,63
4326,2011-07-04,Fall,2011,Jul,3,1,Monday,0,Clear,0.64,0.5909,0.78,0.0,13,13,26,546,26,26
4327,2011-07-04,Fall,2011,Jul,4,1,Monday,0,Misty,0.66,0.6061,0.78,0.0896,8,4,12,546,12,12
4328,2011-07-04,Fall,2011,Jul,5,1,Monday,0,Misty,0.64,0.5758,0.83,0.1343,1,3,4,546,4,4
4329,2011-07-04,Fall,2011,Jul,6,1,Monday,0,Clear,0.64,0.5758,0.89,0.1642,5,11,16,546,16,16
4330,2011-07-04,Fall,2011,Jul,7,1,Monday,0,Clear,0.66,0.6061,0.83,0.1343,17,19,36,546,36,36
4331,2011-07-04,Fall,2011,Jul,8,1,Monday,0,Clear,0.7,0.6667,0.74,0.1045,42,44,86,546,86,86
4332,2011-07-04,Fall,2011,Jul,9,1,Monday,0,Misty,0.72,0.6818,0.66,0.0896,142,96,238,546,238,238
4333,2011-07-04,Fall,2011,Jul,10,1,Monday,0,Misty,0.76,0.697,0.55,0.0896,166,114,280,546,280,280
4334,2011-07-04,Fall,2011,Jul,11,1,Monday,0,Misty,0.76,0.697,0.55,0.0896,177,172,349,546,349,349
4335,2011-07-04,Fall,2011,Jul,12,1,Monday,0,Misty,0.78,0.7121,0.52,0.0,237,210,447,546,447,447
4336,2011-07-04,Fall,2011,Jul,13,1,Monday,0,Misty,0.78,0.7121,0.49,0.0,242,181,423,546,423,423
4337,2011-07-04,Fall,2011,Jul,14,1,Monday,0,Clear,0.8,0.7273,0.46,0.0,235,173,408,546,408,408
4338,2011-07-04,Fall,2011,Jul,15,1,Monday,0,Clear,0.82,0.7424,0.43,0.0896,224,184,408,546,408,408
4339,2011-07-04,Fall,2011,Jul,16,1,Monday,0,Clear,0.82,0.7424,0.41,0.0,236,216,452,546,452,452
4340,2011-07-04,Fall,2011,Jul,17,1,Monday,0,Clear,0.8,0.7273,0.46,0.0,240,196,436,546,436,436
4341,2011-07-04,Fall,2011,Jul,18,1,Monday,0,Clear,0.8,0.7273,0.46,0.1343,222,196,418,546,418,418
4342,2011-07-04,Fall,2011,Jul,19,1,Monday,0,Misty,0.78,0.7121,0.49,0.1642,170,205,375,546,375,375
4343,2011-07-04,Fall,2011,Jul,20,1,Monday,0,Misty,0.76,0.697,0.55,0.1045,195,191,386,546,386,386
4344,2011-07-04,Fall,2011,Jul,21,1,Monday,0,Misty,0.74,0.6818,0.62,0.1045,195,262,457,546,457,457
4345,2011-07-04,Fall,2011,Jul,22,1,Monday,0,Misty,0.74,0.6818,0.62,0.1343,115,211,326,546,326,326
4346,2011-07-04,Fall,2011,Jul,23,1,Monday,0,Misty,0.72,0.6818,0.7,0.1045,44,94,138,546,138,138
4347,2011-07-05,Fall,2011,Jul,0,0,Tuesday,1,Misty,0.7,0.6515,0.65,0.1642,19,36,55,545,55,55
4348,2011-07-05,Fall,2011,Jul,1,0,Tuesday,1,Clear,0.7,0.6515,0.65,0.1045,15,24,39,545,39,39
4349,2011-07-05,Fall,2011,Jul,2,0,Tuesday,1,Clear,0.66,0.6212,0.74,0.0896,8,5,13,545,13,13
4350,2011-07-05,Fall,2011,Jul,3,0,Tuesday,1,Clear,0.66,0.6212,0.74,0.2239,1,7,8,545,8,8
4351,2011-07-05,Fall,2011,Jul,4,0,Tuesday,1,Clear,0.66,0.6212,0.69,0.1642,1,4,5,545,5,5
4352,2011-07-05,Fall,2011,Jul,5,0,Tuesday,1,Clear,0.66,0.6212,0.69,0.0,1,19,20,545,20,20
4353,2011-07-05,Fall,2011,Jul,6,0,Tuesday,1,Clear,0.66,0.6212,0.74,0.0896,3,91,94,545,94,94
4354,2011-07-05,Fall,2011,Jul,7,0,Tuesday,1,Clear,0.7,0.6515,0.65,0.0896,22,248,270,545,270,270
4355,2011-07-05,Fall,2011,Jul,8,0,Tuesday,1,Clear,0.72,0.6818,0.62,0.1343,41,391,432,545,432,432
4356,2011-07-05,Fall,2011,Jul,9,0,Tuesday,1,Clear,0.74,0.6818,0.58,0.1343,50,177,227,545,227,227
4357,2011-07-05,Fall,2011,Jul,10,0,Tuesday,1,Clear,0.76,0.697,0.52,0.1045,55,84,139,545,139,139
4358,2011-07-05,Fall,2011,Jul,11,0,Tuesday,1,Clear,0.78,0.697,0.46,0.1045,75,97,172,545,172,172
4359,2011-07-05,Fall,2011,Jul,12,0,Tuesday,1,Clear,0.8,0.7273,0.43,0.1045,71,130,201,545,201,201
4360,2011-07-05,Fall,2011,Jul,13,0,Tuesday,1,Clear,0.82,0.7424,0.43,0.1045,67,136,203,545,203,203
4361,2011-07-05,Fall,2011,Jul,14,0,Tuesday,1,Clear,0.8,0.7424,0.49,0.1642,66,112,178,545,178,178
4362,2011-07-05,Fall,2011,Jul,15,0,Tuesday,1,Clear,0.82,0.7424,0.43,0.0,51,111,162,545,162,162
4363,2011-07-05,Fall,2011,Jul,16,0,Tuesday,1,Clear,0.82,0.7576,0.46,0.1045,79,202,281,545,281,281
4364,2011-07-05,Fall,2011,Jul,17,0,Tuesday,1,Clear,0.82,0.7576,0.46,0.1045,79,466,545,545,545,545
4365,2011-07-05,Fall,2011,Jul,18,0,Tuesday,1,Clear,0.8,0.7576,0.55,0.1642,70,426,496,545,496,496
4366,2011-07-05,Fall,2011,Jul,19,0,Tuesday,1,Clear,0.8,0.7727,0.59,0.1343,71,297,368,545,368,368
4367,2011-07-05,Fall,2011,Jul,20,0,Tuesday,1,Clear,0.76,0.7273,0.66,0.1045,59,225,284,545,284,284
4368,2011-07-05,Fall,2011,Jul,21,0,Tuesday,1,Clear,0.78,0.7424,0.62,0.2537,77,168,245,545,245,245
4369,2011-07-05,Fall,2011,Jul,22,0,Tuesday,1,Clear,0.76,0.7273,0.66,0.2239,31,124,155,545,155,155
4370,2011-07-05,Fall,2011,Jul,23,0,Tuesday,1,Clear,0.74,0.697,0.66,0.1642,19,54,73,545,73,73
4371,2011-07-06,Fall,2011,Jul,0,0,Wednesday,1,Clear,0.72,0.697,0.74,0.194,11,26,37,544,37,37
4372,2011-07-06,Fall,2011,Jul,1,0,Wednesday,1,Clear,0.7,0.6667,0.74,0.1343,4,11,15,544,15,15
4373,2011-07-06,Fall,2011,Jul,2,0,Wednesday,1,Clear,0.7,0.6667,0.79,0.0896,1,4,5,544,5,5
4374,2011-07-06,Fall,2011,Jul,3,0,Wednesday,1,Clear,0.7,0.6667,0.79,0.0,0,6,6,544,6,6
4375,2011-07-06,Fall,2011,Jul,4,0,Wednesday,1,Misty,0.68,0.6364,0.83,0.0896,0,6,6,544,6,6
4376,2011-07-06,Fall,2011,Jul,5,0,Wednesday,1,Clear,0.68,0.6364,0.83,0.0896,5,30,35,544,35,35
4377,2011-07-06,Fall,2011,Jul,6,0,Wednesday,1,Clear,0.7,0.6667,0.79,0.0896,9,112,121,544,121,121
4378,2011-07-06,Fall,2011,Jul,7,0,Wednesday,1,Misty,0.72,0.697,0.79,0.0,24,288,312,544,312,312
4379,2011-07-06,Fall,2011,Jul,8,0,Wednesday,1,Misty,0.72,0.697,0.74,0.1045,31,397,428,544,428,428
4380,2011-07-06,Fall,2011,Jul,9,0,Wednesday,1,Light_rainsnow,0.7,0.6667,0.79,0.194,31,158,189,544,189,189
4381,2011-07-06,Fall,2011,Jul,10,0,Wednesday,1,Light_rainsnow,0.7,0.6667,0.79,0.0896,13,30,43,544,43,43
4382,2011-07-06,Fall,2011,Jul,11,0,Wednesday,1,Misty,0.72,0.697,0.74,0.0,24,103,127,544,127,127
4383,2011-07-06,Fall,2011,Jul,12,0,Wednesday,1,Misty,0.74,0.697,0.66,0.0896,38,114,152,544,152,152
4384,2011-07-06,Fall,2011,Jul,13,0,Wednesday,1,Misty,0.74,0.697,0.7,0.1045,33,107,140,544,140,140
4385,2011-07-06,Fall,2011,Jul,14,0,Wednesday,1,Clear,0.76,0.7273,0.66,0.2836,50,113,163,544,163,163
4386,2011-07-06,Fall,2011,Jul,15,0,Wednesday,1,Clear,0.76,0.7273,0.7,0.2836,55,130,185,544,185,185
4387,2011-07-06,Fall,2011,Jul,16,0,Wednesday,1,Clear,0.76,0.7273,0.7,0.2537,57,218,275,544,275,275
4388,2011-07-06,Fall,2011,Jul,17,0,Wednesday,1,Clear,0.78,0.7424,0.59,0.2239,79,517,596,544,596,596
4389,2011-07-06,Fall,2011,Jul,18,0,Wednesday,1,Clear,0.76,0.7121,0.62,0.194,77,486,563,544,563,563
4390,2011-07-06,Fall,2011,Jul,19,0,Wednesday,1,Clear,0.74,0.697,0.7,0.2239,71,323,394,544,394,394
4391,2011-07-06,Fall,2011,Jul,20,0,Wednesday,1,Clear,0.72,0.697,0.74,0.2537,55,257,312,544,312,312
4392,2011-07-06,Fall,2011,Jul,21,0,Wednesday,1,Clear,0.7,0.6667,0.79,0.194,66,175,241,544,241,241
4393,2011-07-06,Fall,2011,Jul,22,0,Wednesday,1,Clear,0.7,0.6667,0.79,0.194,30,156,186,544,186,186
4394,2011-07-06,Fall,2011,Jul,23,0,Wednesday,1,Clear,0.68,0.6364,0.83,0.2239,20,78,98,544,98,98
4395,2011-07-07,Fall,2011,Jul,0,0,Thursday,1,Clear,0.66,0.5909,0.89,0.1343,6,29,35,543,35,35
4396,2011-07-07,Fall,2011,Jul,1,0,Thursday,1,Clear,0.66,0.5909,0.89,0.194,2,14,16,543,16,16
4397,2011-07-07,Fall,2011,Jul,2,0,Thursday,1,Clear,0.66,0.5909,0.89,0.194,1,7,8,543,8,8
4398,2011-07-07,Fall,2011,Jul,3,0,Thursday,1,Clear,0.64,0.5606,0.94,0.1045,2,2,4,543,4,4
4399,2011-07-07,Fall,2011,Jul,4,0,Thursday,1,Clear,0.64,0.5758,0.89,0.1045,0,4,4,543,4,4
4400,2011-07-07,Fall,2011,Jul,5,0,Thursday,1,Clear,0.64,0.5758,0.89,0.1045,2,30,32,543,32,32
4401,2011-07-07,Fall,2011,Jul,6,0,Thursday,1,Misty,0.64,0.5758,0.89,0.1343,11,107,118,543,118,118
4402,2011-07-07,Fall,2011,Jul,7,0,Thursday,1,Misty,0.66,0.5909,0.89,0.1045,13,279,292,543,292,292
4403,2011-07-07,Fall,2011,Jul,8,0,Thursday,1,Misty,0.7,0.6667,0.79,0.194,28,415,443,543,443,443
4404,2011-07-07,Fall,2011,Jul,9,0,Thursday,1,Clear,0.74,0.697,0.7,0.1642,25,154,179,543,179,179
4405,2011-07-07,Fall,2011,Jul,10,0,Thursday,1,Clear,0.78,0.7424,0.62,0.0,29,72,101,543,101,101
4406,2011-07-07,Fall,2011,Jul,11,0,Thursday,1,Clear,0.82,0.7727,0.52,0.1343,30,112,142,543,142,142
4407,2011-07-07,Fall,2011,Jul,12,0,Thursday,1,Clear,0.84,0.7727,0.41,0.0,32,139,171,543,171,171
4408,2011-07-07,Fall,2011,Jul,13,0,Thursday,1,Clear,0.86,0.7879,0.41,0.0,48,107,155,543,155,155
4409,2011-07-07,Fall,2011,Jul,14,0,Thursday,1,Clear,0.86,0.7879,0.41,0.2537,39,121,160,543,160,160
4410,2011-07-07,Fall,2011,Jul,15,0,Thursday,1,Clear,0.86,0.7879,0.41,0.2537,47,119,166,543,166,166
4411,2011-07-07,Fall,2011,Jul,16,0,Thursday,1,Clear,0.86,0.7727,0.39,0.2239,47,218,265,543,265,265
4412,2011-07-07,Fall,2011,Jul,17,0,Thursday,1,Clear,0.86,0.7576,0.36,0.2537,80,489,569,543,569,569
4413,2011-07-07,Fall,2011,Jul,18,0,Thursday,1,Clear,0.84,0.7576,0.44,0.2985,70,492,562,543,562,562
4414,2011-07-07,Fall,2011,Jul,19,0,Thursday,1,Clear,0.82,0.7727,0.52,0.2836,79,286,365,543,365,365
4415,2011-07-07,Fall,2011,Jul,20,0,Thursday,1,Clear,0.76,0.7121,0.58,0.3582,61,224,285,543,285,285
4416,2011-07-07,Fall,2011,Jul,21,0,Thursday,1,Clear,0.74,0.6818,0.62,0.1642,39,170,209,543,209,209
4417,2011-07-07,Fall,2011,Jul,22,0,Thursday,1,Clear,0.74,0.6818,0.62,0.1642,32,150,182,543,182,182
4418,2011-07-07,Fall,2011,Jul,23,0,Thursday,1,Clear,0.72,0.6818,0.66,0.0,31,98,129,543,129,129
4419,2011-07-08,Fall,2011,Jul,0,0,Friday,1,Clear,0.74,0.697,0.66,0.1045,6,41,47,542,47,47
4420,2011-07-08,Fall,2011,Jul,1,0,Friday,1,Clear,0.72,0.697,0.79,0.0,9,25,34,542,34,34
4421,2011-07-08,Fall,2011,Jul,2,0,Friday,1,Misty,0.7,0.6667,0.74,0.1642,10,12,22,542,22,22
4422,2011-07-08,Fall,2011,Jul,3,0,Friday,1,Clear,0.68,0.6364,0.79,0.1045,2,4,6,542,6,6
4423,2011-07-08,Fall,2011,Jul,4,0,Friday,1,Clear,0.7,0.6667,0.79,0.2537,7,4,11,542,11,11
4424,2011-07-08,Fall,2011,Jul,5,0,Friday,1,Clear,0.68,0.6364,0.79,0.2537,3,24,27,542,27,27
4425,2011-07-08,Fall,2011,Jul,6,0,Friday,1,Clear,0.7,0.6667,0.74,0.1045,11,91,102,542,102,102
4426,2011-07-08,Fall,2011,Jul,7,0,Friday,1,Misty,0.7,0.6667,0.79,0.194,30,302,332,542,332,332
4427,2011-07-08,Fall,2011,Jul,8,0,Friday,1,Misty,0.72,0.697,0.74,0.2537,36,421,457,542,457,457
4428,2011-07-08,Fall,2011,Jul,9,0,Friday,1,Misty,0.76,0.7273,0.7,0.2985,30,211,241,542,241,241
4429,2011-07-08,Fall,2011,Jul,10,0,Friday,1,Misty,0.74,0.697,0.7,0.3582,30,108,138,542,138,138
4430,2011-07-08,Fall,2011,Jul,11,0,Friday,1,Misty,0.74,0.7121,0.74,0.2537,61,104,165,542,165,165
4431,2011-07-08,Fall,2011,Jul,12,0,Friday,1,Misty,0.76,0.7273,0.7,0.2836,49,164,213,542,213,213
4432,2011-07-08,Fall,2011,Jul,13,0,Friday,1,Misty,0.78,0.7576,0.66,0.2836,54,175,229,542,229,229
4433,2011-07-08,Fall,2011,Jul,14,0,Friday,1,Misty,0.8,0.7879,0.63,0.3582,53,163,216,542,216,216
4434,2011-07-08,Fall,2011,Jul,15,0,Friday,1,Misty,0.8,0.7879,0.63,0.3582,39,102,141,542,141,141
4435,2011-07-08,Fall,2011,Jul,16,0,Friday,1,Light_rainsnow,0.68,0.6364,0.83,0.4478,27,105,132,542,132,132
4436,2011-07-08,Fall,2011,Jul,17,0,Friday,1,Light_rainsnow,0.66,0.5909,0.89,0.4478,6,161,167,542,167,167
4437,2011-07-08,Fall,2011,Jul,18,0,Friday,1,Clear,0.66,0.6061,0.83,0.0896,35,281,316,542,316,316
4438,2011-07-08,Fall,2011,Jul,19,0,Friday,1,Clear,0.66,0.6061,0.83,0.0896,45,225,270,542,270,270
4439,2011-07-08,Fall,2011,Jul,20,0,Friday,1,Clear,0.66,0.6061,0.83,0.1642,30,220,250,542,250,250
4440,2011-07-08,Fall,2011,Jul,21,0,Friday,1,Misty,0.66,0.6061,0.83,0.2537,46,158,204,542,204,204
4441,2011-07-08,Fall,2011,Jul,22,0,Friday,1,Misty,0.66,0.6061,0.78,0.194,33,136,169,542,169,169
4442,2011-07-08,Fall,2011,Jul,23,0,Friday,1,Misty,0.66,0.6061,0.78,0.0896,40,111,151,542,151,151
4443,2011-07-09,Fall,2011,Jul,0,0,Saturday,0,Misty,0.66,0.6061,0.83,0.1343,31,90,121,541,121,121
4444,2011-07-09,Fall,2011,Jul,1,0,Saturday,0,Misty,0.64,0.5758,0.89,0.1045,5,48,53,541,53,53
4445,2011-07-09,Fall,2011,Jul,2,0,Saturday,0,Clear,0.64,0.5758,0.89,0.1642,12,43,55,541,55,55
4446,2011-07-09,Fall,2011,Jul,3,0,Saturday,0,Clear,0.64,0.5758,0.89,0.1343,7,23,30,541,30,30
4447,2011-07-09,Fall,2011,Jul,4,0,Saturday,0,Clear,0.64,0.5758,0.83,0.2239,2,4,6,541,6,6
4448,2011-07-09,Fall,2011,Jul,5,0,Saturday,0,Misty,0.62,0.5606,0.88,0.1642,4,11,15,541,15,15
4449,2011-07-09,Fall,2011,Jul,6,0,Saturday,0,Misty,0.64,0.5758,0.83,0.194,11,27,38,541,38,38
4450,2011-07-09,Fall,2011,Jul,7,0,Saturday,0,Clear,0.66,0.6061,0.78,0.194,21,50,71,541,71,71
4451,2011-07-09,Fall,2011,Jul,8,0,Saturday,0,Clear,0.7,0.6515,0.7,0.2537,68,114,182,541,182,182
4452,2011-07-09,Fall,2011,Jul,9,0,Saturday,0,Clear,0.74,0.6818,0.58,0.2836,77,170,247,541,247,247
4453,2011-07-09,Fall,2011,Jul,10,0,Saturday,0,Clear,0.76,0.697,0.52,0.1642,87,177,264,541,264,264
4454,2011-07-09,Fall,2011,Jul,11,0,Saturday,0,Clear,0.78,0.697,0.46,0.2985,101,189,290,541,290,290
4455,2011-07-09,Fall,2011,Jul,12,0,Saturday,0,Clear,0.8,0.7273,0.46,0.2537,145,221,366,541,366,366
4456,2011-07-09,Fall,2011,Jul,13,0,Saturday,0,Clear,0.82,0.7424,0.41,0.2239,167,249,416,541,416,416
4457,2011-07-09,Fall,2011,Jul,14,0,Saturday,0,Clear,0.84,0.7424,0.36,0.1343,158,215,373,541,373,373
4458,2011-07-09,Fall,2011,Jul,15,0,Saturday,0,Clear,0.84,0.7273,0.34,0.0896,182,220,402,541,402,402
4459,2011-07-09,Fall,2011,Jul,16,0,Saturday,0,Clear,0.82,0.7273,0.38,0.0,171,245,416,541,416,416
4460,2011-07-09,Fall,2011,Jul,17,0,Saturday,0,Clear,0.84,0.7273,0.32,0.0,160,241,401,541,401,401
4461,2011-07-09,Fall,2011,Jul,18,0,Saturday,0,Clear,0.82,0.7273,0.36,0.1045,132,246,378,541,378,378
4462,2011-07-09,Fall,2011,Jul,19,0,Saturday,0,Clear,0.76,0.697,0.55,0.1642,128,178,306,541,306,306
4463,2011-07-09,Fall,2011,Jul,20,0,Saturday,0,Clear,0.76,0.7121,0.58,0.2239,129,185,314,541,314,314
4464,2011-07-09,Fall,2011,Jul,21,0,Saturday,0,Clear,0.74,0.6818,0.58,0.1642,83,155,238,541,238,238
4465,2011-07-09,Fall,2011,Jul,22,0,Saturday,0,Clear,0.72,0.6818,0.62,0.1642,60,154,214,541,214,214
4466,2011-07-09,Fall,2011,Jul,23,0,Saturday,0,Clear,0.72,0.6667,0.58,0.194,47,93,140,541,140,140
4467,2011-07-10,Fall,2011,Jul,0,0,Sunday,0,Clear,0.7,0.6515,0.61,0.1642,42,112,154,540,154,154
4468,2011-07-10,Fall,2011,Jul,1,0,Sunday,0,Clear,0.7,0.6515,0.61,0.1343,19,94,113,540,113,113
4469,2011-07-10,Fall,2011,Jul,2,0,Sunday,0,Clear,0.68,0.6364,0.69,0.0896,28,68,96,540,96,96
4470,2011-07-10,Fall,2011,Jul,3,0,Sunday,0,Clear,0.66,0.6212,0.74,0.0896,6,19,25,540,25,25
4471,2011-07-10,Fall,2011,Jul,4,0,Sunday,0,Clear,0.66,0.6212,0.69,0.0896,0,5,5,540,5,5
4472,2011-07-10,Fall,2011,Jul,5,0,Sunday,0,Clear,0.66,0.6212,0.74,0.0,7,10,17,540,17,17
4473,2011-07-10,Fall,2011,Jul,6,0,Sunday,0,Clear,0.64,0.5909,0.78,0.0896,8,17,25,540,25,25
4474,2011-07-10,Fall,2011,Jul,7,0,Sunday,0,Clear,0.7,0.6515,0.7,0.0896,27,38,65,540,65,65
4475,2011-07-10,Fall,2011,Jul,8,0,Sunday,0,Clear,0.72,0.6818,0.66,0.0,27,65,92,540,92,92
4476,2011-07-10,Fall,2011,Jul,9,0,Sunday,0,Clear,0.74,0.697,0.66,0.0896,62,107,169,540,169,169
4477,2011-07-10,Fall,2011,Jul,10,0,Sunday,0,Clear,0.76,0.697,0.55,0.1343,95,173,268,540,268,268
4478,2011-07-10,Fall,2011,Jul,11,0,Sunday,0,Clear,0.78,0.7273,0.55,0.194,110,177,287,540,287,287
4479,2011-07-10,Fall,2011,Jul,12,0,Sunday,0,Clear,0.82,0.7576,0.46,0.2836,133,244,377,540,377,377
4480,2011-07-10,Fall,2011,Jul,13,0,Sunday,0,Clear,0.8,0.7273,0.46,0.2985,139,228,367,540,367,367
4481,2011-07-10,Fall,2011,Jul,14,0,Sunday,0,Clear,0.82,0.7424,0.41,0.3284,122,227,349,540,349,349
4482,2011-07-10,Fall,2011,Jul,15,0,Sunday,0,Clear,0.84,0.7424,0.39,0.2836,142,219,361,540,361,361
4483,2011-07-10,Fall,2011,Jul,16,0,Sunday,0,Clear,0.84,0.7576,0.41,0.2836,128,244,372,540,372,372
4484,2011-07-10,Fall,2011,Jul,17,0,Sunday,0,Clear,0.84,0.7424,0.36,0.2239,146,217,363,540,363,363
4485,2011-07-10,Fall,2011,Jul,18,0,Sunday,0,Clear,0.82,0.7424,0.43,0.2836,141,222,363,540,363,363
4486,2011-07-10,Fall,2011,Jul,19,0,Sunday,0,Clear,0.8,0.7424,0.49,0.3284,120,183,303,540,303,303
4487,2011-07-10,Fall,2011,Jul,20,0,Sunday,0,Clear,0.76,0.697,0.55,0.194,101,167,268,540,268,268
4488,2011-07-10,Fall,2011,Jul,21,0,Sunday,0,Clear,0.74,0.6818,0.62,0.2537,65,162,227,540,227,227
4489,2011-07-10,Fall,2011,Jul,22,0,Sunday,0,Clear,0.74,0.697,0.66,0.2239,56,87,143,540,143,143
4490,2011-07-10,Fall,2011,Jul,23,0,Sunday,0,Clear,0.72,0.6818,0.66,0.2537,19,53,72,540,72,72
4491,2011-07-11,Fall,2011,Jul,0,0,Monday,1,Clear,0.7,0.6515,0.65,0.194,10,25,35,539,35,35
4492,2011-07-11,Fall,2011,Jul,1,0,Monday,1,Clear,0.7,0.6515,0.61,0.2836,5,5,10,539,10,10
4493,2011-07-11,Fall,2011,Jul,2,0,Monday,1,Clear,0.7,0.6515,0.61,0.2239,8,4,12,539,12,12
4494,2011-07-11,Fall,2011,Jul,3,0,Monday,1,Clear,0.68,0.6364,0.65,0.1642,2,8,10,539,10,10
4495,2011-07-11,Fall,2011,Jul,4,0,Monday,1,Clear,0.66,0.6212,0.74,0.2239,0,4,4,539,4,4
4496,2011-07-11,Fall,2011,Jul,5,0,Monday,1,Clear,0.66,0.6212,0.74,0.1343,5,21,26,539,26,26
4497,2011-07-11,Fall,2011,Jul,6,0,Monday,1,Clear,0.68,0.6364,0.74,0.194,19,102,121,539,121,121
4498,2011-07-11,Fall,2011,Jul,7,0,Monday,1,Clear,0.7,0.6667,0.74,0.2537,28,289,317,539,317,317
4499,2011-07-11,Fall,2011,Jul,8,0,Monday,1,Clear,0.74,0.697,0.66,0.2836,35,385,420,539,420,420
4500,2011-07-11,Fall,2011,Jul,9,0,Monday,1,Clear,0.78,0.7424,0.59,0.2985,41,167,208,539,208,208
4501,2011-07-11,Fall,2011,Jul,10,0,Monday,1,Clear,0.8,0.7576,0.55,0.3582,44,73,117,539,117,117
4502,2011-07-11,Fall,2011,Jul,11,0,Monday,1,Clear,0.82,0.7879,0.56,0.2985,39,89,128,539,128,128
4503,2011-07-11,Fall,2011,Jul,12,0,Monday,1,Clear,0.84,0.803,0.53,0.2836,40,108,148,539,148,148
4504,2011-07-11,Fall,2011,Jul,13,0,Monday,1,Clear,0.86,0.8182,0.5,0.2537,22,119,141,539,141,141
4505,2011-07-11,Fall,2011,Jul,14,0,Monday,1,Clear,0.86,0.8333,0.53,0.2836,40,94,134,539,134,134
4506,2011-07-11,Fall,2011,Jul,15,0,Monday,1,Clear,0.86,0.8485,0.56,0.4179,38,108,146,539,146,146
4507,2011-07-11,Fall,2011,Jul,16,0,Monday,1,Clear,0.86,0.8485,0.56,0.3881,57,182,239,539,239,239
4508,2011-07-11,Fall,2011,Jul,17,0,Monday,1,Clear,0.86,0.8485,0.56,0.4179,59,455,514,539,514,514
4509,2011-07-11,Fall,2011,Jul,18,0,Monday,1,Clear,0.86,0.8333,0.53,0.3881,57,415,472,539,472,472
4510,2011-07-11,Fall,2011,Jul,19,0,Monday,1,Clear,0.84,0.8333,0.59,0.3284,80,293,373,539,373,373
4511,2011-07-11,Fall,2011,Jul,20,0,Monday,1,Clear,0.72,0.697,0.74,0.4179,42,194,236,539,236,236
4512,2011-07-11,Fall,2011,Jul,21,0,Monday,1,Clear,0.7,0.6667,0.79,0.4179,21,109,130,539,130,130
4513,2011-07-11,Fall,2011,Jul,22,0,Monday,1,Clear,0.72,0.697,0.74,0.1343,20,70,90,539,90,90
4514,2011-07-11,Fall,2011,Jul,23,0,Monday,1,Clear,0.7,0.6667,0.79,0.1343,11,44,55,539,55,55
4515,2011-07-12,Fall,2011,Jul,0,0,Tuesday,1,Clear,0.7,0.6667,0.79,0.1343,3,19,22,538,22,22
4516,2011-07-12,Fall,2011,Jul,1,0,Tuesday,1,Clear,0.7,0.6667,0.79,0.0896,6,8,14,538,14,14
4517,2011-07-12,Fall,2011,Jul,2,0,Tuesday,1,Clear,0.7,0.6667,0.79,0.1045,2,7,9,538,9,9
4518,2011-07-12,Fall,2011,Jul,3,0,Tuesday,1,Misty,0.7,0.6667,0.79,0.0,2,6,8,538,8,8
4519,2011-07-12,Fall,2011,Jul,4,0,Tuesday,1,Clear,0.7,0.6667,0.79,0.1642,0,6,6,538,6,6
4520,2011-07-12,Fall,2011,Jul,5,0,Tuesday,1,Clear,0.7,0.6667,0.79,0.0896,4,21,25,538,25,25
4521,2011-07-12,Fall,2011,Jul,6,0,Tuesday,1,Clear,0.74,0.6818,0.58,0.2239,13,102,115,538,115,115
4522,2011-07-12,Fall,2011,Jul,7,0,Tuesday,1,Clear,0.76,0.697,0.55,0.194,29,301,330,538,330,330
4523,2011-07-12,Fall,2011,Jul,8,0,Tuesday,1,Clear,0.76,0.7121,0.58,0.2239,35,382,417,538,417,417
4524,2011-07-12,Fall,2011,Jul,9,0,Tuesday,1,Clear,0.78,0.7273,0.55,0.4925,27,149,176,538,176,176
4525,2011-07-12,Fall,2011,Jul,10,0,Tuesday,1,Clear,0.82,0.7727,0.52,0.1642,38,85,123,538,123,123
4526,2011-07-12,Fall,2011,Jul,11,0,Tuesday,1,Clear,0.82,0.7727,0.52,0.1642,39,86,125,538,125,125
4527,2011-07-12,Fall,2011,Jul,12,0,Tuesday,1,Clear,0.86,0.7879,0.44,0.2985,38,125,163,538,163,163
4528,2011-07-12,Fall,2011,Jul,13,0,Tuesday,1,Clear,0.86,0.803,0.47,0.2239,32,104,136,538,136,136
4529,2011-07-12,Fall,2011,Jul,14,0,Tuesday,1,Clear,0.9,0.8485,0.42,0.2985,33,91,124,538,124,124
4530,2011-07-12,Fall,2011,Jul,15,0,Tuesday,1,Clear,0.9,0.8485,0.42,0.3582,37,111,148,538,148,148
4531,2011-07-12,Fall,2011,Jul,16,0,Tuesday,1,Clear,0.86,0.7879,0.44,0.2836,25,177,202,538,202,202
4532,2011-07-12,Fall,2011,Jul,17,0,Tuesday,1,Clear,0.88,0.8182,0.44,0.2836,48,380,428,538,428,428
4533,2011-07-12,Fall,2011,Jul,18,0,Tuesday,1,Clear,0.86,0.803,0.47,0.2985,39,472,511,538,511,511
4534,2011-07-12,Fall,2011,Jul,19,0,Tuesday,1,Clear,0.84,0.7576,0.44,0.2836,42,295,337,538,337,337
4535,2011-07-12,Fall,2011,Jul,20,0,Tuesday,1,Clear,0.82,0.7424,0.43,0.194,57,251,308,538,308,308
4536,2011-07-12,Fall,2011,Jul,21,0,Tuesday,1,Clear,0.82,0.7424,0.43,0.1045,49,209,258,538,258,258
4537,2011-07-12,Fall,2011,Jul,22,0,Tuesday,1,Clear,0.8,0.7273,0.46,0.1343,44,150,194,538,194,194
4538,2011-07-12,Fall,2011,Jul,23,0,Tuesday,1,Clear,0.78,0.7121,0.52,0.0,20,59,79,538,79,79
4539,2011-07-13,Fall,2011,Jul,0,0,Wednesday,1,Clear,0.76,0.7121,0.62,0.0,9,37,46,537,46,46
4540,2011-07-13,Fall,2011,Jul,1,0,Wednesday,1,Clear,0.76,0.697,0.55,0.0,1,11,12,537,12,12
4541,2011-07-13,Fall,2011,Jul,2,0,Wednesday,1,Clear,0.76,0.697,0.55,0.0,2,3,5,537,5,5
4542,2011-07-13,Fall,2011,Jul,3,0,Wednesday,1,Clear,0.74,0.6818,0.58,0.194,0,4,4,537,4,4
4543,2011-07-13,Fall,2011,Jul,4,0,Wednesday,1,Clear,0.74,0.6818,0.58,0.2537,0,5,5,537,5,5
4544,2011-07-13,Fall,2011,Jul,5,0,Wednesday,1,Clear,0.74,0.6818,0.58,0.194,4,22,26,537,26,26
4545,2011-07-13,Fall,2011,Jul,6,0,Wednesday,1,Clear,0.74,0.6818,0.58,0.1642,18,103,121,537,121,121
4546,2011-07-13,Fall,2011,Jul,7,0,Wednesday,1,Clear,0.76,0.697,0.55,0.2537,32,281,313,537,313,313
4547,2011-07-13,Fall,2011,Jul,8,0,Wednesday,1,Clear,0.8,0.7424,0.49,0.2537,31,418,449,537,449,449
4548,2011-07-13,Fall,2011,Jul,9,0,Wednesday,1,Clear,0.82,0.7424,0.41,0.194,23,163,186,537,186,186
4549,2011-07-13,Fall,2011,Jul,10,0,Wednesday,1,Clear,0.82,0.7576,0.46,0.194,33,80,113,537,113,113
4550,2011-07-13,Fall,2011,Jul,11,0,Wednesday,1,Clear,0.84,0.7424,0.39,0.1642,55,110,165,537,165,165
4551,2011-07-13,Fall,2011,Jul,12,0,Wednesday,1,Clear,0.84,0.7576,0.41,0.2836,40,134,174,537,174,174
4552,2011-07-13,Fall,2011,Jul,13,0,Wednesday,1,Light_rainsnow,0.82,0.7576,0.46,0.1343,39,119,158,537,158,158
4553,2011-07-13,Fall,2011,Jul,14,0,Wednesday,1,Light_rainsnow,0.82,0.7576,0.46,0.1343,27,89,116,537,116,116
4554,2011-07-13,Fall,2011,Jul,15,0,Wednesday,1,Light_rainsnow,0.64,0.5606,0.94,0.1343,13,33,46,537,46,46
4555,2011-07-13,Fall,2011,Jul,16,0,Wednesday,1,Misty,0.66,0.5909,0.89,0.0,23,118,141,537,141,141
4556,2011-07-13,Fall,2011,Jul,17,0,Wednesday,1,Clear,0.7,0.6667,0.79,0.0,70,418,488,537,488,488
4557,2011-07-13,Fall,2011,Jul,18,0,Wednesday,1,Clear,0.72,0.697,0.79,0.1343,51,412,463,537,463,463
4558,2011-07-13,Fall,2011,Jul,19,0,Wednesday,1,Clear,0.7,0.6667,0.79,0.1045,79,340,419,537,419,419
4559,2011-07-13,Fall,2011,Jul,20,0,Wednesday,1,Clear,0.7,0.6667,0.84,0.1642,61,281,342,537,342,342
4560,2011-07-13,Fall,2011,Jul,21,0,Wednesday,1,Clear,0.7,0.6667,0.79,0.1045,56,194,250,537,250,250
4561,2011-07-13,Fall,2011,Jul,22,0,Wednesday,1,Clear,0.68,0.6364,0.83,0.194,48,136,184,537,184,184
4562,2011-07-13,Fall,2011,Jul,23,0,Wednesday,1,Clear,0.66,0.6061,0.83,0.2537,33,83,116,537,116,116
4563,2011-07-14,Fall,2011,Jul,0,0,Thursday,1,Clear,0.66,0.6212,0.69,0.2985,14,32,46,536,46,46
4564,2011-07-14,Fall,2011,Jul,1,0,Thursday,1,Clear,0.66,0.6212,0.61,0.2537,4,21,25,536,25,25
4565,2011-07-14,Fall,2011,Jul,2,0,Thursday,1,Clear,0.64,0.6212,0.57,0.2985,3,7,10,536,10,10
4566,2011-07-14,Fall,2011,Jul,3,0,Thursday,1,Clear,0.62,0.6212,0.57,0.2985,1,5,6,536,6,6
4567,2011-07-14,Fall,2011,Jul,4,0,Thursday,1,Clear,0.62,0.6212,0.53,0.2537,0,6,6,536,6,6
4568,2011-07-14,Fall,2011,Jul,5,0,Thursday,1,Clear,0.6,0.6212,0.56,0.2239,6,22,28,536,28,28
4569,2011-07-14,Fall,2011,Jul,6,0,Thursday,1,Clear,0.6,0.6061,0.6,0.2239,14,116,130,536,130,130
4570,2011-07-14,Fall,2011,Jul,7,0,Thursday,1,Clear,0.62,0.6212,0.53,0.2537,23,311,334,536,334,334
4571,2011-07-14,Fall,2011,Jul,8,0,Thursday,1,Clear,0.64,0.6212,0.5,0.3582,53,433,486,536,486,486
4572,2011-07-14,Fall,2011,Jul,9,0,Thursday,1,Clear,0.68,0.6364,0.47,0.2836,29,195,224,536,224,224
4573,2011-07-14,Fall,2011,Jul,10,0,Thursday,1,Clear,0.7,0.6364,0.42,0.2537,32,95,127,536,127,127
4574,2011-07-14,Fall,2011,Jul,11,0,Thursday,1,Clear,0.72,0.6515,0.37,0.2239,38,110,148,536,148,148
4575,2011-07-14,Fall,2011,Jul,12,0,Thursday,1,Clear,0.74,0.6515,0.35,0.2537,51,172,223,536,223,223
4576,2011-07-14,Fall,2011,Jul,13,0,Thursday,1,Clear,0.76,0.6667,0.33,0.3284,39,138,177,536,177,177
4577,2011-07-14,Fall,2011,Jul,14,0,Thursday,1,Clear,0.74,0.6515,0.35,0.2836,49,129,178,536,178,178
4578,2011-07-14,Fall,2011,Jul,15,0,Thursday,1,Clear,0.76,0.6667,0.33,0.2985,42,138,180,536,180,180
4579,2011-07-14,Fall,2011,Jul,16,0,Thursday,1,Clear,0.76,0.6667,0.33,0.1343,43,231,274,536,274,274
4580,2011-07-14,Fall,2011,Jul,17,0,Thursday,1,Clear,0.74,0.6515,0.37,0.1343,78,517,595,536,595,595
4581,2011-07-14,Fall,2011,Jul,18,0,Thursday,1,Clear,0.72,0.6515,0.42,0.194,94,484,578,536,578,578
4582,2011-07-14,Fall,2011,Jul,19,0,Thursday,1,Clear,0.72,0.6515,0.39,0.2239,67,333,400,536,400,400
4583,2011-07-14,Fall,2011,Jul,20,0,Thursday,1,Clear,0.7,0.6364,0.42,0.2239,81,267,348,536,348,348
4584,2011-07-14,Fall,2011,Jul,21,0,Thursday,1,Clear,0.66,0.6212,0.5,0.1343,58,203,261,536,261,261
4585,2011-07-14,Fall,2011,Jul,22,0,Thursday,1,Clear,0.64,0.6212,0.57,0.0896,42,134,176,536,176,176
4586,2011-07-14,Fall,2011,Jul,23,0,Thursday,1,Clear,0.64,0.6061,0.65,0.2537,27,97,124,536,124,124
4587,2011-07-15,Fall,2011,Jul,0,0,Friday,1,Clear,0.62,0.5909,0.73,0.2239,23,57,80,535,80,80
4588,2011-07-15,Fall,2011,Jul,1,0,Friday,1,Clear,0.62,0.5909,0.73,0.194,7,13,20,535,20,20
4589,2011-07-15,Fall,2011,Jul,2,0,Friday,1,Clear,0.6,0.5758,0.78,0.1642,16,22,38,535,38,38
4590,2011-07-15,Fall,2011,Jul,3,0,Friday,1,Clear,0.6,0.5909,0.73,0.194,1,6,7,535,7,7
4591,2011-07-15,Fall,2011,Jul,4,0,Friday,1,Clear,0.6,0.5909,0.73,0.1642,2,8,10,535,10,10
4592,2011-07-15,Fall,2011,Jul,5,0,Friday,1,Clear,0.6,0.5909,0.73,0.1343,7,16,23,535,23,23
4593,2011-07-15,Fall,2011,Jul,6,0,Friday,1,Misty,0.6,0.5909,0.73,0.1045,12,108,120,535,120,120
4594,2011-07-15,Fall,2011,Jul,7,0,Friday,1,Clear,0.64,0.6061,0.65,0.1045,17,257,274,535,274,274
4595,2011-07-15,Fall,2011,Jul,8,0,Friday,1,Clear,0.64,0.6061,0.65,0.2537,50,514,564,535,564,564
4596,2011-07-15,Fall,2011,Jul,9,0,Friday,1,Clear,0.68,0.6364,0.54,0.194,31,176,207,535,207,207
4597,2011-07-15,Fall,2011,Jul,10,0,Friday,1,Misty,0.66,0.6212,0.61,0.1642,59,107,166,535,166,166
4598,2011-07-15,Fall,2011,Jul,11,0,Friday,1,Clear,0.7,0.6515,0.54,0.1343,73,137,210,535,210,210
4599,2011-07-15,Fall,2011,Jul,12,0,Friday,1,Clear,0.7,0.6515,0.48,0.194,61,177,238,535,238,238
4600,2011-07-15,Fall,2011,Jul,13,0,Friday,1,Clear,0.7,0.6515,0.54,0.194,85,162,247,535,247,247
4601,2011-07-15,Fall,2011,Jul,14,0,Friday,1,Clear,0.7,0.6515,0.51,0.194,105,160,265,535,265,265
4602,2011-07-15,Fall,2011,Jul,15,0,Friday,1,Clear,0.72,0.6515,0.45,0.1642,74,163,237,535,237,237
4603,2011-07-15,Fall,2011,Jul,16,0,Friday,1,Clear,0.72,0.6667,0.51,0.194,96,265,361,535,361,361
4604,2011-07-15,Fall,2011,Jul,17,0,Friday,1,Clear,0.74,0.6667,0.42,0.2537,104,483,587,535,587,587
4605,2011-07-15,Fall,2011,Jul,18,0,Friday,1,Clear,0.72,0.6515,0.45,0.2239,102,394,496,535,496,496
4606,2011-07-15,Fall,2011,Jul,19,0,Friday,1,Clear,0.7,0.6364,0.45,0.2239,114,280,394,535,394,394
4607,2011-07-15,Fall,2011,Jul,20,0,Friday,1,Clear,0.7,0.6515,0.51,0.2239,92,251,343,535,343,343
4608,2011-07-15,Fall,2011,Jul,21,0,Friday,1,Clear,0.66,0.6212,0.54,0.1045,75,186,261,535,261,261
4609,2011-07-15,Fall,2011,Jul,22,0,Friday,1,Clear,0.66,0.6212,0.57,0.2239,71,152,223,535,223,223
4610,2011-07-15,Fall,2011,Jul,23,0,Friday,1,Clear,0.64,0.6212,0.61,0.1642,41,126,167,535,167,167
4611,2011-07-16,Fall,2011,Jul,0,0,Saturday,0,Clear,0.62,0.6061,0.65,0.194,42,68,110,534,110,110
4612,2011-07-16,Fall,2011,Jul,1,0,Saturday,0,Clear,0.6,0.5909,0.69,0.1045,24,51,75,534,75,75
4613,2011-07-16,Fall,2011,Jul,2,0,Saturday,0,Clear,0.6,0.5909,0.73,0.1343,10,48,58,534,58,58
4614,2011-07-16,Fall,2011,Jul,3,0,Saturday,0,Clear,0.6,0.5758,0.78,0.1343,6,20,26,534,26,26
4615,2011-07-16,Fall,2011,Jul,4,0,Saturday,0,Clear,0.6,0.5909,0.73,0.0896,9,7,16,534,16,16
4616,2011-07-16,Fall,2011,Jul,5,0,Saturday,0,Clear,0.58,0.5455,0.78,0.0896,4,6,10,534,10,10
4617,2011-07-16,Fall,2011,Jul,6,0,Saturday,0,Clear,0.6,0.5758,0.78,0.1642,16,21,37,534,37,37
4618,2011-07-16,Fall,2011,Jul,7,0,Saturday,0,Clear,0.62,0.5909,0.73,0.1343,14,38,52,534,52,52
4619,2011-07-16,Fall,2011,Jul,8,0,Saturday,0,Clear,0.66,0.6212,0.65,0.1642,37,90,127,534,127,127
4620,2011-07-16,Fall,2011,Jul,9,0,Saturday,0,Clear,0.7,0.6515,0.54,0.2239,72,150,222,534,222,222
4621,2011-07-16,Fall,2011,Jul,10,0,Saturday,0,Clear,0.72,0.6667,0.54,0.194,114,208,322,534,322,322
4622,2011-07-16,Fall,2011,Jul,11,0,Saturday,0,Clear,0.74,0.6667,0.48,0.2239,171,225,396,534,396,396
4623,2011-07-16,Fall,2011,Jul,12,0,Saturday,0,Clear,0.76,0.6818,0.43,0.2836,187,276,463,534,463,463
4624,2011-07-16,Fall,2011,Jul,13,0,Saturday,0,Clear,0.76,0.6818,0.45,0.2985,221,276,497,534,497,497
4625,2011-07-16,Fall,2011,Jul,14,0,Saturday,0,Clear,0.74,0.6667,0.45,0.2985,201,232,433,534,433,433
4626,2011-07-16,Fall,2011,Jul,15,0,Saturday,0,Clear,0.76,0.6818,0.45,0.3284,205,223,428,534,428,428
4627,2011-07-16,Fall,2011,Jul,16,0,Saturday,0,Clear,0.76,0.6818,0.45,0.2836,183,242,425,534,425,425
4628,2011-07-16,Fall,2011,Jul,17,0,Saturday,0,Clear,0.76,0.6818,0.45,0.2239,234,241,475,534,475,475
4629,2011-07-16,Fall,2011,Jul,18,0,Saturday,0,Clear,0.76,0.6818,0.45,0.2836,185,243,428,534,428,428
4630,2011-07-16,Fall,2011,Jul,19,0,Saturday,0,Clear,0.74,0.6818,0.48,0.194,164,242,406,534,406,406
4631,2011-07-16,Fall,2011,Jul,20,0,Saturday,0,Clear,0.72,0.6667,0.51,0.2239,108,188,296,534,296,296
4632,2011-07-16,Fall,2011,Jul,21,0,Saturday,0,Clear,0.7,0.6515,0.58,0.2239,85,167,252,534,252,252
4633,2011-07-16,Fall,2011,Jul,22,0,Saturday,0,Clear,0.7,0.6515,0.65,0.2836,65,136,201,534,201,201
4634,2011-07-16,Fall,2011,Jul,23,0,Saturday,0,Clear,0.68,0.6364,0.61,0.2239,61,107,168,534,168,168
4635,2011-07-17,Fall,2011,Jul,0,0,Sunday,0,Clear,0.66,0.6212,0.65,0.2239,34,91,125,533,125,125
4636,2011-07-17,Fall,2011,Jul,1,0,Sunday,0,Clear,0.64,0.6061,0.69,0.194,16,86,102,533,102,102
4637,2011-07-17,Fall,2011,Jul,2,0,Sunday,0,Clear,0.64,0.6061,0.69,0.2239,28,66,94,533,94,94
4638,2011-07-17,Fall,2011,Jul,3,0,Sunday,0,Clear,0.64,0.6061,0.69,0.2239,21,26,47,533,47,47
4639,2011-07-17,Fall,2011,Jul,4,0,Sunday,0,Clear,0.62,0.5909,0.73,0.1642,4,6,10,533,10,10
4640,2011-07-17,Fall,2011,Jul,5,0,Sunday,0,Clear,0.64,0.6061,0.69,0.2239,4,8,12,533,12,12
4641,2011-07-17,Fall,2011,Jul,6,0,Sunday,0,Clear,0.62,0.5909,0.73,0.1642,10,11,21,533,21,21
4642,2011-07-17,Fall,2011,Jul,7,0,Sunday,0,Clear,0.64,0.6061,0.73,0.1642,20,30,50,533,50,50
4643,2011-07-17,Fall,2011,Jul,8,0,Sunday,0,Clear,0.68,0.6364,0.65,0.2239,45,73,118,533,118,118
4644,2011-07-17,Fall,2011,Jul,9,0,Sunday,0,Clear,0.72,0.6667,0.58,0.2239,74,110,184,533,184,184
4645,2011-07-17,Fall,2011,Jul,10,0,Sunday,0,Clear,0.74,0.6818,0.6,0.2239,127,177,304,533,304,304
4646,2011-07-17,Fall,2011,Jul,11,0,Sunday,0,Clear,0.76,0.697,0.55,0.2836,147,244,391,533,391,391
4647,2011-07-17,Fall,2011,Jul,12,0,Sunday,0,Clear,0.76,0.697,0.55,0.2836,177,243,420,533,420,420
4648,2011-07-17,Fall,2011,Jul,13,0,Sunday,0,Clear,0.8,0.7424,0.49,0.2985,200,272,472,533,472,472
4649,2011-07-17,Fall,2011,Jul,14,0,Sunday,0,Clear,0.8,0.7424,0.49,0.3582,168,262,430,533,430,430
4650,2011-07-17,Fall,2011,Jul,15,0,Sunday,0,Clear,0.82,0.7424,0.43,0.2985,129,195,324,533,324,324
4651,2011-07-17,Fall,2011,Jul,16,0,Sunday,0,Clear,0.8,0.7273,0.46,0.2985,129,188,317,533,317,317
4652,2011-07-17,Fall,2011,Jul,17,0,Sunday,0,Clear,0.8,0.7424,0.49,0.3881,133,236,369,533,369,369
4653,2011-07-17,Fall,2011,Jul,18,0,Sunday,0,Clear,0.8,0.7273,0.46,0.2985,147,243,390,533,390,390
4654,2011-07-17,Fall,2011,Jul,19,0,Sunday,0,Clear,0.76,0.697,0.55,0.2836,145,234,379,533,379,379
4655,2011-07-17,Fall,2011,Jul,20,0,Sunday,0,Clear,0.76,0.7121,0.58,0.2537,85,177,262,533,262,262
4656,2011-07-17,Fall,2011,Jul,21,0,Sunday,0,Clear,0.74,0.6818,0.62,0.2239,59,148,207,533,207,207
4657,2011-07-17,Fall,2011,Jul,22,0,Sunday,0,Clear,0.72,0.6818,0.66,0.2239,65,116,181,533,181,181
4658,2011-07-17,Fall,2011,Jul,23,0,Sunday,0,Clear,0.7,0.6667,0.74,0.1343,39,54,93,533,93,93
4659,2011-07-18,Fall,2011,Jul,0,0,Monday,1,Clear,0.7,0.6667,0.74,0.1343,21,30,51,532,51,51
4660,2011-07-18,Fall,2011,Jul,1,0,Monday,1,Clear,0.7,0.6667,0.74,0.2239,17,8,25,532,25,25
4661,2011-07-18,Fall,2011,Jul,2,0,Monday,1,Clear,0.66,0.6061,0.83,0.2239,2,8,10,532,10,10
4662,2011-07-18,Fall,2011,Jul,3,0,Monday,1,Clear,0.66,0.6061,0.78,0.194,3,4,7,532,7,7
4663,2011-07-18,Fall,2011,Jul,4,0,Monday,1,Clear,0.64,0.5909,0.78,0.1642,1,3,4,532,4,4
4664,2011-07-18,Fall,2011,Jul,5,0,Monday,1,Clear,0.64,0.5909,0.78,0.1045,2,15,17,532,17,17
4665,2011-07-18,Fall,2011,Jul,6,0,Monday,1,Clear,0.64,0.5758,0.83,0.1045,10,95,105,532,105,105
4666,2011-07-18,Fall,2011,Jul,7,0,Monday,1,Clear,0.68,0.6364,0.74,0.2239,22,255,277,532,277,277
4667,2011-07-18,Fall,2011,Jul,8,0,Monday,1,Clear,0.7,0.6515,0.7,0.194,18,329,347,532,347,347
4668,2011-07-18,Fall,2011,Jul,9,0,Monday,1,Clear,0.74,0.697,0.67,0.2239,33,170,203,532,203,203
4669,2011-07-18,Fall,2011,Jul,10,0,Monday,1,Clear,0.76,0.7121,0.62,0.194,52,78,130,532,130,130
4670,2011-07-18,Fall,2011,Jul,11,0,Monday,1,Clear,0.8,0.7576,0.55,0.0896,42,99,141,532,141,141
4671,2011-07-18,Fall,2011,Jul,12,0,Monday,1,Clear,0.8,0.7727,0.59,0.194,39,126,165,532,165,165
4672,2011-07-18,Fall,2011,Jul,13,0,Monday,1,Clear,0.82,0.7879,0.56,0.2537,27,125,152,532,152,152
4673,2011-07-18,Fall,2011,Jul,14,0,Monday,1,Clear,0.82,0.7879,0.56,0.3284,32,106,138,532,138,138
4674,2011-07-18,Fall,2011,Jul,15,0,Monday,1,Clear,0.84,0.803,0.53,0.3284,53,111,164,532,164,164
4675,2011-07-18,Fall,2011,Jul,16,0,Monday,1,Clear,0.84,0.803,0.53,0.2836,45,220,265,532,265,265
4676,2011-07-18,Fall,2011,Jul,17,0,Monday,1,Clear,0.84,0.7879,0.49,0.3284,72,473,545,532,545,545
4677,2011-07-18,Fall,2011,Jul,18,0,Monday,1,Clear,0.82,0.7727,0.49,0.3582,80,478,558,532,558,558
4678,2011-07-18,Fall,2011,Jul,19,0,Monday,1,Clear,0.8,0.7576,0.55,0.2239,63,335,398,532,398,398
4679,2011-07-18,Fall,2011,Jul,20,0,Monday,1,Clear,0.78,0.7424,0.59,0.2239,91,232,323,532,323,323
4680,2011-07-18,Fall,2011,Jul,21,0,Monday,1,Clear,0.74,0.697,0.66,0.194,48,154,202,532,202,202
4681,2011-07-18,Fall,2011,Jul,22,0,Monday,1,Clear,0.76,0.7273,0.66,0.2239,36,104,140,532,140,140
4682,2011-07-18,Fall,2011,Jul,23,0,Monday,1,Clear,0.74,0.697,0.66,0.1642,32,59,91,532,91,91
4683,2011-07-19,Fall,2011,Jul,0,0,Tuesday,1,Clear,0.74,0.697,0.66,0.1045,25,26,51,531,51,51
4684,2011-07-19,Fall,2011,Jul,1,0,Tuesday,1,Misty,0.74,0.697,0.66,0.1343,7,6,13,531,13,13
4685,2011-07-19,Fall,2011,Jul,2,0,Tuesday,1,Clear,0.72,0.6818,0.7,0.1642,9,4,13,531,13,13
4686,2011-07-19,Fall,2011,Jul,3,0,Tuesday,1,Clear,0.72,0.6818,0.7,0.1642,2,1,3,531,3,3
4687,2011-07-19,Fall,2011,Jul,4,0,Tuesday,1,Clear,0.72,0.6818,0.7,0.1343,1,4,5,531,5,5
4688,2011-07-19,Fall,2011,Jul,5,0,Tuesday,1,Misty,0.7,0.6667,0.74,0.1045,0,19,19,531,19,19
4689,2011-07-19,Fall,2011,Jul,6,0,Tuesday,1,Misty,0.72,0.697,0.74,0.1045,8,126,134,531,134,134
4690,2011-07-19,Fall,2011,Jul,7,0,Tuesday,1,Misty,0.74,0.697,0.7,0.1642,28,287,315,531,315,315
4691,2011-07-19,Fall,2011,Jul,8,0,Tuesday,1,Misty,0.76,0.7273,0.7,0.1642,31,381,412,531,412,412
4692,2011-07-19,Fall,2011,Jul,9,0,Tuesday,1,Misty,0.8,0.7879,0.63,0.1343,22,177,199,531,199,199
4693,2011-07-19,Fall,2011,Jul,10,0,Tuesday,1,Misty,0.82,0.7879,0.56,0.1642,29,112,141,531,141,141
4694,2011-07-19,Fall,2011,Jul,11,0,Tuesday,1,Clear,0.82,0.803,0.59,0.0,29,98,127,531,127,127
4695,2011-07-19,Fall,2011,Jul,12,0,Tuesday,1,Clear,0.84,0.8182,0.56,0.0896,26,127,153,531,153,153
4696,2011-07-19,Fall,2011,Jul,13,0,Tuesday,1,Clear,0.86,0.8333,0.53,0.1045,33,139,172,531,172,172
4697,2011-07-19,Fall,2011,Jul,14,0,Tuesday,1,Clear,0.86,0.8182,0.5,0.194,41,111,152,531,152,152
4698,2011-07-19,Fall,2011,Jul,15,0,Tuesday,1,Clear,0.88,0.8182,0.44,0.194,48,110,158,531,158,158
4699,2011-07-19,Fall,2011,Jul,16,0,Tuesday,1,Clear,0.9,0.8485,0.42,0.2985,61,216,277,531,277,277
4700,2011-07-19,Fall,2011,Jul,17,0,Tuesday,1,Clear,0.8,0.803,0.66,0.0,68,445,513,531,513,513
4701,2011-07-19,Fall,2011,Jul,18,0,Tuesday,1,Clear,0.8,0.803,0.66,0.1343,80,450,530,531,530,530
4702,2011-07-19,Fall,2011,Jul,19,0,Tuesday,1,Clear,0.76,0.7424,0.75,0.194,54,334,388,531,388,388
4703,2011-07-19,Fall,2011,Jul,20,0,Tuesday,1,Clear,0.74,0.7273,0.74,0.0896,48,229,277,531,277,277
4704,2011-07-19,Fall,2011,Jul,21,0,Tuesday,1,Clear,0.74,0.7121,0.74,0.1343,47,194,241,531,241,241
4705,2011-07-19,Fall,2011,Jul,22,0,Tuesday,1,Clear,0.74,0.7121,0.74,0.0,36,120,156,531,156,156
4706,2011-07-19,Fall,2011,Jul,23,0,Tuesday,1,Light_rainsnow,0.72,0.697,0.79,0.1642,19,73,92,531,92,92
4707,2011-07-20,Fall,2011,Jul,0,0,Wednesday,1,Clear,0.7,0.6667,0.84,0.1045,11,29,40,530,40,40
4708,2011-07-20,Fall,2011,Jul,1,0,Wednesday,1,Clear,0.7,0.6667,0.84,0.0,4,7,11,530,11,11
4709,2011-07-20,Fall,2011,Jul,2,0,Wednesday,1,Clear,0.7,0.6667,0.84,0.0,2,7,9,530,9,9
4710,2011-07-20,Fall,2011,Jul,3,0,Wednesday,1,Clear,0.7,0.6667,0.84,0.1045,2,4,6,530,6,6
4711,2011-07-20,Fall,2011,Jul,4,0,Wednesday,1,Clear,0.68,0.6364,0.83,0.0,0,4,4,530,4,4
4712,2011-07-20,Fall,2011,Jul,5,0,Wednesday,1,Clear,0.68,0.6364,0.83,0.1045,4,19,23,530,23,23
4713,2011-07-20,Fall,2011,Jul,6,0,Wednesday,1,Misty,0.68,0.6364,0.89,0.1045,5,111,116,530,116,116
4714,2011-07-20,Fall,2011,Jul,7,0,Wednesday,1,Misty,0.7,0.6667,0.84,0.1045,27,276,303,530,303,303
4715,2011-07-20,Fall,2011,Jul,8,0,Wednesday,1,Clear,0.74,0.7121,0.74,0.0,34,404,438,530,438,438
4716,2011-07-20,Fall,2011,Jul,9,0,Wednesday,1,Clear,0.74,0.697,0.7,0.0896,28,181,209,530,209,209
4717,2011-07-20,Fall,2011,Jul,10,0,Wednesday,1,Clear,0.76,0.7273,0.7,0.0,34,76,110,530,110,110
4718,2011-07-20,Fall,2011,Jul,11,0,Wednesday,1,Clear,0.8,0.7879,0.63,0.0896,26,116,142,530,142,142
4719,2011-07-20,Fall,2011,Jul,12,0,Wednesday,1,Clear,0.82,0.803,0.59,0.0,28,121,149,530,149,149
4720,2011-07-20,Fall,2011,Jul,13,0,Wednesday,1,Clear,0.84,0.8182,0.56,0.194,23,97,120,530,120,120
4721,2011-07-20,Fall,2011,Jul,14,0,Wednesday,1,Clear,0.86,0.8333,0.53,0.2239,44,83,127,530,127,127
4722,2011-07-20,Fall,2011,Jul,15,0,Wednesday,1,Clear,0.86,0.8182,0.5,0.1642,36,102,138,530,138,138
4723,2011-07-20,Fall,2011,Jul,16,0,Wednesday,1,Clear,0.84,0.8182,0.56,0.0,30,204,234,530,234,234
4724,2011-07-20,Fall,2011,Jul,17,0,Wednesday,1,Clear,0.84,0.8333,0.59,0.194,50,405,455,530,455,455
4725,2011-07-20,Fall,2011,Jul,18,0,Wednesday,1,Clear,0.84,0.8333,0.59,0.2239,68,429,497,530,497,497
4726,2011-07-20,Fall,2011,Jul,19,0,Wednesday,1,Clear,0.82,0.8485,0.67,0.1642,59,323,382,530,382,382
4727,2011-07-20,Fall,2011,Jul,20,0,Wednesday,1,Clear,0.8,0.8333,0.75,0.2239,45,264,309,530,309,309
4728,2011-07-20,Fall,2011,Jul,21,0,Wednesday,1,Clear,0.8,0.803,0.66,0.1642,33,209,242,530,242,242
4729,2011-07-20,Fall,2011,Jul,22,0,Wednesday,1,Clear,0.78,0.7727,0.7,0.2239,25,144,169,530,169,169
4730,2011-07-20,Fall,2011,Jul,23,0,Wednesday,1,Clear,0.76,0.7424,0.75,0.2537,26,73,99,530,99,99
4731,2011-07-21,Fall,2011,Jul,0,0,Thursday,1,Misty,0.76,0.7424,0.75,0.194,13,29,42,529,42,42
4732,2011-07-21,Fall,2011,Jul,1,0,Thursday,1,Misty,0.74,0.7273,0.84,0.2239,5,16,21,529,21,21
4733,2011-07-21,Fall,2011,Jul,2,0,Thursday,1,Misty,0.74,0.7273,0.84,0.2239,2,4,6,529,6,6
4734,2011-07-21,Fall,2011,Jul,3,0,Thursday,1,Misty,0.74,0.7121,0.79,0.1343,1,5,6,529,6,6
4735,2011-07-21,Fall,2011,Jul,4,0,Thursday,1,Misty,0.72,0.7121,0.84,0.1045,0,4,4,529,4,4
4736,2011-07-21,Fall,2011,Jul,5,0,Thursday,1,Misty,0.72,0.7121,0.84,0.1045,2,16,18,529,18,18
4737,2011-07-21,Fall,2011,Jul,6,0,Thursday,1,Misty,0.72,0.7121,0.84,0.1045,6,111,117,529,117,117
4738,2011-07-21,Fall,2011,Jul,7,0,Thursday,1,Misty,0.74,0.7273,0.84,0.1343,23,251,274,529,274,274
4739,2011-07-21,Fall,2011,Jul,8,0,Thursday,1,Misty,0.76,0.7576,0.79,0.1642,23,358,381,529,381,381
4740,2011-07-21,Fall,2011,Jul,9,0,Thursday,1,Misty,0.8,0.8182,0.75,0.2537,34,166,200,529,200,200
4741,2011-07-21,Fall,2011,Jul,10,0,Thursday,1,Misty,0.82,0.8636,0.71,0.2239,31,47,78,529,78,78
4742,2011-07-21,Fall,2011,Jul,11,0,Thursday,1,Misty,0.86,0.8939,0.63,0.2985,27,79,106,529,106,106
4743,2011-07-21,Fall,2011,Jul,12,0,Thursday,1,Clear,0.88,0.8939,0.56,0.3284,29,106,135,529,135,135
4744,2011-07-21,Fall,2011,Jul,13,0,Thursday,1,Clear,0.88,0.8939,0.56,0.2985,21,81,102,529,102,102
4745,2011-07-21,Fall,2011,Jul,14,0,Thursday,1,Clear,0.9,0.8939,0.5,0.3582,50,97,147,529,147,147
4746,2011-07-21,Fall,2011,Jul,15,0,Thursday,1,Clear,0.9,0.9242,0.53,0.2537,40,93,133,529,133,133
4747,2011-07-21,Fall,2011,Jul,16,0,Thursday,1,Clear,0.92,0.9242,0.48,0.2836,43,167,210,529,210,210
4748,2011-07-21,Fall,2011,Jul,17,0,Thursday,1,Clear,0.92,0.9091,0.45,0.2985,40,374,414,529,414,414
4749,2011-07-21,Fall,2011,Jul,18,0,Thursday,1,Clear,0.9,0.8939,0.5,0.2836,39,343,382,529,382,382
4750,2011-07-21,Fall,2011,Jul,19,0,Thursday,1,Clear,0.86,0.9242,0.67,0.2836,51,233,284,529,284,284
4751,2011-07-21,Fall,2011,Jul,20,0,Thursday,1,Clear,0.84,0.8939,0.71,0.2239,38,199,237,529,237,237
4752,2011-07-21,Fall,2011,Jul,21,0,Thursday,1,Clear,0.82,0.8939,0.75,0.2239,38,187,225,529,225,225
4753,2011-07-21,Fall,2011,Jul,22,0,Thursday,1,Clear,0.82,0.8636,0.71,0.1642,36,113,149,529,149,149
4754,2011-07-21,Fall,2011,Jul,23,0,Thursday,1,Clear,0.8,0.8182,0.71,0.1642,40,73,113,529,113,113
4755,2011-07-22,Fall,2011,Jul,0,0,Friday,1,Clear,0.82,0.8333,0.63,0.1343,9,51,60,528,60,60
4756,2011-07-22,Fall,2011,Jul,1,0,Friday,1,Clear,0.8,0.7879,0.63,0.0,7,17,24,528,24,24
4757,2011-07-22,Fall,2011,Jul,2,0,Friday,1,Clear,0.78,0.803,0.79,0.1343,0,14,14,528,14,14
4758,2011-07-22,Fall,2011,Jul,3,0,Friday,1,Clear,0.78,0.7879,0.75,0.1045,1,6,7,528,7,7
4759,2011-07-22,Fall,2011,Jul,4,0,Friday,1,Clear,0.76,0.7424,0.75,0.1045,8,5,13,528,13,13
4760,2011-07-22,Fall,2011,Jul,5,0,Friday,1,Clear,0.74,0.7121,0.79,0.1045,2,17,19,528,19,19
4761,2011-07-22,Fall,2011,Jul,6,0,Friday,1,Clear,0.76,0.7424,0.75,0.0896,13,83,96,528,96,96
4762,2011-07-22,Fall,2011,Jul,7,0,Friday,1,Misty,0.8,0.803,0.66,0.1045,20,232,252,528,252,252
4763,2011-07-22,Fall,2011,Jul,8,0,Friday,1,Misty,0.84,0.8485,0.63,0.1642,30,292,322,528,322,322
4764,2011-07-22,Fall,2011,Jul,9,0,Friday,1,Clear,0.86,0.8939,0.63,0.0896,31,177,208,528,208,208
4765,2011-07-22,Fall,2011,Jul,10,0,Friday,1,Clear,0.9,0.9242,0.53,0.0896,32,83,115,528,115,115
4766,2011-07-22,Fall,2011,Jul,11,0,Friday,1,Clear,0.9,0.8939,0.5,0.1045,23,86,109,528,109,109
4767,2011-07-22,Fall,2011,Jul,12,0,Friday,1,Clear,0.94,0.9545,0.48,0.1642,20,95,115,528,115,115
4768,2011-07-22,Fall,2011,Jul,13,0,Friday,1,Clear,0.94,0.9848,0.51,0.1642,25,98,123,528,123,123
4769,2011-07-22,Fall,2011,Jul,14,0,Friday,1,Clear,0.96,1.0,0.48,0.2985,24,77,101,528,101,101
4770,2011-07-22,Fall,2011,Jul,15,0,Friday,1,Clear,0.94,0.9848,0.51,0.2985,32,101,133,528,133,133
4771,2011-07-22,Fall,2011,Jul,16,0,Friday,1,Light_rainsnow,0.9,0.8333,0.39,0.2985,29,153,182,528,182,182
4772,2011-07-22,Fall,2011,Jul,17,0,Friday,1,Clear,0.88,0.8485,0.47,0.1045,35,271,306,528,306,306
4773,2011-07-22,Fall,2011,Jul,18,0,Friday,1,Clear,0.9,0.8182,0.37,0.1642,34,250,284,528,284,284
4774,2011-07-22,Fall,2011,Jul,19,0,Friday,1,Misty,0.86,0.7879,0.41,0.1045,40,210,250,528,250,250
4775,2011-07-22,Fall,2011,Jul,20,0,Friday,1,Clear,0.84,0.8182,0.56,0.0,46,166,212,528,212,212
4776,2011-07-22,Fall,2011,Jul,21,0,Friday,1,Clear,0.82,0.803,0.59,0.0896,38,152,190,528,190,190
4777,2011-07-22,Fall,2011,Jul,22,0,Friday,1,Misty,0.84,0.7879,0.49,0.0896,44,105,149,528,149,149
4778,2011-07-22,Fall,2011,Jul,23,0,Friday,1,Clear,0.8,0.7879,0.63,0.194,19,84,103,528,103,103
4779,2011-07-23,Fall,2011,Jul,0,0,Saturday,0,Clear,0.82,0.7879,0.56,0.0,16,85,101,527,101,101
4780,2011-07-23,Fall,2011,Jul,1,0,Saturday,0,Clear,0.82,0.7727,0.52,0.1045,13,57,70,527,70,70
4781,2011-07-23,Fall,2011,Jul,2,0,Saturday,0,Clear,0.82,0.7727,0.52,0.0,13,48,61,527,61,61
4782,2011-07-23,Fall,2011,Jul,3,0,Saturday,0,Clear,0.78,0.7576,0.66,0.0896,6,16,22,527,22,22
4783,2011-07-23,Fall,2011,Jul,4,0,Saturday,0,Clear,0.76,0.7273,0.66,0.1045,5,4,9,527,9,9
4784,2011-07-23,Fall,2011,Jul,5,0,Saturday,0,Clear,0.76,0.7121,0.62,0.1343,1,6,7,527,7,7
4785,2011-07-23,Fall,2011,Jul,6,0,Saturday,0,Clear,0.8,0.7424,0.52,0.1343,6,19,25,527,25,25
4786,2011-07-23,Fall,2011,Jul,7,0,Saturday,0,Clear,0.8,0.7424,0.52,0.1045,7,38,45,527,45,45
4787,2011-07-23,Fall,2011,Jul,8,0,Saturday,0,Clear,0.84,0.7879,0.49,0.2537,24,85,109,527,109,109
4788,2011-07-23,Fall,2011,Jul,9,0,Saturday,0,Clear,0.84,0.7879,0.49,0.1642,30,102,132,527,132,132
4789,2011-07-23,Fall,2011,Jul,10,0,Saturday,0,Clear,0.86,0.7879,0.41,0.2239,61,137,198,527,198,198
4790,2011-07-23,Fall,2011,Jul,11,0,Saturday,0,Clear,0.9,0.8182,0.37,0.194,62,154,216,527,216,216
4791,2011-07-23,Fall,2011,Jul,12,0,Saturday,0,Clear,0.92,0.8636,0.37,0.1045,71,164,235,527,235,235
4792,2011-07-23,Fall,2011,Jul,13,0,Saturday,0,Clear,0.94,0.8788,0.38,0.1642,78,167,245,527,245,245
4793,2011-07-23,Fall,2011,Jul,14,0,Saturday,0,Clear,0.92,0.8939,0.42,0.0,84,152,236,527,236,236
4794,2011-07-23,Fall,2011,Jul,15,0,Saturday,0,Clear,0.94,0.8788,0.38,0.0,78,137,215,527,215,215
4795,2011-07-23,Fall,2011,Jul,16,0,Saturday,0,Clear,0.94,0.8788,0.38,0.1343,70,151,221,527,221,221
4796,2011-07-23,Fall,2011,Jul,17,0,Saturday,0,Clear,0.94,0.8788,0.38,0.1343,70,127,197,527,197,197
4797,2011-07-23,Fall,2011,Jul,18,0,Saturday,0,Clear,0.92,0.8788,0.4,0.2239,62,134,196,527,196,196
4798,2011-07-23,Fall,2011,Jul,19,0,Saturday,0,Misty,0.82,0.803,0.59,0.1343,80,137,217,527,217,217
4799,2011-07-23,Fall,2011,Jul,20,0,Saturday,0,Clear,0.82,0.803,0.59,0.2239,47,98,145,527,145,145
4800,2011-07-23,Fall,2011,Jul,21,0,Saturday,0,Clear,0.82,0.803,0.59,0.2239,39,115,154,527,154,154
4801,2011-07-23,Fall,2011,Jul,22,0,Saturday,0,Clear,0.8,0.7727,0.59,0.194,37,88,125,527,125,125
4802,2011-07-23,Fall,2011,Jul,23,0,Saturday,0,Clear,0.8,0.7727,0.59,0.1045,27,77,104,527,104,104
4803,2011-07-24,Fall,2011,Jul,0,0,Sunday,0,Clear,0.8,0.7727,0.59,0.1045,42,77,119,526,119,119
4804,2011-07-24,Fall,2011,Jul,1,0,Sunday,0,Clear,0.78,0.7576,0.66,0.1045,33,63,96,526,96,96
4805,2011-07-24,Fall,2011,Jul,2,0,Sunday,0,Clear,0.8,0.7879,0.63,0.0896,12,48,60,526,60,60
4806,2011-07-24,Fall,2011,Jul,3,0,Sunday,0,Clear,0.8,0.7879,0.63,0.0896,17,20,37,526,37,37
4807,2011-07-24,Fall,2011,Jul,4,0,Sunday,0,Clear,0.78,0.7576,0.66,0.1045,1,5,6,526,6,6
4808,2011-07-24,Fall,2011,Jul,5,0,Sunday,0,Clear,0.78,0.7576,0.66,0.0896,5,3,8,526,8,8
4809,2011-07-24,Fall,2011,Jul,6,0,Sunday,0,Misty,0.8,0.7879,0.63,0.0896,9,13,22,526,22,22
4810,2011-07-24,Fall,2011,Jul,7,0,Sunday,0,Clear,0.8,0.7727,0.59,0.1343,6,29,35,526,35,35
4811,2011-07-24,Fall,2011,Jul,8,0,Sunday,0,Clear,0.82,0.7879,0.56,0.2836,22,82,104,526,104,104
4812,2011-07-24,Fall,2011,Jul,9,0,Sunday,0,Clear,0.82,0.7879,0.56,0.3881,42,112,154,526,154,154
4813,2011-07-24,Fall,2011,Jul,10,0,Sunday,0,Clear,0.86,0.8182,0.5,0.3284,61,165,226,526,226,226
4814,2011-07-24,Fall,2011,Jul,11,0,Sunday,0,Clear,0.84,0.803,0.53,0.2537,74,169,243,526,243,243
4815,2011-07-24,Fall,2011,Jul,12,0,Sunday,0,Clear,0.9,0.8636,0.45,0.1642,85,161,246,526,246,246
4816,2011-07-24,Fall,2011,Jul,13,0,Sunday,0,Clear,0.86,0.803,0.47,0.2239,90,162,252,526,252,252
4817,2011-07-24,Fall,2011,Jul,14,0,Sunday,0,Clear,0.86,0.8182,0.5,0.2836,79,204,283,526,283,283
4818,2011-07-24,Fall,2011,Jul,15,0,Sunday,0,Clear,0.9,0.8485,0.42,0.2537,68,170,238,526,238,238
4819,2011-07-24,Fall,2011,Jul,16,0,Sunday,0,Clear,0.9,0.8485,0.42,0.2537,62,187,249,526,249,249
4820,2011-07-24,Fall,2011,Jul,17,0,Sunday,0,Clear,0.9,0.8333,0.39,0.1045,75,174,249,526,249,249
4821,2011-07-24,Fall,2011,Jul,18,0,Sunday,0,Clear,0.88,0.8182,0.42,0.1642,67,176,243,526,243,243
4822,2011-07-24,Fall,2011,Jul,19,0,Sunday,0,Clear,0.86,0.803,0.47,0.1642,70,170,240,526,240,240
4823,2011-07-24,Fall,2011,Jul,20,0,Sunday,0,Clear,0.84,0.7879,0.49,0.1642,52,143,195,526,195,195
4824,2011-07-24,Fall,2011,Jul,21,0,Sunday,0,Clear,0.8,0.7879,0.63,0.1343,42,111,153,526,153,153
4825,2011-07-24,Fall,2011,Jul,22,0,Sunday,0,Clear,0.78,0.7576,0.66,0.0,23,75,98,526,98,98
4826,2011-07-24,Fall,2011,Jul,23,0,Sunday,0,Misty,0.76,0.7273,0.7,0.0896,13,37,50,526,50,50
4827,2011-07-25,Fall,2011,Jul,0,0,Monday,1,Misty,0.76,0.7273,0.7,0.0,17,17,34,525,34,34
4828,2011-07-25,Fall,2011,Jul,1,0,Monday,1,Misty,0.76,0.7424,0.75,0.0896,4,8,12,525,12,12
4829,2011-07-25,Fall,2011,Jul,2,0,Monday,1,Misty,0.74,0.7121,0.79,0.0896,3,3,6,525,6,6
4830,2011-07-25,Fall,2011,Jul,3,0,Monday,1,Clear,0.74,0.7121,0.79,0.0,2,2,4,525,4,4
4831,2011-07-25,Fall,2011,Jul,4,0,Monday,1,Clear,0.72,0.7121,0.84,0.0896,0,6,6,525,6,6
4832,2011-07-25,Fall,2011,Jul,5,0,Monday,1,Clear,0.72,0.7121,0.84,0.0896,2,22,24,525,24,24
4833,2011-07-25,Fall,2011,Jul,6,0,Monday,1,Misty,0.72,0.7121,0.84,0.0896,7,100,107,525,107,107
4834,2011-07-25,Fall,2011,Jul,7,0,Monday,1,Misty,0.74,0.7121,0.79,0.0,20,257,277,525,277,277
4835,2011-07-25,Fall,2011,Jul,8,0,Monday,1,Misty,0.76,0.7424,0.75,0.0,34,353,387,525,387,387
4836,2011-07-25,Fall,2011,Jul,9,0,Monday,1,Clear,0.8,0.803,0.66,0.0,11,124,135,525,135,135
4837,2011-07-25,Fall,2011,Jul,10,0,Monday,1,Clear,0.82,0.803,0.59,0.0,30,54,84,525,84,84
4838,2011-07-25,Fall,2011,Jul,11,0,Monday,1,Misty,0.84,0.8333,0.59,0.194,24,83,107,525,107,107
4839,2011-07-25,Fall,2011,Jul,12,0,Monday,1,Misty,0.84,0.8333,0.59,0.194,17,50,67,525,67,67
4840,2011-07-25,Fall,2011,Jul,13,0,Monday,1,Misty,0.74,0.7121,0.74,0.1343,14,64,78,525,78,78
4841,2011-07-25,Fall,2011,Jul,14,0,Monday,1,Misty,0.72,0.697,0.79,0.194,28,62,90,525,90,90
4842,2011-07-25,Fall,2011,Jul,15,0,Monday,1,Clear,0.7,0.6667,0.84,0.3881,16,96,112,525,112,112
4843,2011-07-25,Fall,2011,Jul,16,0,Monday,1,Clear,0.7,0.6667,0.84,0.2239,37,161,198,525,198,198
4844,2011-07-25,Fall,2011,Jul,17,0,Monday,1,Clear,0.72,0.697,0.74,0.0,48,437,485,525,485,485
4845,2011-07-25,Fall,2011,Jul,18,0,Monday,1,Clear,0.74,0.7121,0.74,0.0896,60,473,533,525,533,533
4846,2011-07-25,Fall,2011,Jul,19,0,Monday,1,Clear,0.74,0.697,0.7,0.0896,62,324,386,525,386,386
4847,2011-07-25,Fall,2011,Jul,20,0,Monday,1,Clear,0.72,0.697,0.74,0.1343,55,247,302,525,302,302
4848,2011-07-25,Fall,2011,Jul,21,0,Monday,1,Clear,0.7,0.6667,0.84,0.0,41,153,194,525,194,194
4849,2011-07-25,Fall,2011,Jul,22,0,Monday,1,Clear,0.7,0.6667,0.84,0.0,13,112,125,525,125,125
4850,2011-07-25,Fall,2011,Jul,23,0,Monday,1,Clear,0.7,0.6667,0.84,0.0896,23,64,87,525,87,87
4851,2011-07-26,Fall,2011,Jul,0,0,Tuesday,1,Clear,0.7,0.6667,0.79,0.1045,8,20,28,524,28,28
4852,2011-07-26,Fall,2011,Jul,1,0,Tuesday,1,Clear,0.7,0.6667,0.79,0.1045,6,6,12,524,12,12
4853,2011-07-26,Fall,2011,Jul,2,0,Tuesday,1,Clear,0.68,0.6364,0.89,0.1045,1,6,7,524,7,7
4854,2011-07-26,Fall,2011,Jul,3,0,Tuesday,1,Clear,0.68,0.6364,0.89,0.1343,2,2,4,524,4,4
4855,2011-07-26,Fall,2011,Jul,4,0,Tuesday,1,Clear,0.68,0.6364,0.88,0.1642,0,6,6,524,6,6
4856,2011-07-26,Fall,2011,Jul,5,0,Tuesday,1,Clear,0.66,0.5909,0.89,0.0896,3,24,27,524,27,27
4857,2011-07-26,Fall,2011,Jul,6,0,Tuesday,1,Clear,0.68,0.6364,0.83,0.2239,2,108,110,524,110,110
4858,2011-07-26,Fall,2011,Jul,7,0,Tuesday,1,Clear,0.72,0.6818,0.66,0.2836,30,288,318,524,318,318
4859,2011-07-26,Fall,2011,Jul,8,0,Tuesday,1,Clear,0.74,0.6818,0.55,0.194,32,392,424,524,424,424
4860,2011-07-26,Fall,2011,Jul,9,0,Tuesday,1,Clear,0.76,0.6818,0.4,0.2239,25,162,187,524,187,187
4861,2011-07-26,Fall,2011,Jul,10,0,Tuesday,1,Clear,0.8,0.697,0.31,0.2239,42,96,138,524,138,138
4862,2011-07-26,Fall,2011,Jul,11,0,Tuesday,1,Clear,0.82,0.7121,0.3,0.0,49,102,151,524,151,151
4863,2011-07-26,Fall,2011,Jul,12,0,Tuesday,1,Clear,0.84,0.7273,0.28,0.0,25,122,147,524,147,147
4864,2011-07-26,Fall,2011,Jul,13,0,Tuesday,1,Clear,0.84,0.7273,0.32,0.2985,43,139,182,524,182,182
4865,2011-07-26,Fall,2011,Jul,14,0,Tuesday,1,Clear,0.86,0.7424,0.3,0.2836,46,101,147,524,147,147
4866,2011-07-26,Fall,2011,Jul,15,0,Tuesday,1,Clear,0.88,0.7576,0.28,0.3284,49,114,163,524,163,163
4867,2011-07-26,Fall,2011,Jul,16,0,Tuesday,1,Clear,0.86,0.7576,0.36,0.2836,41,213,254,524,254,254
4868,2011-07-26,Fall,2011,Jul,17,0,Tuesday,1,Clear,0.86,0.7576,0.36,0.3582,72,465,537,524,537,537
4869,2011-07-26,Fall,2011,Jul,18,0,Tuesday,1,Clear,0.84,0.7424,0.39,0.3881,68,478,546,524,546,546
4870,2011-07-26,Fall,2011,Jul,19,0,Tuesday,1,Clear,0.82,0.7424,0.43,0.2985,69,329,398,524,398,398
4871,2011-07-26,Fall,2011,Jul,20,0,Tuesday,1,Clear,0.8,0.7273,0.46,0.2537,47,243,290,524,290,290
4872,2011-07-26,Fall,2011,Jul,21,0,Tuesday,1,Clear,0.78,0.7121,0.49,0.2239,45,222,267,524,267,267
4873,2011-07-26,Fall,2011,Jul,22,0,Tuesday,1,Clear,0.76,0.697,0.55,0.1343,27,131,158,524,158,158
4874,2011-07-26,Fall,2011,Jul,23,0,Tuesday,1,Clear,0.76,0.7121,0.58,0.1045,18,71,89,524,89,89
4875,2011-07-27,Fall,2011,Jul,0,0,Wednesday,1,Misty,0.78,0.7121,0.52,0.1642,19,26,45,523,45,45
4876,2011-07-27,Fall,2011,Jul,1,0,Wednesday,1,Clear,0.78,0.7121,0.49,0.194,1,9,10,523,10,10
4877,2011-07-27,Fall,2011,Jul,2,0,Wednesday,1,Clear,0.76,0.697,0.52,0.2985,1,5,6,523,6,6
4878,2011-07-27,Fall,2011,Jul,3,0,Wednesday,1,Clear,0.72,0.6667,0.58,0.1642,0,4,4,523,4,4
4879,2011-07-27,Fall,2011,Jul,4,0,Wednesday,1,Clear,0.72,0.6667,0.51,0.194,1,3,4,523,4,4
4880,2011-07-27,Fall,2011,Jul,5,0,Wednesday,1,Clear,0.7,0.6515,0.54,0.2836,0,18,18,523,18,18
4881,2011-07-27,Fall,2011,Jul,6,0,Wednesday,1,Clear,0.7,0.6515,0.54,0.2239,4,119,123,523,123,123
4882,2011-07-27,Fall,2011,Jul,7,0,Wednesday,1,Clear,0.72,0.6667,0.48,0.2537,34,313,347,523,347,347
4883,2011-07-27,Fall,2011,Jul,8,0,Wednesday,1,Clear,0.74,0.6667,0.42,0.2537,28,405,433,523,433,433
4884,2011-07-27,Fall,2011,Jul,9,0,Wednesday,1,Clear,0.76,0.6667,0.35,0.2537,27,189,216,523,216,216
4885,2011-07-27,Fall,2011,Jul,10,0,Wednesday,1,Clear,0.78,0.6818,0.33,0.0,32,82,114,523,114,114
4886,2011-07-27,Fall,2011,Jul,11,0,Wednesday,1,Clear,0.8,0.697,0.31,0.0,42,94,136,523,136,136
4887,2011-07-27,Fall,2011,Jul,12,0,Wednesday,1,Clear,0.82,0.7121,0.3,0.2836,37,132,169,523,169,169
4888,2011-07-27,Fall,2011,Jul,13,0,Wednesday,1,Clear,0.84,0.7273,0.3,0.3582,29,151,180,523,180,180
4889,2011-07-27,Fall,2011,Jul,14,0,Wednesday,1,Clear,0.84,0.7273,0.28,0.2239,20,107,127,523,127,127
4890,2011-07-27,Fall,2011,Jul,15,0,Wednesday,1,Clear,0.86,0.7424,0.26,0.2537,37,103,140,523,140,140
4891,2011-07-27,Fall,2011,Jul,16,0,Wednesday,1,Clear,0.86,0.7273,0.25,0.1642,40,228,268,523,268,268
4892,2011-07-27,Fall,2011,Jul,17,0,Wednesday,1,Clear,0.84,0.7121,0.26,0.2239,81,491,572,523,572,572
4893,2011-07-27,Fall,2011,Jul,18,0,Wednesday,1,Clear,0.82,0.7121,0.28,0.1045,78,463,541,523,541,541
4894,2011-07-27,Fall,2011,Jul,19,0,Wednesday,1,Clear,0.8,0.697,0.29,0.0896,87,288,375,523,375,375
4895,2011-07-27,Fall,2011,Jul,20,0,Wednesday,1,Clear,0.76,0.6818,0.45,0.2239,55,239,294,523,294,294
4896,2011-07-27,Fall,2011,Jul,21,0,Wednesday,1,Clear,0.74,0.6667,0.48,0.1045,49,196,245,523,245,245
4897,2011-07-27,Fall,2011,Jul,22,0,Wednesday,1,Clear,0.72,0.6667,0.48,0.0,37,143,180,523,180,180
4898,2011-07-27,Fall,2011,Jul,23,0,Wednesday,1,Clear,0.74,0.6667,0.45,0.0896,16,93,109,523,109,109
4899,2011-07-28,Fall,2011,Jul,0,0,Thursday,1,Clear,0.7,0.6515,0.51,0.1343,14,31,45,522,45,45
4900,2011-07-28,Fall,2011,Jul,1,0,Thursday,1,Clear,0.72,0.6667,0.51,0.0,3,26,29,522,29,29
4901,2011-07-28,Fall,2011,Jul,2,0,Thursday,1,Clear,0.72,0.6667,0.54,0.1045,2,5,7,522,7,7
4902,2011-07-28,Fall,2011,Jul,3,0,Thursday,1,Clear,0.72,0.6667,0.54,0.0,0,5,5,522,5,5
4903,2011-07-28,Fall,2011,Jul,4,0,Thursday,1,Clear,0.7,0.6515,0.61,0.1045,0,6,6,522,6,6
4904,2011-07-28,Fall,2011,Jul,5,0,Thursday,1,Clear,0.7,0.6515,0.65,0.1045,1,26,27,522,27,27
4905,2011-07-28,Fall,2011,Jul,6,0,Thursday,1,Clear,0.7,0.6515,0.7,0.0896,6,110,116,522,116,116
4906,2011-07-28,Fall,2011,Jul,7,0,Thursday,1,Clear,0.72,0.6818,0.7,0.1642,27,278,305,522,305,305
4907,2011-07-28,Fall,2011,Jul,8,0,Thursday,1,Clear,0.74,0.697,0.66,0.1642,47,409,456,522,456,456
4908,2011-07-28,Fall,2011,Jul,9,0,Thursday,1,Clear,0.78,0.7424,0.59,0.194,21,189,210,522,210,210
4909,2011-07-28,Fall,2011,Jul,10,0,Thursday,1,Clear,0.8,0.7576,0.55,0.2836,30,86,116,522,116,116
4910,2011-07-28,Fall,2011,Jul,11,0,Thursday,1,Clear,0.84,0.8182,0.56,0.2836,41,113,154,522,154,154
4911,2011-07-28,Fall,2011,Jul,12,0,Thursday,1,Clear,0.84,0.803,0.53,0.2537,35,151,186,522,186,186
4912,2011-07-28,Fall,2011,Jul,13,0,Thursday,1,Clear,0.86,0.803,0.47,0.2537,26,126,152,522,152,152
4913,2011-07-28,Fall,2011,Jul,14,0,Thursday,1,Misty,0.84,0.7879,0.49,0.2537,27,111,138,522,138,138
4914,2011-07-28,Fall,2011,Jul,15,0,Thursday,1,Clear,0.86,0.8182,0.5,0.194,22,124,146,522,146,146
4915,2011-07-28,Fall,2011,Jul,16,0,Thursday,1,Clear,0.86,0.803,0.47,0.1642,42,214,256,522,256,256
4916,2011-07-28,Fall,2011,Jul,17,0,Thursday,1,Clear,0.84,0.803,0.53,0.194,45,423,468,522,468,468
4917,2011-07-28,Fall,2011,Jul,18,0,Thursday,1,Clear,0.84,0.8182,0.56,0.2239,55,428,483,522,483,483
4918,2011-07-28,Fall,2011,Jul,19,0,Thursday,1,Clear,0.82,0.803,0.59,0.194,37,285,322,522,322,322
4919,2011-07-28,Fall,2011,Jul,20,0,Thursday,1,Clear,0.8,0.7879,0.63,0.194,41,229,270,522,270,270
4920,2011-07-28,Fall,2011,Jul,21,0,Thursday,1,Clear,0.78,0.7576,0.66,0.2836,31,165,196,522,196,196
4921,2011-07-28,Fall,2011,Jul,22,0,Thursday,1,Clear,0.76,0.7273,0.7,0.2537,25,149,174,522,174,174
4922,2011-07-28,Fall,2011,Jul,23,0,Thursday,1,Clear,0.76,0.7424,0.75,0.194,28,95,123,522,123,123
4923,2011-07-29,Fall,2011,Jul,0,0,Friday,1,Clear,0.74,0.7121,0.79,0.1642,12,45,57,521,57,57
4924,2011-07-29,Fall,2011,Jul,1,0,Friday,1,Clear,0.74,0.7121,0.79,0.1343,12,22,34,521,34,34
4925,2011-07-29,Fall,2011,Jul,2,0,Friday,1,Clear,0.74,0.7121,0.79,0.0,3,10,13,521,13,13
4926,2011-07-29,Fall,2011,Jul,3,0,Friday,1,Clear,0.74,0.7121,0.79,0.0,2,9,11,521,11,11
4927,2011-07-29,Fall,2011,Jul,4,0,Friday,1,Clear,0.72,0.7121,0.84,0.1343,2,4,6,521,6,6
4928,2011-07-29,Fall,2011,Jul,5,0,Friday,1,Clear,0.72,0.7121,0.84,0.0,4,23,27,521,27,27
4929,2011-07-29,Fall,2011,Jul,6,0,Friday,1,Misty,0.72,0.7121,0.84,0.0,7,83,90,521,90,90
4930,2011-07-29,Fall,2011,Jul,7,0,Friday,1,Misty,0.74,0.7121,0.79,0.0896,26,228,254,521,254,254
4931,2011-07-29,Fall,2011,Jul,8,0,Friday,1,Misty,0.76,0.7727,0.77,0.0,30,354,384,521,384,384
4932,2011-07-29,Fall,2011,Jul,9,0,Friday,1,Clear,0.86,0.803,0.47,0.2537,28,151,179,521,179,179
4933,2011-07-29,Fall,2011,Jul,10,0,Friday,1,Clear,0.9,0.8485,0.42,0.2836,37,69,106,521,106,106
4934,2011-07-29,Fall,2011,Jul,11,0,Friday,1,Clear,0.92,0.8788,0.4,0.2985,43,118,161,521,161,161
4935,2011-07-29,Fall,2011,Jul,12,0,Friday,1,Clear,0.96,0.8636,0.31,0.2836,40,95,135,521,135,135
4936,2011-07-29,Fall,2011,Jul,13,0,Friday,1,Clear,0.94,0.8333,0.31,0.0,42,114,156,521,156,156
4937,2011-07-29,Fall,2011,Jul,14,0,Friday,1,Clear,0.96,0.8636,0.3,0.2239,34,114,148,521,148,148
4938,2011-07-29,Fall,2011,Jul,15,0,Friday,1,Clear,0.96,0.8636,0.3,0.2537,40,129,169,521,169,169
4939,2011-07-29,Fall,2011,Jul,16,0,Friday,1,Clear,0.96,0.8636,0.3,0.3881,35,198,233,521,233,233
4940,2011-07-29,Fall,2011,Jul,17,0,Friday,1,Clear,0.96,0.8636,0.3,0.2985,47,374,421,521,421,421
4941,2011-07-29,Fall,2011,Jul,18,0,Friday,1,Clear,0.92,0.8636,0.37,0.3284,49,313,362,521,362,362
4942,2011-07-29,Fall,2011,Jul,19,0,Friday,1,Clear,0.9,0.8485,0.42,0.2239,22,219,241,521,241,241
4943,2011-07-29,Fall,2011,Jul,20,0,Friday,1,Clear,0.86,0.7879,0.41,0.3284,53,153,206,521,206,206
4944,2011-07-29,Fall,2011,Jul,21,0,Friday,1,Clear,0.82,0.7576,0.46,0.1642,29,134,163,521,163,163
4945,2011-07-29,Fall,2011,Jul,22,0,Friday,1,Clear,0.8,0.7424,0.49,0.2239,47,127,174,521,174,174
4946,2011-07-29,Fall,2011,Jul,23,0,Friday,1,Clear,0.78,0.7121,0.52,0.1045,26,90,116,521,116,116
4947,2011-07-30,Fall,2011,Jul,0,0,Saturday,0,Clear,0.76,0.697,0.55,0.194,60,73,133,520,133,133
4948,2011-07-30,Fall,2011,Jul,1,0,Saturday,0,Clear,0.76,0.697,0.55,0.0896,15,75,90,520,90,90
4949,2011-07-30,Fall,2011,Jul,2,0,Saturday,0,Clear,0.76,0.697,0.55,0.1045,11,31,42,520,42,42
4950,2011-07-30,Fall,2011,Jul,3,0,Saturday,0,Clear,0.74,0.6818,0.62,0.1642,18,25,43,520,43,43
4951,2011-07-30,Fall,2011,Jul,4,0,Saturday,0,Clear,0.72,0.6818,0.66,0.1642,4,6,10,520,10,10
4952,2011-07-30,Fall,2011,Jul,5,0,Saturday,0,Clear,0.72,0.6818,0.7,0.2836,4,9,13,520,13,13
4953,2011-07-30,Fall,2011,Jul,6,0,Saturday,0,Clear,0.72,0.6818,0.7,0.2985,6,18,24,520,24,24
4954,2011-07-30,Fall,2011,Jul,7,0,Saturday,0,Clear,0.76,0.7273,0.66,0.194,3,39,42,520,42,42
4955,2011-07-30,Fall,2011,Jul,8,0,Saturday,0,Clear,0.78,0.7424,0.59,0.2239,27,87,114,520,114,114
4956,2011-07-30,Fall,2011,Jul,9,0,Saturday,0,Clear,0.82,0.7576,0.46,0.2985,49,125,174,520,174,174
4957,2011-07-30,Fall,2011,Jul,10,0,Saturday,0,Clear,0.82,0.7424,0.41,0.2985,79,182,261,520,261,261
4958,2011-07-30,Fall,2011,Jul,11,0,Saturday,0,Clear,0.84,0.7424,0.36,0.194,111,206,317,520,317,317
4959,2011-07-30,Fall,2011,Jul,12,0,Saturday,0,Clear,0.84,0.7273,0.32,0.1642,111,230,341,520,341,341
4960,2011-07-30,Fall,2011,Jul,13,0,Saturday,0,Clear,0.88,0.7576,0.29,0.0,125,183,308,520,308,308
4961,2011-07-30,Fall,2011,Jul,14,0,Saturday,0,Clear,0.9,0.7879,0.29,0.0,112,193,305,520,305,305
4962,2011-07-30,Fall,2011,Jul,15,0,Saturday,0,Clear,0.9,0.803,0.31,0.1343,113,189,302,520,302,302
4963,2011-07-30,Fall,2011,Jul,16,0,Saturday,0,Clear,0.9,0.7879,0.27,0.2239,126,176,302,520,302,302
4964,2011-07-30,Fall,2011,Jul,17,0,Saturday,0,Clear,0.9,0.7879,0.29,0.1045,93,209,302,520,302,302
4965,2011-07-30,Fall,2011,Jul,18,0,Saturday,0,Clear,0.88,0.7576,0.28,0.194,92,207,299,520,299,299
4966,2011-07-30,Fall,2011,Jul,19,0,Saturday,0,Clear,0.74,0.6515,0.33,0.2239,101,155,256,520,256,256
4967,2011-07-30,Fall,2011,Jul,20,0,Saturday,0,Clear,0.82,0.7424,0.43,0.1343,74,132,206,520,206,206
4968,2011-07-30,Fall,2011,Jul,21,0,Saturday,0,Clear,0.8,0.7424,0.49,0.1642,82,123,205,520,205,205
4969,2011-07-30,Fall,2011,Jul,22,0,Saturday,0,Clear,0.78,0.7121,0.52,0.1045,80,129,209,520,209,209
4970,2011-07-30,Fall,2011,Jul,23,0,Saturday,0,Clear,0.76,0.697,0.55,0.0896,63,114,177,520,177,177
4971,2011-07-31,Fall,2011,Jul,0,0,Sunday,0,Clear,0.76,0.697,0.55,0.0896,33,80,113,519,113,113
4972,2011-07-31,Fall,2011,Jul,1,0,Sunday,0,Clear,0.74,0.6818,0.62,0.0896,8,71,79,519,79,79
4973,2011-07-31,Fall,2011,Jul,2,0,Sunday,0,Clear,0.74,0.697,0.66,0.0896,19,48,67,519,67,67
4974,2011-07-31,Fall,2011,Jul,3,0,Sunday,0,Clear,0.74,0.697,0.66,0.0,24,26,50,519,50,50
4975,2011-07-31,Fall,2011,Jul,4,0,Sunday,0,Clear,0.72,0.6818,0.7,0.0,6,7,13,519,13,13
4976,2011-07-31,Fall,2011,Jul,5,0,Sunday,0,Clear,0.72,0.6818,0.69,0.0,4,4,8,519,8,8
4977,2011-07-31,Fall,2011,Jul,6,0,Sunday,0,Clear,0.74,0.697,0.7,0.0,5,8,13,519,13,13
4978,2011-07-31,Fall,2011,Jul,7,0,Sunday,0,Clear,0.74,0.6818,0.58,0.1343,19,26,45,519,45,45
4979,2011-07-31,Fall,2011,Jul,8,0,Sunday,0,Clear,0.76,0.697,0.55,0.2239,54,88,142,519,142,142
4980,2011-07-31,Fall,2011,Jul,9,0,Sunday,0,Clear,0.8,0.7424,0.49,0.0,55,128,183,519,183,183
4981,2011-07-31,Fall,2011,Jul,10,0,Sunday,0,Clear,0.84,0.7424,0.36,0.1642,91,163,254,519,254,254
4982,2011-07-31,Fall,2011,Jul,11,0,Sunday,0,Clear,0.86,0.7424,0.28,0.1642,112,163,275,519,275,275
4983,2011-07-31,Fall,2011,Jul,12,0,Sunday,0,Clear,0.9,0.7727,0.25,0.194,146,192,338,519,338,338
4984,2011-07-31,Fall,2011,Jul,13,0,Sunday,0,Clear,0.9,0.7727,0.24,0.1343,142,152,294,519,294,294
4985,2011-07-31,Fall,2011,Jul,14,0,Sunday,0,Clear,0.9,0.7727,0.24,0.1642,130,196,326,519,326,326
4986,2011-07-31,Fall,2011,Jul,15,0,Sunday,0,Clear,0.92,0.7727,0.18,0.2985,109,184,293,519,293,293
4987,2011-07-31,Fall,2011,Jul,16,0,Sunday,0,Clear,0.92,0.7727,0.17,0.2836,98,208,306,519,306,306
4988,2011-07-31,Fall,2011,Jul,17,0,Sunday,0,Clear,0.92,0.7727,0.16,0.1642,114,206,320,519,320,320
4989,2011-07-31,Fall,2011,Jul,18,0,Sunday,0,Clear,0.86,0.7879,0.41,0.2836,91,213,304,519,304,304
4990,2011-07-31,Fall,2011,Jul,19,0,Sunday,0,Clear,0.8,0.7576,0.55,0.3284,87,187,274,519,274,274
4991,2011-07-31,Fall,2011,Jul,20,0,Sunday,0,Clear,0.8,0.7576,0.55,0.3284,70,205,275,519,275,275
4992,2011-07-31,Fall,2011,Jul,21,0,Sunday,0,Clear,0.78,0.7424,0.59,0.2985,68,96,164,519,164,164
4993,2011-07-31,Fall,2011,Jul,22,0,Sunday,0,Clear,0.74,0.697,0.7,0.2985,25,71,96,519,96,96
4994,2011-07-31,Fall,2011,Jul,23,0,Sunday,0,Clear,0.74,0.697,0.66,0.2239,14,56,70,519,70,70
4995,2011-08-01,Fall,2011,Aug,0,0,Monday,1,Clear,0.72,0.6818,0.7,0.2239,7,22,29,518,29,29
4996,2011-08-01,Fall,2011,Aug,1,0,Monday,1,Clear,0.72,0.697,0.74,0.194,5,12,17,518,17,17
4997,2011-08-01,Fall,2011,Aug,2,0,Monday,1,Clear,0.7,0.6667,0.74,0.1045,4,7,11,518,11,11
4998,2011-08-01,Fall,2011,Aug,3,0,Monday,1,Clear,0.7,0.6667,0.79,0.1642,0,4,4,518,4,4
4999,2011-08-01,Fall,2011,Aug,4,0,Monday,1,Clear,0.66,0.6061,0.83,0.1343,2,2,4,518,4,4
5000,2011-08-01,Fall,2011,Aug,5,0,Monday,1,Clear,0.66,0.6061,0.83,0.1045,2,24,26,518,26,26
5001,2011-08-01,Fall,2011,Aug,6,0,Monday,1,Clear,0.66,0.6061,0.83,0.0896,3,97,100,518,100,100
5002,2011-08-01,Fall,2011,Aug,7,0,Monday,1,Clear,0.74,0.6818,0.62,0.0,24,258,282,518,282,282
5003,2011-08-01,Fall,2011,Aug,8,0,Monday,1,Clear,0.8,0.7273,0.43,0.194,35,347,382,518,382,382
5004,2011-08-01,Fall,2011,Aug,9,0,Monday,1,Clear,0.82,0.7424,0.41,0.0,27,139,166,518,166,166
5005,2011-08-01,Fall,2011,Aug,10,0,Monday,1,Clear,0.86,0.7576,0.36,0.1642,27,70,97,518,97,97
5006,2011-08-01,Fall,2011,Aug,11,0,Monday,1,Clear,0.88,0.7727,0.32,0.1642,53,66,119,518,119,119
5007,2011-08-01,Fall,2011,Aug,12,0,Monday,1,Clear,0.9,0.803,0.33,0.2537,53,115,168,518,168,168
5008,2011-08-01,Fall,2011,Aug,13,0,Monday,1,Clear,0.9,0.803,0.31,0.2985,38,112,150,518,150,150
5009,2011-08-01,Fall,2011,Aug,14,0,Monday,1,Clear,0.92,0.8182,0.29,0.194,37,86,123,518,123,123
5010,2011-08-01,Fall,2011,Aug,15,0,Monday,1,Clear,0.9,0.7879,0.27,0.0,52,77,129,518,129,129
5011,2011-08-01,Fall,2011,Aug,16,0,Monday,1,Clear,0.9,0.7879,0.27,0.0,34,197,231,518,231,231
5012,2011-08-01,Fall,2011,Aug,17,0,Monday,1,Clear,0.76,0.6818,0.45,0.2985,69,445,514,518,514,514
5013,2011-08-01,Fall,2011,Aug,18,0,Monday,1,Clear,0.78,0.697,0.43,0.194,68,475,543,518,543,543
5014,2011-08-01,Fall,2011,Aug,19,0,Monday,1,Clear,0.74,0.6667,0.51,0.2239,63,350,413,518,413,413
5015,2011-08-01,Fall,2011,Aug,20,0,Monday,1,Clear,0.72,0.6818,0.62,0.2239,49,256,305,518,305,305
5016,2011-08-01,Fall,2011,Aug,21,0,Monday,1,Clear,0.7,0.6515,0.7,0.2537,42,178,220,518,220,220
5017,2011-08-01,Fall,2011,Aug,22,0,Monday,1,Clear,0.7,0.6515,0.7,0.0896,21,116,137,518,137,137
5018,2011-08-01,Fall,2011,Aug,23,0,Monday,1,Clear,0.68,0.6364,0.74,0.194,14,82,96,518,96,96
5019,2011-08-02,Fall,2011,Aug,0,0,Tuesday,1,Clear,0.66,0.6212,0.74,0.0,11,18,29,517,29,29
5020,2011-08-02,Fall,2011,Aug,1,0,Tuesday,1,Clear,0.66,0.6212,0.74,0.1045,4,8,12,517,12,12
5021,2011-08-02,Fall,2011,Aug,2,0,Tuesday,1,Clear,0.68,0.6364,0.69,0.0,2,6,8,517,8,8
5022,2011-08-02,Fall,2011,Aug,3,0,Tuesday,1,Clear,0.66,0.6212,0.74,0.194,0,5,5,517,5,5
5023,2011-08-02,Fall,2011,Aug,4,0,Tuesday,1,Clear,0.66,0.6212,0.74,0.1045,0,10,10,517,10,10
5024,2011-08-02,Fall,2011,Aug,5,0,Tuesday,1,Clear,0.66,0.6212,0.74,0.1343,4,17,21,517,21,21
5025,2011-08-02,Fall,2011,Aug,6,0,Tuesday,1,Clear,0.68,0.6364,0.69,0.1045,12,105,117,517,117,117
5026,2011-08-02,Fall,2011,Aug,7,0,Tuesday,1,Clear,0.72,0.6667,0.61,0.2836,15,320,335,517,335,335
5027,2011-08-02,Fall,2011,Aug,8,0,Tuesday,1,Clear,0.74,0.6818,0.58,0.2836,37,398,435,517,435,435
5028,2011-08-02,Fall,2011,Aug,9,0,Tuesday,1,Clear,0.78,0.697,0.46,0.2985,31,182,213,517,213,213
5029,2011-08-02,Fall,2011,Aug,10,0,Tuesday,1,Clear,0.82,0.7273,0.36,0.2985,50,90,140,517,140,140
5030,2011-08-02,Fall,2011,Aug,11,0,Tuesday,1,Clear,0.84,0.7273,0.32,0.4179,32,96,128,517,128,128
5031,2011-08-02,Fall,2011,Aug,12,0,Tuesday,1,Clear,0.86,0.7424,0.3,0.2836,45,112,157,517,157,157
5032,2011-08-02,Fall,2011,Aug,13,0,Tuesday,1,Clear,0.86,0.7424,0.3,0.2239,50,153,203,517,203,203
5033,2011-08-02,Fall,2011,Aug,14,0,Tuesday,1,Clear,0.9,0.7727,0.25,0.2836,45,114,159,517,159,159
5034,2011-08-02,Fall,2011,Aug,15,0,Tuesday,1,Clear,0.9,0.7727,0.25,0.2836,48,120,168,517,168,168
5035,2011-08-02,Fall,2011,Aug,16,0,Tuesday,1,Clear,0.9,0.7727,0.25,0.2836,58,216,274,517,274,274
5036,2011-08-02,Fall,2011,Aug,17,0,Tuesday,1,Misty,0.9,0.7879,0.27,0.1343,63,493,556,517,556,556
5037,2011-08-02,Fall,2011,Aug,18,0,Tuesday,1,Misty,0.86,0.7576,0.34,0.194,65,491,556,517,556,556
5038,2011-08-02,Fall,2011,Aug,19,0,Tuesday,1,Misty,0.86,0.7576,0.36,0.2239,85,369,454,517,454,454
5039,2011-08-02,Fall,2011,Aug,20,0,Tuesday,1,Misty,0.82,0.7576,0.46,0.2537,40,248,288,517,288,288
5040,2011-08-02,Fall,2011,Aug,21,0,Tuesday,1,Clear,0.8,0.7424,0.52,0.2239,53,201,254,517,254,254
5041,2011-08-02,Fall,2011,Aug,22,0,Tuesday,1,Misty,0.78,0.7424,0.59,0.1642,22,169,191,517,191,191
5042,2011-08-02,Fall,2011,Aug,23,0,Tuesday,1,Misty,0.8,0.7424,0.49,0.1642,29,103,132,517,132,132
5043,2011-08-03,Fall,2011,Aug,0,0,Wednesday,1,Misty,0.8,0.7424,0.49,0.1642,11,32,43,516,43,43
5044,2011-08-03,Fall,2011,Aug,1,0,Wednesday,1,Misty,0.78,0.7121,0.52,0.1642,7,9,16,516,16,16
5045,2011-08-03,Fall,2011,Aug,2,0,Wednesday,1,Misty,0.78,0.7121,0.49,0.1642,2,9,11,516,11,11
5046,2011-08-03,Fall,2011,Aug,3,0,Wednesday,1,Misty,0.76,0.697,0.55,0.0896,0,4,4,516,4,4
5047,2011-08-03,Fall,2011,Aug,4,0,Wednesday,1,Misty,0.76,0.697,0.52,0.1642,0,7,7,516,7,7
5048,2011-08-03,Fall,2011,Aug,5,0,Wednesday,1,Misty,0.76,0.697,0.55,0.0896,2,22,24,516,24,24
5049,2011-08-03,Fall,2011,Aug,6,0,Wednesday,1,Light_rainsnow,0.72,0.6818,0.66,0.4925,9,101,110,516,110,110
5050,2011-08-03,Fall,2011,Aug,7,0,Wednesday,1,Misty,0.74,0.6667,0.51,0.2239,19,252,271,516,271,271
5051,2011-08-03,Fall,2011,Aug,8,0,Wednesday,1,Misty,0.74,0.6667,0.51,0.1642,29,408,437,516,437,437
5052,2011-08-03,Fall,2011,Aug,9,0,Wednesday,1,Misty,0.74,0.6818,0.55,0.194,23,172,195,516,195,195
5053,2011-08-03,Fall,2011,Aug,10,0,Wednesday,1,Light_rainsnow,0.74,0.6818,0.58,0.0896,9,59,68,516,68,68
5054,2011-08-03,Fall,2011,Aug,11,0,Wednesday,1,Misty,0.74,0.6818,0.58,0.1045,29,93,122,516,122,122
5055,2011-08-03,Fall,2011,Aug,12,0,Wednesday,1,Light_rainsnow,0.76,0.697,0.55,0.1343,19,142,161,516,161,161
5056,2011-08-03,Fall,2011,Aug,13,0,Wednesday,1,Misty,0.76,0.7121,0.58,0.2239,37,107,144,516,144,144
5057,2011-08-03,Fall,2011,Aug,14,0,Wednesday,1,Misty,0.76,0.7121,0.58,0.2239,43,104,147,516,147,147
5058,2011-08-03,Fall,2011,Aug,15,0,Wednesday,1,Misty,0.7,0.6667,0.79,0.1343,31,87,118,516,118,118
5059,2011-08-03,Fall,2011,Aug,16,0,Wednesday,1,Light_rainsnow,0.68,0.6364,0.79,0.0,21,129,150,516,150,150
5060,2011-08-03,Fall,2011,Aug,17,0,Wednesday,1,Misty,0.7,0.6667,0.79,0.0,47,378,425,516,425,425
5061,2011-08-03,Fall,2011,Aug,18,0,Wednesday,1,Light_rainsnow,0.7,0.6667,0.84,0.0,49,443,492,516,492,492
5062,2011-08-03,Fall,2011,Aug,19,0,Wednesday,1,Light_rainsnow,0.7,0.6667,0.84,0.0,51,270,321,516,321,321
5063,2011-08-03,Fall,2011,Aug,20,0,Wednesday,1,Light_rainsnow,0.7,0.6667,0.84,0.1045,7,80,87,516,87,87
5064,2011-08-03,Fall,2011,Aug,21,0,Wednesday,1,Misty,0.68,0.6364,0.89,0.1343,7,81,88,516,88,88
5065,2011-08-03,Fall,2011,Aug,22,0,Wednesday,1,Light_rainsnow,0.68,0.6364,0.89,0.1045,11,66,77,516,77,77
5066,2011-08-03,Fall,2011,Aug,23,0,Wednesday,1,Misty,0.68,0.6364,0.89,0.0896,4,52,56,516,56,56
5067,2011-08-04,Fall,2011,Aug,0,0,Thursday,1,Misty,0.68,0.6364,0.89,0.0896,2,15,17,515,17,17
5068,2011-08-04,Fall,2011,Aug,1,0,Thursday,1,Misty,0.66,0.5909,0.94,0.0896,3,14,17,515,17,17
5069,2011-08-04,Fall,2011,Aug,2,0,Thursday,1,Misty,0.66,0.5909,0.94,0.0896,2,5,7,515,7,7
5070,2011-08-04,Fall,2011,Aug,3,0,Thursday,1,Light_rainsnow,0.66,0.5909,0.94,0.0896,0,3,3,515,3,3
5071,2011-08-04,Fall,2011,Aug,4,0,Thursday,1,Misty,0.68,0.6364,0.89,0.0,0,7,7,515,7,7
5072,2011-08-04,Fall,2011,Aug,5,0,Thursday,1,Misty,0.68,0.6364,0.89,0.0,3,17,20,515,20,20
5073,2011-08-04,Fall,2011,Aug,6,0,Thursday,1,Misty,0.68,0.6364,0.89,0.2985,7,90,97,515,97,97
5074,2011-08-04,Fall,2011,Aug,7,0,Thursday,1,Misty,0.68,0.6364,0.89,0.2985,11,271,282,515,282,282
5075,2011-08-04,Fall,2011,Aug,8,0,Thursday,1,Misty,0.7,0.6515,0.82,0.3582,29,369,398,515,398,398
5076,2011-08-04,Fall,2011,Aug,9,0,Thursday,1,Clear,0.72,0.697,0.74,0.3284,25,162,187,515,187,187
5077,2011-08-04,Fall,2011,Aug,10,0,Thursday,1,Clear,0.72,0.6667,0.71,0.2985,24,89,113,515,113,113
5078,2011-08-04,Fall,2011,Aug,11,0,Thursday,1,Misty,0.74,0.697,0.66,0.2239,37,112,149,515,149,149
5079,2011-08-04,Fall,2011,Aug,12,0,Thursday,1,Misty,0.76,0.7121,0.62,0.2239,53,152,205,515,205,205
5080,2011-08-04,Fall,2011,Aug,13,0,Thursday,1,Clear,0.76,0.7121,0.58,0.0,63,142,205,515,205,205
5081,2011-08-04,Fall,2011,Aug,14,0,Thursday,1,Clear,0.8,0.7576,0.55,0.1642,53,114,167,515,167,167
5082,2011-08-04,Fall,2011,Aug,15,0,Thursday,1,Clear,0.8,0.7576,0.55,0.2537,50,115,165,515,165,165
5083,2011-08-04,Fall,2011,Aug,16,0,Thursday,1,Clear,0.76,0.7121,0.62,0.3284,70,220,290,515,290,290
5084,2011-08-04,Fall,2011,Aug,17,0,Thursday,1,Clear,0.76,0.7121,0.62,0.3284,91,464,555,515,555,555
5085,2011-08-04,Fall,2011,Aug,18,0,Thursday,1,Clear,0.7,0.6667,0.74,0.2985,88,435,523,515,523,523
5086,2011-08-04,Fall,2011,Aug,19,0,Thursday,1,Clear,0.7,0.6667,0.74,0.2836,65,301,366,515,366,366
5087,2011-08-04,Fall,2011,Aug,20,0,Thursday,1,Misty,0.7,0.6667,0.74,0.194,41,245,286,515,286,286
5088,2011-08-04,Fall,2011,Aug,21,0,Thursday,1,Misty,0.7,0.6667,0.74,0.194,25,186,211,515,211,211
5089,2011-08-04,Fall,2011,Aug,22,0,Thursday,1,Clear,0.68,0.6364,0.74,0.194,33,141,174,515,174,174
5090,2011-08-04,Fall,2011,Aug,23,0,Thursday,1,Clear,0.66,0.6212,0.74,0.1045,24,108,132,515,132,132
5091,2011-08-05,Fall,2011,Aug,0,0,Friday,1,Clear,0.66,0.6212,0.74,0.1045,13,41,54,514,54,54
5092,2011-08-05,Fall,2011,Aug,1,0,Friday,1,Clear,0.64,0.5909,0.78,0.0896,3,16,19,514,19,19
5093,2011-08-05,Fall,2011,Aug,2,0,Friday,1,Clear,0.66,0.6212,0.69,0.0,5,14,19,514,19,19
5094,2011-08-05,Fall,2011,Aug,3,0,Friday,1,Clear,0.64,0.5909,0.78,0.0896,0,6,6,514,6,6
5095,2011-08-05,Fall,2011,Aug,4,0,Friday,1,Clear,0.64,0.5909,0.78,0.1343,1,6,7,514,7,7
5096,2011-08-05,Fall,2011,Aug,5,0,Friday,1,Clear,0.64,0.5909,0.78,0.0896,0,16,16,514,16,16
5097,2011-08-05,Fall,2011,Aug,6,0,Friday,1,Clear,0.64,0.5909,0.78,0.1343,7,94,101,514,101,101
5098,2011-08-05,Fall,2011,Aug,7,0,Friday,1,Clear,0.66,0.6061,0.78,0.1343,23,247,270,514,270,270
5099,2011-08-05,Fall,2011,Aug,8,0,Friday,1,Clear,0.7,0.6515,0.65,0.2239,39,415,454,514,454,454
5100,2011-08-05,Fall,2011,Aug,9,0,Friday,1,Clear,0.72,0.6667,0.58,0.1045,43,183,226,514,226,226
5101,2011-08-05,Fall,2011,Aug,10,0,Friday,1,Clear,0.74,0.6818,0.55,0.1343,50,113,163,514,163,163
5102,2011-08-05,Fall,2011,Aug,11,0,Friday,1,Misty,0.76,0.697,0.52,0.2537,44,103,147,514,147,147
5103,2011-08-05,Fall,2011,Aug,12,0,Friday,1,Clear,0.76,0.697,0.52,0.2537,57,159,216,514,216,216
5104,2011-08-05,Fall,2011,Aug,13,0,Friday,1,Clear,0.78,0.7121,0.52,0.2537,40,164,204,514,204,204
5105,2011-08-05,Fall,2011,Aug,14,0,Friday,1,Misty,0.78,0.7121,0.52,0.2537,81,164,245,514,245,245
5106,2011-08-05,Fall,2011,Aug,15,0,Friday,1,Clear,0.76,0.697,0.55,0.2537,50,160,210,514,210,210
5107,2011-08-05,Fall,2011,Aug,16,0,Friday,1,Clear,0.8,0.7424,0.49,0.2537,76,254,330,514,330,330
5108,2011-08-05,Fall,2011,Aug,17,0,Friday,1,Clear,0.78,0.7121,0.49,0.2985,84,466,550,514,550,550
5109,2011-08-05,Fall,2011,Aug,18,0,Friday,1,Clear,0.76,0.697,0.52,0.2537,105,361,466,514,466,466
5110,2011-08-05,Fall,2011,Aug,19,0,Friday,1,Clear,0.74,0.6818,0.55,0.2537,90,282,372,514,372,372
5111,2011-08-05,Fall,2011,Aug,20,0,Friday,1,Clear,0.72,0.6667,0.58,0.2239,70,221,291,514,291,291
5112,2011-08-05,Fall,2011,Aug,21,0,Friday,1,Clear,0.7,0.6515,0.65,0.194,54,119,173,514,173,173
5113,2011-08-05,Fall,2011,Aug,22,0,Friday,1,Clear,0.7,0.6515,0.65,0.2239,51,137,188,514,188,188
5114,2011-08-05,Fall,2011,Aug,23,0,Friday,1,Clear,0.68,0.6364,0.69,0.2239,37,102,139,514,139,139
5115,2011-08-06,Fall,2011,Aug,0,0,Saturday,0,Clear,0.66,0.6061,0.78,0.194,29,104,133,513,133,133
5116,2011-08-06,Fall,2011,Aug,1,0,Saturday,0,Clear,0.66,0.6061,0.78,0.1642,17,50,67,513,67,67
5117,2011-08-06,Fall,2011,Aug,2,0,Saturday,0,Clear,0.66,0.6061,0.78,0.2239,14,39,53,513,53,53
5118,2011-08-06,Fall,2011,Aug,3,0,Saturday,0,Misty,0.66,0.6061,0.78,0.1642,14,28,42,513,42,42
5119,2011-08-06,Fall,2011,Aug,4,0,Saturday,0,Misty,0.66,0.6061,0.83,0.1642,5,5,10,513,10,10
5120,2011-08-06,Fall,2011,Aug,5,0,Saturday,0,Clear,0.64,0.5758,0.89,0.0896,2,4,6,513,6,6
5121,2011-08-06,Fall,2011,Aug,6,0,Saturday,0,Clear,0.64,0.5758,0.89,0.1045,5,22,27,513,27,27
5122,2011-08-06,Fall,2011,Aug,7,0,Saturday,0,Clear,0.68,0.6364,0.83,0.1642,14,49,63,513,63,63
5123,2011-08-06,Fall,2011,Aug,8,0,Saturday,0,Clear,0.68,0.6364,0.83,0.1642,27,94,121,513,121,121
5124,2011-08-06,Fall,2011,Aug,9,0,Saturday,0,Clear,0.74,0.697,0.7,0.2239,60,155,215,513,215,215
5125,2011-08-06,Fall,2011,Aug,10,0,Saturday,0,Misty,0.74,0.697,0.7,0.2836,91,199,290,513,290,290
5126,2011-08-06,Fall,2011,Aug,11,0,Saturday,0,Clear,0.78,0.7424,0.62,0.2239,138,211,349,513,349,349
5127,2011-08-06,Fall,2011,Aug,12,0,Saturday,0,Clear,0.8,0.7576,0.55,0.2239,130,252,382,513,382,382
5128,2011-08-06,Fall,2011,Aug,13,0,Saturday,0,Misty,0.8,0.7727,0.59,0.3284,176,265,441,513,441,441
5129,2011-08-06,Fall,2011,Aug,14,0,Saturday,0,Clear,0.82,0.7727,0.52,0.2537,176,204,380,513,380,380
5130,2011-08-06,Fall,2011,Aug,15,0,Saturday,0,Misty,0.84,0.803,0.53,0.2537,130,232,362,513,362,362
5131,2011-08-06,Fall,2011,Aug,16,0,Saturday,0,Light_rainsnow,0.74,0.7121,0.79,0.1642,155,188,343,513,343,343
5132,2011-08-06,Fall,2011,Aug,17,0,Saturday,0,Light_rainsnow,0.74,0.7121,0.79,0.1642,61,88,149,513,149,149
5133,2011-08-06,Fall,2011,Aug,18,0,Saturday,0,Misty,0.72,0.697,0.79,0.4478,81,130,211,513,211,211
5134,2011-08-06,Fall,2011,Aug,19,0,Saturday,0,Light_rainsnow,0.72,0.7121,0.84,0.2537,57,114,171,513,171,171
5135,2011-08-06,Fall,2011,Aug,20,0,Saturday,0,Light_rainsnow,0.72,0.697,0.79,0.2836,58,79,137,513,137,137
5136,2011-08-06,Fall,2011,Aug,21,0,Saturday,0,Misty,0.7,0.6667,0.84,0.3284,28,86,114,513,114,114
5137,2011-08-06,Fall,2011,Aug,22,0,Saturday,0,Misty,0.7,0.6667,0.84,0.3284,24,96,120,513,120,120
5138,2011-08-06,Fall,2011,Aug,23,0,Saturday,0,Light_rainsnow,0.7,0.6667,0.84,0.2836,29,79,108,513,108,108
5139,2011-08-07,Fall,2011,Aug,0,0,Sunday,0,Misty,0.7,0.6667,0.84,0.2836,14,66,80,512,80,80
5140,2011-08-07,Fall,2011,Aug,1,0,Sunday,0,Misty,0.7,0.6667,0.84,0.2537,10,63,73,512,73,73
5141,2011-08-07,Fall,2011,Aug,2,0,Sunday,0,Misty,0.7,0.6667,0.84,0.2239,18,48,66,512,66,66
5142,2011-08-07,Fall,2011,Aug,3,0,Sunday,0,Misty,0.7,0.6667,0.84,0.1343,9,23,32,512,32,32
5143,2011-08-07,Fall,2011,Aug,4,0,Sunday,0,Clear,0.7,0.6667,0.84,0.1343,1,5,6,512,6,6
5144,2011-08-07,Fall,2011,Aug,5,0,Sunday,0,Clear,0.7,0.6667,0.89,0.194,1,4,5,512,5,5
5145,2011-08-07,Fall,2011,Aug,6,0,Sunday,0,Clear,0.7,0.6667,0.89,0.1642,3,10,13,512,13,13
5146,2011-08-07,Fall,2011,Aug,7,0,Sunday,0,Clear,0.7,0.6667,0.84,0.194,11,28,39,512,39,39
5147,2011-08-07,Fall,2011,Aug,8,0,Sunday,0,Clear,0.72,0.697,0.79,0.194,23,66,89,512,89,89
5148,2011-08-07,Fall,2011,Aug,9,0,Sunday,0,Clear,0.76,0.7424,0.75,0.1045,82,102,184,512,184,184
5149,2011-08-07,Fall,2011,Aug,10,0,Sunday,0,Clear,0.8,0.803,0.66,0.1343,88,178,266,512,266,266
5150,2011-08-07,Fall,2011,Aug,11,0,Sunday,0,Clear,0.82,0.8333,0.63,0.0,113,156,269,512,269,269
5151,2011-08-07,Fall,2011,Aug,12,0,Sunday,0,Clear,0.9,0.8485,0.42,0.2985,161,209,370,512,370,370
5152,2011-08-07,Fall,2011,Aug,13,0,Sunday,0,Clear,0.9,0.8485,0.42,0.2985,118,206,324,512,324,324
5153,2011-08-07,Fall,2011,Aug,14,0,Sunday,0,Clear,0.86,0.803,0.47,0.194,130,192,322,512,322,322
5154,2011-08-07,Fall,2011,Aug,15,0,Sunday,0,Light_rainsnow,0.72,0.697,0.74,0.2985,118,208,326,512,326,326
5155,2011-08-07,Fall,2011,Aug,16,0,Sunday,0,Light_rainsnow,0.72,0.697,0.74,0.2985,74,119,193,512,193,193
5156,2011-08-07,Fall,2011,Aug,17,0,Sunday,0,Light_rainsnow,0.74,0.7121,0.74,0.6418,63,131,194,512,194,194
5157,2011-08-07,Fall,2011,Aug,18,0,Sunday,0,Clear,0.72,0.697,0.74,0.0896,74,155,229,512,229,229
5158,2011-08-07,Fall,2011,Aug,19,0,Sunday,0,Clear,0.72,0.697,0.79,0.1642,68,160,228,512,228,228
5159,2011-08-07,Fall,2011,Aug,20,0,Sunday,0,Clear,0.72,0.7121,0.84,0.1343,50,133,183,512,183,183
5160,2011-08-07,Fall,2011,Aug,21,0,Sunday,0,Clear,0.72,0.7121,0.84,0.1045,36,100,136,512,136,136
5161,2011-08-07,Fall,2011,Aug,22,0,Sunday,0,Clear,0.7,0.6667,0.89,0.194,21,82,103,512,103,103
5162,2011-08-07,Fall,2011,Aug,23,0,Sunday,0,Clear,0.7,0.6667,0.79,0.1045,12,43,55,512,55,55
5163,2011-08-08,Fall,2011,Aug,0,0,Monday,1,Clear,0.7,0.6667,0.79,0.1045,13,17,30,511,30,30
5164,2011-08-08,Fall,2011,Aug,1,0,Monday,1,Clear,0.68,0.6364,0.83,0.1343,4,8,12,511,12,12
5165,2011-08-08,Fall,2011,Aug,2,0,Monday,1,Clear,0.66,0.5909,0.89,0.0,4,3,7,511,7,7
5166,2011-08-08,Fall,2011,Aug,3,0,Monday,1,Clear,0.66,0.5909,0.89,0.0,1,0,1,511,1,1
5167,2011-08-08,Fall,2011,Aug,4,0,Monday,1,Clear,0.66,0.5909,0.89,0.1045,2,8,10,511,10,10
5168,2011-08-08,Fall,2011,Aug,5,0,Monday,1,Clear,0.7,0.6667,0.79,0.0896,1,14,15,511,15,15
5169,2011-08-08,Fall,2011,Aug,6,0,Monday,1,Clear,0.7,0.6515,0.65,0.2836,8,87,95,511,95,95
5170,2011-08-08,Fall,2011,Aug,7,0,Monday,1,Clear,0.72,0.6818,0.62,0.2985,18,249,267,511,267,267
5171,2011-08-08,Fall,2011,Aug,8,0,Monday,1,Clear,0.74,0.6818,0.58,0.3284,29,320,349,511,349,349
5172,2011-08-08,Fall,2011,Aug,9,0,Monday,1,Clear,0.76,0.697,0.55,0.3881,37,146,183,511,183,183
5173,2011-08-08,Fall,2011,Aug,10,0,Monday,1,Clear,0.8,0.7424,0.52,0.3881,62,62,124,511,124,124
5174,2011-08-08,Fall,2011,Aug,11,0,Monday,1,Clear,0.82,0.7424,0.48,0.3582,90,89,179,511,179,179
5175,2011-08-08,Fall,2011,Aug,12,0,Monday,1,Clear,0.82,0.7576,0.46,0.2537,48,134,182,511,182,182
5176,2011-08-08,Fall,2011,Aug,13,0,Monday,1,Clear,0.84,0.7576,0.44,0.2985,43,108,151,511,151,151
5177,2011-08-08,Fall,2011,Aug,14,0,Monday,1,Clear,0.82,0.7424,0.43,0.2985,41,109,150,511,150,150
5178,2011-08-08,Fall,2011,Aug,15,0,Monday,1,Clear,0.84,0.7576,0.41,0.2985,40,86,126,511,126,126
5179,2011-08-08,Fall,2011,Aug,16,0,Monday,1,Clear,0.86,0.7727,0.39,0.2836,64,218,282,511,282,282
5180,2011-08-08,Fall,2011,Aug,17,0,Monday,1,Clear,0.86,0.7727,0.39,0.1642,67,460,527,511,527,527
5181,2011-08-08,Fall,2011,Aug,18,0,Monday,1,Clear,0.84,0.7576,0.41,0.1343,64,465,529,511,529,529
5182,2011-08-08,Fall,2011,Aug,19,0,Monday,1,Clear,0.82,0.7424,0.43,0.1045,64,352,416,511,416,416
5183,2011-08-08,Fall,2011,Aug,20,0,Monday,1,Clear,0.8,0.7576,0.55,0.0,71,215,286,511,286,286
5184,2011-08-08,Fall,2011,Aug,21,0,Monday,1,Clear,0.76,0.7121,0.58,0.0896,30,156,186,511,186,186
5185,2011-08-08,Fall,2011,Aug,22,0,Monday,1,Clear,0.76,0.7121,0.58,0.1045,26,121,147,511,147,147
5186,2011-08-08,Fall,2011,Aug,23,0,Monday,1,Clear,0.74,0.697,0.66,0.1045,19,53,72,511,72,72
5187,2011-08-09,Fall,2011,Aug,0,0,Tuesday,1,Clear,0.72,0.697,0.79,0.1343,10,25,35,510,35,35
5188,2011-08-09,Fall,2011,Aug,1,0,Tuesday,1,Clear,0.72,0.6818,0.66,0.0,5,9,14,510,14,14
5189,2011-08-09,Fall,2011,Aug,2,0,Tuesday,1,Clear,0.72,0.6818,0.7,0.0,9,3,12,510,12,12
5190,2011-08-09,Fall,2011,Aug,3,0,Tuesday,1,Clear,0.72,0.6818,0.62,0.0,0,3,3,510,3,3
5191,2011-08-09,Fall,2011,Aug,4,0,Tuesday,1,Clear,0.7,0.6667,0.74,0.0,1,6,7,510,7,7
5192,2011-08-09,Fall,2011,Aug,5,0,Tuesday,1,Clear,0.7,0.6515,0.65,0.0896,5,25,30,510,30,30
5193,2011-08-09,Fall,2011,Aug,6,0,Tuesday,1,Clear,0.72,0.6667,0.64,0.0,6,95,101,510,101,101
5194,2011-08-09,Fall,2011,Aug,7,0,Tuesday,1,Clear,0.72,0.697,0.74,0.1045,30,313,343,510,343,343
5195,2011-08-09,Fall,2011,Aug,8,0,Tuesday,1,Clear,0.74,0.697,0.66,0.0,40,352,392,510,392,392
5196,2011-08-09,Fall,2011,Aug,9,0,Tuesday,1,Misty,0.78,0.7424,0.62,0.1343,34,141,175,510,175,175
5197,2011-08-09,Fall,2011,Aug,10,0,Tuesday,1,Misty,0.8,0.7727,0.59,0.2239,55,89,144,510,144,144
5198,2011-08-09,Fall,2011,Aug,11,0,Tuesday,1,Clear,0.8,0.7727,0.59,0.2239,61,88,149,510,149,149
5199,2011-08-09,Fall,2011,Aug,12,0,Tuesday,1,Clear,0.82,0.7879,0.56,0.194,60,125,185,510,185,185
5200,2011-08-09,Fall,2011,Aug,13,0,Tuesday,1,Clear,0.84,0.7879,0.49,0.1642,48,127,175,510,175,175
5201,2011-08-09,Fall,2011,Aug,14,0,Tuesday,1,Clear,0.86,0.7879,0.44,0.2836,53,95,148,510,148,148
5202,2011-08-09,Fall,2011,Aug,15,0,Tuesday,1,Clear,0.86,0.7727,0.39,0.2836,58,106,164,510,164,164
5203,2011-08-09,Fall,2011,Aug,16,0,Tuesday,1,Clear,0.86,0.7727,0.39,0.2985,57,228,285,510,285,285
5204,2011-08-09,Fall,2011,Aug,17,0,Tuesday,1,Clear,0.8,0.7576,0.55,0.1642,79,453,532,510,532,532
5205,2011-08-09,Fall,2011,Aug,18,0,Tuesday,1,Clear,0.8,0.7576,0.55,0.194,97,488,585,510,585,585
5206,2011-08-09,Fall,2011,Aug,19,0,Tuesday,1,Clear,0.8,0.7424,0.49,0.1045,69,302,371,510,371,371
5207,2011-08-09,Fall,2011,Aug,20,0,Tuesday,1,Clear,0.8,0.7273,0.43,0.194,34,258,292,510,292,292
5208,2011-08-09,Fall,2011,Aug,21,0,Tuesday,1,Clear,0.78,0.697,0.46,0.2537,46,184,230,510,230,230
5209,2011-08-09,Fall,2011,Aug,22,0,Tuesday,1,Clear,0.78,0.697,0.46,0.2985,28,127,155,510,155,155
5210,2011-08-09,Fall,2011,Aug,23,0,Tuesday,1,Clear,0.76,0.6818,0.48,0.2836,22,53,75,510,75,75
5211,2011-08-10,Fall,2011,Aug,0,0,Wednesday,1,Clear,0.74,0.6667,0.51,0.2239,19,18,37,509,37,37
5212,2011-08-10,Fall,2011,Aug,1,0,Wednesday,1,Clear,0.72,0.6667,0.54,0.194,7,10,17,509,17,17
5213,2011-08-10,Fall,2011,Aug,2,0,Wednesday,1,Clear,0.72,0.6667,0.54,0.1642,1,10,11,509,11,11
5214,2011-08-10,Fall,2011,Aug,3,0,Wednesday,1,Clear,0.7,0.6515,0.58,0.1642,1,3,4,509,4,4
5215,2011-08-10,Fall,2011,Aug,4,0,Wednesday,1,Clear,0.7,0.6515,0.54,0.1343,1,4,5,509,5,5
5216,2011-08-10,Fall,2011,Aug,5,0,Wednesday,1,Clear,0.68,0.6364,0.61,0.0896,2,30,32,509,32,32
5217,2011-08-10,Fall,2011,Aug,6,0,Wednesday,1,Clear,0.68,0.6364,0.61,0.0,9,110,119,509,119,119
5218,2011-08-10,Fall,2011,Aug,7,0,Wednesday,1,Clear,0.7,0.6515,0.58,0.0896,16,289,305,509,305,305
5219,2011-08-10,Fall,2011,Aug,8,0,Wednesday,1,Clear,0.74,0.6667,0.51,0.194,38,361,399,509,399,399
5220,2011-08-10,Fall,2011,Aug,9,0,Wednesday,1,Clear,0.76,0.6818,0.48,0.2239,32,148,180,509,180,180
5221,2011-08-10,Fall,2011,Aug,10,0,Wednesday,1,Clear,0.8,0.7273,0.43,0.2239,41,72,113,509,113,113
5222,2011-08-10,Fall,2011,Aug,11,0,Wednesday,1,Clear,0.8,0.7121,0.41,0.3881,54,95,149,509,149,149
5223,2011-08-10,Fall,2011,Aug,12,0,Wednesday,1,Clear,0.82,0.7273,0.38,0.2985,74,166,240,509,240,240
5224,2011-08-10,Fall,2011,Aug,13,0,Wednesday,1,Clear,0.82,0.7273,0.38,0.2836,41,150,191,509,191,191
5225,2011-08-10,Fall,2011,Aug,14,0,Wednesday,1,Clear,0.84,0.7273,0.34,0.3284,62,116,178,509,178,178
5226,2011-08-10,Fall,2011,Aug,15,0,Wednesday,1,Clear,0.86,0.7424,0.3,0.3284,53,141,194,509,194,194
5227,2011-08-10,Fall,2011,Aug,16,0,Wednesday,1,Clear,0.86,0.7424,0.26,0.2985,76,206,282,509,282,282
5228,2011-08-10,Fall,2011,Aug,17,0,Wednesday,1,Clear,0.84,0.7121,0.26,0.2985,71,513,584,509,584,584
5229,2011-08-10,Fall,2011,Aug,18,0,Wednesday,1,Clear,0.82,0.7121,0.28,0.2985,70,489,559,509,559,559
5230,2011-08-10,Fall,2011,Aug,19,0,Wednesday,1,Clear,0.8,0.697,0.26,0.2537,79,334,413,509,413,413
5231,2011-08-10,Fall,2011,Aug,20,0,Wednesday,1,Clear,0.76,0.6667,0.31,0.1343,59,253,312,509,312,312
5232,2011-08-10,Fall,2011,Aug,21,0,Wednesday,1,Clear,0.76,0.6667,0.33,0.1045,47,162,209,509,209,209
5233,2011-08-10,Fall,2011,Aug,22,0,Wednesday,1,Clear,0.74,0.6515,0.37,0.0,17,122,139,509,139,139
5234,2011-08-10,Fall,2011,Aug,23,0,Wednesday,1,Clear,0.74,0.6515,0.37,0.0896,14,94,108,509,108,108
5235,2011-08-11,Fall,2011,Aug,0,0,Thursday,1,Clear,0.7,0.6364,0.45,0.1045,6,40,46,508,46,46
5236,2011-08-11,Fall,2011,Aug,1,0,Thursday,1,Clear,0.7,0.6364,0.45,0.1343,9,17,26,508,26,26
5237,2011-08-11,Fall,2011,Aug,2,0,Thursday,1,Clear,0.66,0.6212,0.54,0.1343,3,8,11,508,11,11
5238,2011-08-11,Fall,2011,Aug,3,0,Thursday,1,Clear,0.64,0.6212,0.57,0.1343,2,7,9,508,9,9
5239,2011-08-11,Fall,2011,Aug,4,0,Thursday,1,Clear,0.64,0.6212,0.57,0.1642,1,4,5,508,5,5
5240,2011-08-11,Fall,2011,Aug,5,0,Thursday,1,Clear,0.64,0.6212,0.61,0.194,2,23,25,508,25,25
5241,2011-08-11,Fall,2011,Aug,6,0,Thursday,1,Clear,0.62,0.6061,0.65,0.1642,5,101,106,508,106,106
5242,2011-08-11,Fall,2011,Aug,7,0,Thursday,1,Clear,0.66,0.6212,0.54,0.1343,15,292,307,508,307,307
5243,2011-08-11,Fall,2011,Aug,8,0,Thursday,1,Clear,0.7,0.6364,0.45,0.1642,29,361,390,508,390,390
5244,2011-08-11,Fall,2011,Aug,9,0,Thursday,1,Clear,0.72,0.6515,0.39,0.2239,31,166,197,508,197,197
5245,2011-08-11,Fall,2011,Aug,10,0,Thursday,1,Clear,0.74,0.6515,0.37,0.2537,36,96,132,508,132,132
5246,2011-08-11,Fall,2011,Aug,11,0,Thursday,1,Clear,0.76,0.6667,0.35,0.2537,59,128,187,508,187,187
5247,2011-08-11,Fall,2011,Aug,12,0,Thursday,1,Clear,0.78,0.6818,0.31,0.2537,50,164,214,508,214,214
5248,2011-08-11,Fall,2011,Aug,13,0,Thursday,1,Clear,0.76,0.6667,0.31,0.2239,51,166,217,508,217,217
5249,2011-08-11,Fall,2011,Aug,14,0,Thursday,1,Clear,0.8,0.697,0.29,0.0,39,103,142,508,142,142
5250,2011-08-11,Fall,2011,Aug,15,0,Thursday,1,Clear,0.8,0.697,0.29,0.2985,52,126,178,508,178,178
5251,2011-08-11,Fall,2011,Aug,16,0,Thursday,1,Clear,0.8,0.697,0.27,0.194,57,241,298,508,298,298
5252,2011-08-11,Fall,2011,Aug,17,0,Thursday,1,Clear,0.8,0.697,0.29,0.2537,96,486,582,508,582,582
5253,2011-08-11,Fall,2011,Aug,18,0,Thursday,1,Clear,0.78,0.6818,0.29,0.0896,74,497,571,508,571,571
5254,2011-08-11,Fall,2011,Aug,19,0,Thursday,1,Clear,0.74,0.6515,0.35,0.194,48,323,371,508,371,371
5255,2011-08-11,Fall,2011,Aug,20,0,Thursday,1,Clear,0.72,0.6515,0.37,0.1343,56,232,288,508,288,288
5256,2011-08-11,Fall,2011,Aug,21,0,Thursday,1,Clear,0.7,0.6515,0.48,0.0896,35,171,206,508,206,206
5257,2011-08-11,Fall,2011,Aug,22,0,Thursday,1,Clear,0.7,0.6515,0.48,0.0,34,123,157,508,157,157
5258,2011-08-11,Fall,2011,Aug,23,0,Thursday,1,Clear,0.66,0.6212,0.5,0.1642,22,105,127,508,127,127
5259,2011-08-12,Fall,2011,Aug,0,0,Friday,1,Clear,0.64,0.6212,0.53,0.1642,12,53,65,507,65,65
5260,2011-08-12,Fall,2011,Aug,1,0,Friday,1,Clear,0.64,0.6212,0.53,0.1343,4,19,23,507,23,23
5261,2011-08-12,Fall,2011,Aug,2,0,Friday,1,Clear,0.62,0.6212,0.57,0.194,0,15,15,507,15,15
5262,2011-08-12,Fall,2011,Aug,3,0,Friday,1,Clear,0.62,0.6212,0.53,0.1642,0,9,9,507,9,9
5263,2011-08-12,Fall,2011,Aug,4,0,Friday,1,Clear,0.62,0.6212,0.53,0.1343,0,5,5,507,5,5
5264,2011-08-12,Fall,2011,Aug,5,0,Friday,1,Clear,0.6,0.6212,0.56,0.1343,2,24,26,507,26,26
5265,2011-08-12,Fall,2011,Aug,6,0,Friday,1,Clear,0.62,0.6212,0.5,0.1343,3,73,76,507,76,76
5266,2011-08-12,Fall,2011,Aug,7,0,Friday,1,Clear,0.64,0.6212,0.44,0.1642,17,247,264,507,264,264
5267,2011-08-12,Fall,2011,Aug,8,0,Friday,1,Clear,0.68,0.6364,0.39,0.2239,29,397,426,507,426,426
5268,2011-08-12,Fall,2011,Aug,9,0,Friday,1,Clear,0.72,0.6515,0.34,0.1343,27,178,205,507,205,205
5269,2011-08-12,Fall,2011,Aug,10,0,Friday,1,Clear,0.74,0.6515,0.33,0.1045,44,86,130,507,130,130
5270,2011-08-12,Fall,2011,Aug,11,0,Friday,1,Clear,0.76,0.6667,0.29,0.0,48,108,156,507,156,156
5271,2011-08-12,Fall,2011,Aug,12,0,Friday,1,Clear,0.8,0.697,0.27,0.0,55,167,222,507,222,222
5272,2011-08-12,Fall,2011,Aug,13,0,Friday,1,Clear,0.78,0.6818,0.29,0.0896,74,179,253,507,253,253
5273,2011-08-12,Fall,2011,Aug,14,0,Friday,1,Clear,0.8,0.697,0.29,0.194,51,135,186,507,186,186
5274,2011-08-12,Fall,2011,Aug,15,0,Friday,1,Clear,0.8,0.697,0.29,0.1642,59,190,249,507,249,249
5275,2011-08-12,Fall,2011,Aug,16,0,Friday,1,Clear,0.82,0.7121,0.28,0.0,68,266,334,507,334,334
5276,2011-08-12,Fall,2011,Aug,17,0,Friday,1,Clear,0.82,0.7121,0.26,0.0,93,423,516,507,516,516
5277,2011-08-12,Fall,2011,Aug,18,0,Friday,1,Clear,0.76,0.6818,0.4,0.2985,89,376,465,507,465,465
5278,2011-08-12,Fall,2011,Aug,19,0,Friday,1,Clear,0.74,0.6667,0.42,0.2239,101,284,385,507,385,385
5279,2011-08-12,Fall,2011,Aug,20,0,Friday,1,Clear,0.72,0.6515,0.42,0.2239,77,210,287,507,287,287
5280,2011-08-12,Fall,2011,Aug,21,0,Friday,1,Clear,0.7,0.6515,0.48,0.1343,73,153,226,507,226,226
5281,2011-08-12,Fall,2011,Aug,22,0,Friday,1,Clear,0.68,0.6364,0.51,0.0,74,157,231,507,231,231
5282,2011-08-12,Fall,2011,Aug,23,0,Friday,1,Clear,0.68,0.6364,0.51,0.0,51,100,151,507,151,151
5283,2011-08-13,Fall,2011,Aug,0,0,Saturday,0,Clear,0.68,0.6364,0.51,0.1045,15,69,84,506,84,84
5284,2011-08-13,Fall,2011,Aug,1,0,Saturday,0,Misty,0.68,0.6364,0.57,0.0896,13,64,77,506,77,77
5285,2011-08-13,Fall,2011,Aug,2,0,Saturday,0,Clear,0.68,0.6364,0.57,0.0,16,58,74,506,74,74
5286,2011-08-13,Fall,2011,Aug,3,0,Saturday,0,Clear,0.66,0.6212,0.65,0.1343,9,18,27,506,27,27
5287,2011-08-13,Fall,2011,Aug,4,0,Saturday,0,Misty,0.64,0.6061,0.73,0.1343,5,5,10,506,10,10
5288,2011-08-13,Fall,2011,Aug,5,0,Saturday,0,Clear,0.64,0.6061,0.73,0.1045,3,15,18,506,18,18
5289,2011-08-13,Fall,2011,Aug,6,0,Saturday,0,Clear,0.64,0.6061,0.73,0.0896,3,19,22,506,22,22
5290,2011-08-13,Fall,2011,Aug,7,0,Saturday,0,Misty,0.66,0.6212,0.74,0.194,10,34,44,506,44,44
5291,2011-08-13,Fall,2011,Aug,8,0,Saturday,0,Misty,0.7,0.6515,0.65,0.1642,28,90,118,506,118,118
5292,2011-08-13,Fall,2011,Aug,9,0,Saturday,0,Misty,0.7,0.6667,0.74,0.1642,70,138,208,506,208,208
5293,2011-08-13,Fall,2011,Aug,10,0,Saturday,0,Misty,0.72,0.697,0.74,0.2239,97,163,260,506,260,260
5294,2011-08-13,Fall,2011,Aug,11,0,Saturday,0,Misty,0.74,0.697,0.7,0.194,122,192,314,506,314,314
5295,2011-08-13,Fall,2011,Aug,12,0,Saturday,0,Misty,0.66,0.5909,0.89,0.1642,175,246,421,506,421,421
5296,2011-08-13,Fall,2011,Aug,13,0,Saturday,0,Misty,0.74,0.7121,0.74,0.3284,61,92,153,506,153,153
5297,2011-08-13,Fall,2011,Aug,14,0,Saturday,0,Clear,0.74,0.697,0.7,0.2537,113,146,259,506,259,259
5298,2011-08-13,Fall,2011,Aug,15,0,Saturday,0,Light_rainsnow,0.68,0.6364,0.79,0.3582,150,208,358,506,358,358
5299,2011-08-13,Fall,2011,Aug,16,0,Saturday,0,Misty,0.7,0.6667,0.74,0.2836,148,133,281,506,281,281
5300,2011-08-13,Fall,2011,Aug,17,0,Saturday,0,Misty,0.72,0.697,0.74,0.2537,97,172,269,506,269,269
5301,2011-08-13,Fall,2011,Aug,18,0,Saturday,0,Clear,0.7,0.6667,0.74,0.2239,123,169,292,506,292,292
5302,2011-08-13,Fall,2011,Aug,19,0,Saturday,0,Misty,0.68,0.6364,0.79,0.2836,67,170,237,506,237,237
5303,2011-08-13,Fall,2011,Aug,20,0,Saturday,0,Misty,0.68,0.6364,0.83,0.2239,78,105,183,506,183,183
5304,2011-08-13,Fall,2011,Aug,21,0,Saturday,0,Misty,0.68,0.6364,0.83,0.3881,40,127,167,506,167,167
5305,2011-08-13,Fall,2011,Aug,22,0,Saturday,0,Misty,0.68,0.6364,0.83,0.3881,36,118,154,506,154,154
5306,2011-08-13,Fall,2011,Aug,23,0,Saturday,0,Misty,0.66,0.6061,0.83,0.3284,25,95,120,506,120,120
5307,2011-08-14,Fall,2011,Aug,0,0,Sunday,0,Light_rainsnow,0.66,0.6061,0.83,0.2985,19,71,90,505,90,90
5308,2011-08-14,Fall,2011,Aug,1,0,Sunday,0,Light_rainsnow,0.64,0.5758,0.89,0.2239,16,57,73,505,73,73
5309,2011-08-14,Fall,2011,Aug,2,0,Sunday,0,Light_rainsnow,0.64,0.5758,0.89,0.2239,13,49,62,505,62,62
5310,2011-08-14,Fall,2011,Aug,3,0,Sunday,0,Misty,0.64,0.5606,0.94,0.2537,5,22,27,505,27,27
5311,2011-08-14,Fall,2011,Aug,4,0,Sunday,0,Light_rainsnow,0.64,0.5606,0.94,0.194,1,2,3,505,3,3
5312,2011-08-14,Fall,2011,Aug,5,0,Sunday,0,Misty,0.64,0.5606,0.94,0.1642,1,9,10,505,10,10
5313,2011-08-14,Fall,2011,Aug,6,0,Sunday,0,Misty,0.64,0.5606,0.94,0.1045,2,4,6,505,6,6
5314,2011-08-14,Fall,2011,Aug,7,0,Sunday,0,Misty,0.66,0.5909,0.89,0.194,4,20,24,505,24,24
5315,2011-08-14,Fall,2011,Aug,8,0,Sunday,0,Misty,0.66,0.5909,0.89,0.2836,20,21,41,505,41,41
5316,2011-08-14,Fall,2011,Aug,9,0,Sunday,0,Light_rainsnow,0.66,0.5909,0.89,0.2836,27,76,103,505,103,103
5317,2011-08-14,Fall,2011,Aug,10,0,Sunday,0,Clear,0.7,0.6667,0.79,0.2239,67,116,183,505,183,183
5318,2011-08-14,Fall,2011,Aug,11,0,Sunday,0,Clear,0.7,0.6667,0.79,0.194,81,117,198,505,198,198
5319,2011-08-14,Fall,2011,Aug,12,0,Sunday,0,Misty,0.7,0.6667,0.79,0.2239,98,183,281,505,281,281
5320,2011-08-14,Fall,2011,Aug,13,0,Sunday,0,Clear,0.72,0.697,0.74,0.2537,144,233,377,505,377,377
5321,2011-08-14,Fall,2011,Aug,14,0,Sunday,0,Clear,0.74,0.697,0.7,0.194,126,244,370,505,370,370
5322,2011-08-14,Fall,2011,Aug,15,0,Sunday,0,Clear,0.74,0.697,0.66,0.194,128,203,331,505,331,331
5323,2011-08-14,Fall,2011,Aug,16,0,Sunday,0,Clear,0.74,0.697,0.66,0.1642,116,176,292,505,292,292
5324,2011-08-14,Fall,2011,Aug,17,0,Sunday,0,Clear,0.76,0.7121,0.62,0.1343,133,196,329,505,329,329
5325,2011-08-14,Fall,2011,Aug,18,0,Sunday,0,Clear,0.74,0.697,0.66,0.1642,125,222,347,505,347,347
5326,2011-08-14,Fall,2011,Aug,19,0,Sunday,0,Clear,0.72,0.697,0.74,0.2239,75,184,259,505,259,259
5327,2011-08-14,Fall,2011,Aug,20,0,Sunday,0,Clear,0.7,0.6667,0.84,0.1642,67,126,193,505,193,193
5328,2011-08-14,Fall,2011,Aug,21,0,Sunday,0,Light_rainsnow,0.6,0.5455,0.88,0.4925,51,104,155,505,155,155
5329,2011-08-14,Fall,2011,Aug,22,0,Sunday,0,Light_rainsnow,0.6,0.5455,0.88,0.4925,14,25,39,505,39,39
5330,2011-08-14,Fall,2011,Aug,23,0,Sunday,0,Light_rainsnow,0.6,0.5606,0.83,0.0,5,22,27,505,27,27
5331,2011-08-15,Fall,2011,Aug,0,0,Monday,1,Light_rainsnow,0.6,0.5455,0.88,0.0896,7,18,25,504,25,25
5332,2011-08-15,Fall,2011,Aug,1,0,Monday,1,Misty,0.6,0.5455,0.88,0.1343,1,9,10,504,10,10
5333,2011-08-15,Fall,2011,Aug,2,0,Monday,1,Misty,0.6,0.5606,0.83,0.0,0,3,3,504,3,3
5334,2011-08-15,Fall,2011,Aug,3,0,Monday,1,Clear,0.6,0.5606,0.83,0.194,1,6,7,504,7,7
5335,2011-08-15,Fall,2011,Aug,4,0,Monday,1,Clear,0.6,0.5606,0.83,0.1343,1,4,5,504,5,5
5336,2011-08-15,Fall,2011,Aug,5,0,Monday,1,Misty,0.6,0.5455,0.88,0.194,3,14,17,504,17,17
5337,2011-08-15,Fall,2011,Aug,6,0,Monday,1,Clear,0.6,0.5455,0.88,0.2537,3,87,90,504,90,90
5338,2011-08-15,Fall,2011,Aug,7,0,Monday,1,Clear,0.6,0.5455,0.88,0.2537,10,248,258,504,258,258
5339,2011-08-15,Fall,2011,Aug,8,0,Monday,1,Clear,0.64,0.5909,0.78,0.3284,29,326,355,504,355,355
5340,2011-08-15,Fall,2011,Aug,9,0,Monday,1,Clear,0.64,0.5909,0.78,0.3284,52,170,222,504,222,222
5341,2011-08-15,Fall,2011,Aug,10,0,Monday,1,Clear,0.68,0.6364,0.69,0.2836,54,87,141,504,141,141
5342,2011-08-15,Fall,2011,Aug,11,0,Monday,1,Misty,0.72,0.6818,0.62,0.2537,41,112,153,504,153,153
5343,2011-08-15,Fall,2011,Aug,12,0,Monday,1,Clear,0.74,0.6818,0.58,0.2836,62,116,178,504,178,178
5344,2011-08-15,Fall,2011,Aug,13,0,Monday,1,Clear,0.78,0.7121,0.52,0.2836,53,140,193,504,193,193
5345,2011-08-15,Fall,2011,Aug,14,0,Monday,1,Clear,0.74,0.6818,0.55,0.0896,56,95,151,504,151,151
5346,2011-08-15,Fall,2011,Aug,15,0,Monday,1,Light_rainsnow,0.74,0.6818,0.55,0.2985,49,133,182,504,182,182
5347,2011-08-15,Fall,2011,Aug,16,0,Monday,1,Clear,0.74,0.6818,0.55,0.3284,58,225,283,504,283,283
5348,2011-08-15,Fall,2011,Aug,17,0,Monday,1,Clear,0.74,0.6667,0.51,0.2836,59,471,530,504,530,530
5349,2011-08-15,Fall,2011,Aug,18,0,Monday,1,Clear,0.7,0.6515,0.65,0.194,70,413,483,504,483,483
5350,2011-08-15,Fall,2011,Aug,19,0,Monday,1,Clear,0.7,0.6515,0.65,0.0,54,343,397,504,397,397
5351,2011-08-15,Fall,2011,Aug,20,0,Monday,1,Clear,0.66,0.6212,0.74,0.1343,45,240,285,504,285,285
5352,2011-08-15,Fall,2011,Aug,21,0,Monday,1,Clear,0.66,0.6212,0.65,0.194,34,150,184,504,184,184
5353,2011-08-15,Fall,2011,Aug,22,0,Monday,1,Clear,0.66,0.6212,0.69,0.2537,22,76,98,504,98,98
5354,2011-08-15,Fall,2011,Aug,23,0,Monday,1,Clear,0.64,0.6061,0.69,0.2239,11,77,88,504,88,88
5355,2011-08-16,Fall,2011,Aug,0,0,Tuesday,1,Clear,0.64,0.6061,0.69,0.1045,8,23,31,503,31,31
5356,2011-08-16,Fall,2011,Aug,1,0,Tuesday,1,Clear,0.64,0.6061,0.69,0.1642,4,12,16,503,16,16
5357,2011-08-16,Fall,2011,Aug,2,0,Tuesday,1,Clear,0.62,0.5909,0.73,0.2239,1,3,4,503,4,4
5358,2011-08-16,Fall,2011,Aug,3,0,Tuesday,1,Clear,0.62,0.5909,0.73,0.2239,1,5,6,503,6,6
5359,2011-08-16,Fall,2011,Aug,4,0,Tuesday,1,Clear,0.64,0.6061,0.69,0.2985,0,5,5,503,5,5
5360,2011-08-16,Fall,2011,Aug,5,0,Tuesday,1,Clear,0.62,0.5909,0.73,0.2836,1,29,30,503,30,30
5361,2011-08-16,Fall,2011,Aug,6,0,Tuesday,1,Clear,0.62,0.5909,0.73,0.3284,4,115,119,503,119,119
5362,2011-08-16,Fall,2011,Aug,7,0,Tuesday,1,Clear,0.64,0.6061,0.69,0.2537,18,328,346,503,346,346
5363,2011-08-16,Fall,2011,Aug,8,0,Tuesday,1,Clear,0.7,0.6515,0.58,0.4478,24,417,441,503,441,441
5364,2011-08-16,Fall,2011,Aug,9,0,Tuesday,1,Clear,0.68,0.6364,0.61,0.2836,27,171,198,503,198,198
5365,2011-08-16,Fall,2011,Aug,10,0,Tuesday,1,Clear,0.7,0.6515,0.58,0.3881,28,83,111,503,111,111
5366,2011-08-16,Fall,2011,Aug,11,0,Tuesday,1,Clear,0.74,0.6667,0.51,0.2239,40,110,150,503,150,150
5367,2011-08-16,Fall,2011,Aug,12,0,Tuesday,1,Clear,0.76,0.6818,0.48,0.3284,42,120,162,503,162,162
5368,2011-08-16,Fall,2011,Aug,13,0,Tuesday,1,Clear,0.76,0.6818,0.48,0.2985,45,147,192,503,192,192
5369,2011-08-16,Fall,2011,Aug,14,0,Tuesday,1,Clear,0.76,0.6818,0.45,0.4179,65,117,182,503,182,182
5370,2011-08-16,Fall,2011,Aug,15,0,Tuesday,1,Clear,0.8,0.7121,0.41,0.2985,36,123,159,503,159,159
5371,2011-08-16,Fall,2011,Aug,16,0,Tuesday,1,Clear,0.8,0.7121,0.41,0.2239,55,248,303,503,303,303
5372,2011-08-16,Fall,2011,Aug,17,0,Tuesday,1,Clear,0.76,0.6818,0.45,0.3284,75,525,600,503,600,600
5373,2011-08-16,Fall,2011,Aug,18,0,Tuesday,1,Clear,0.76,0.6818,0.45,0.2239,54,516,570,503,570,570
5374,2011-08-16,Fall,2011,Aug,19,0,Tuesday,1,Clear,0.74,0.6667,0.48,0.194,56,320,376,503,376,376
5375,2011-08-16,Fall,2011,Aug,20,0,Tuesday,1,Clear,0.74,0.6667,0.51,0.0,48,232,280,503,280,280
5376,2011-08-16,Fall,2011,Aug,21,0,Tuesday,1,Clear,0.72,0.6667,0.54,0.0,38,177,215,503,215,215
5377,2011-08-16,Fall,2011,Aug,22,0,Tuesday,1,Clear,0.7,0.6515,0.61,0.0,31,121,152,503,152,152
5378,2011-08-16,Fall,2011,Aug,23,0,Tuesday,1,Clear,0.66,0.6212,0.65,0.1343,20,57,77,503,77,77
5379,2011-08-17,Fall,2011,Aug,0,0,Wednesday,1,Clear,0.66,0.6212,0.69,0.0896,8,16,24,502,24,24
5380,2011-08-17,Fall,2011,Aug,1,0,Wednesday,1,Clear,0.64,0.6061,0.73,0.1642,2,12,14,502,14,14
5381,2011-08-17,Fall,2011,Aug,2,0,Wednesday,1,Clear,0.66,0.6212,0.69,0.0,0,6,6,502,6,6
5382,2011-08-17,Fall,2011,Aug,3,0,Wednesday,1,Clear,0.64,0.5909,0.78,0.0,1,4,5,502,5,5
5383,2011-08-17,Fall,2011,Aug,4,0,Wednesday,1,Clear,0.64,0.6061,0.73,0.0,0,5,5,502,5,5
5384,2011-08-17,Fall,2011,Aug,5,0,Wednesday,1,Clear,0.64,0.6061,0.73,0.0,0,28,28,502,28,28
5385,2011-08-17,Fall,2011,Aug,6,0,Wednesday,1,Clear,0.62,0.5909,0.78,0.0,4,101,105,502,105,105
5386,2011-08-17,Fall,2011,Aug,7,0,Wednesday,1,Clear,0.66,0.6212,0.65,0.0896,12,296,308,502,308,308
5387,2011-08-17,Fall,2011,Aug,8,0,Wednesday,1,Clear,0.7,0.6515,0.54,0.1642,35,452,487,502,487,487
5388,2011-08-17,Fall,2011,Aug,9,0,Wednesday,1,Clear,0.74,0.6667,0.48,0.0896,31,178,209,502,209,209
5389,2011-08-17,Fall,2011,Aug,10,0,Wednesday,1,Clear,0.76,0.6818,0.43,0.0896,27,91,118,502,118,118
5390,2011-08-17,Fall,2011,Aug,11,0,Wednesday,1,Clear,0.78,0.697,0.43,0.1045,20,108,128,502,128,128
5391,2011-08-17,Fall,2011,Aug,12,0,Wednesday,1,Clear,0.8,0.7273,0.43,0.2836,26,163,189,502,189,189
5392,2011-08-17,Fall,2011,Aug,13,0,Wednesday,1,Clear,0.8,0.7121,0.41,0.194,38,138,176,502,176,176
5393,2011-08-17,Fall,2011,Aug,14,0,Wednesday,1,Clear,0.82,0.7273,0.36,0.1642,54,138,192,502,192,192
5394,2011-08-17,Fall,2011,Aug,15,0,Wednesday,1,Clear,0.8,0.7273,0.43,0.1343,42,117,159,502,159,159
5395,2011-08-17,Fall,2011,Aug,16,0,Wednesday,1,Clear,0.82,0.7424,0.43,0.2239,62,238,300,502,300,300
5396,2011-08-17,Fall,2011,Aug,17,0,Wednesday,1,Clear,0.8,0.7424,0.49,0.2239,46,506,552,502,552,552
5397,2011-08-17,Fall,2011,Aug,18,0,Wednesday,1,Clear,0.76,0.697,0.55,0.2537,86,470,556,502,556,556
5398,2011-08-17,Fall,2011,Aug,19,0,Wednesday,1,Clear,0.76,0.697,0.55,0.2239,50,297,347,502,347,347
5399,2011-08-17,Fall,2011,Aug,20,0,Wednesday,1,Clear,0.74,0.6818,0.58,0.2537,37,243,280,502,280,280
5400,2011-08-17,Fall,2011,Aug,21,0,Wednesday,1,Clear,0.72,0.6818,0.62,0.2239,38,192,230,502,230,230
5401,2011-08-17,Fall,2011,Aug,22,0,Wednesday,1,Clear,0.7,0.6515,0.65,0.194,29,142,171,502,171,171
5402,2011-08-17,Fall,2011,Aug,23,0,Wednesday,1,Clear,0.7,0.6515,0.65,0.2836,20,85,105,502,105,105
5403,2011-08-18,Fall,2011,Aug,0,0,Thursday,1,Clear,0.68,0.6364,0.65,0.1343,18,38,56,501,56,56
5404,2011-08-18,Fall,2011,Aug,1,0,Thursday,1,Misty,0.66,0.6212,0.65,0.1642,13,11,24,501,24,24
5405,2011-08-18,Fall,2011,Aug,2,0,Thursday,1,Clear,0.66,0.6212,0.65,0.2239,2,4,6,501,6,6
5406,2011-08-18,Fall,2011,Aug,3,0,Thursday,1,Clear,0.66,0.6212,0.69,0.2836,0,6,6,501,6,6
5407,2011-08-18,Fall,2011,Aug,4,0,Thursday,1,Clear,0.64,0.6061,0.73,0.2239,0,9,9,501,9,9
5408,2011-08-18,Fall,2011,Aug,5,0,Thursday,1,Clear,0.64,0.5909,0.78,0.2836,0,27,27,501,27,27
5409,2011-08-18,Fall,2011,Aug,6,0,Thursday,1,Misty,0.64,0.5909,0.78,0.2537,6,97,103,501,103,103
5410,2011-08-18,Fall,2011,Aug,7,0,Thursday,1,Clear,0.64,0.5909,0.78,0.2985,19,289,308,501,308,308
5411,2011-08-18,Fall,2011,Aug,8,0,Thursday,1,Clear,0.66,0.6212,0.74,0.2836,27,393,420,501,420,420
5412,2011-08-18,Fall,2011,Aug,9,0,Thursday,1,Clear,0.72,0.6818,0.66,0.2537,42,186,228,501,228,228
5413,2011-08-18,Fall,2011,Aug,10,0,Thursday,1,Clear,0.74,0.697,0.66,0.2537,37,92,129,501,129,129
5414,2011-08-18,Fall,2011,Aug,11,0,Thursday,1,Clear,0.76,0.7121,0.58,0.2537,44,97,141,501,141,141
5415,2011-08-18,Fall,2011,Aug,12,0,Thursday,1,Clear,0.8,0.7424,0.52,0.2836,34,139,173,501,173,173
5416,2011-08-18,Fall,2011,Aug,13,0,Thursday,1,Clear,0.8,0.7424,0.52,0.3582,33,154,187,501,187,187
5417,2011-08-18,Fall,2011,Aug,14,0,Thursday,1,Clear,0.82,0.7576,0.46,0.3284,67,115,182,501,182,182
5418,2011-08-18,Fall,2011,Aug,15,0,Thursday,1,Clear,0.8,0.7273,0.46,0.3582,56,118,174,501,174,174
5419,2011-08-18,Fall,2011,Aug,16,0,Thursday,1,Clear,0.8,0.7273,0.46,0.3582,49,196,245,501,245,245
5420,2011-08-18,Fall,2011,Aug,17,0,Thursday,1,Light_rainsnow,0.8,0.7273,0.46,0.2985,44,365,409,501,409,409
5421,2011-08-18,Fall,2011,Aug,18,0,Thursday,1,Light_rainsnow,0.76,0.697,0.55,0.2537,48,226,274,501,274,274
5422,2011-08-18,Fall,2011,Aug,19,0,Thursday,1,Clear,0.66,0.6061,0.83,0.1045,26,115,141,501,141,141
5423,2011-08-18,Fall,2011,Aug,20,0,Thursday,1,Clear,0.66,0.6061,0.83,0.1045,24,141,165,501,165,165
5424,2011-08-18,Fall,2011,Aug,21,0,Thursday,1,Misty,0.68,0.6364,0.79,0.0,12,137,149,501,149,149
5425,2011-08-18,Fall,2011,Aug,22,0,Thursday,1,Misty,0.7,0.6667,0.74,0.1045,18,117,135,501,135,135
5426,2011-08-18,Fall,2011,Aug,23,0,Thursday,1,Misty,0.7,0.6667,0.74,0.1343,20,94,114,501,114,114
5427,2011-08-19,Fall,2011,Aug,0,0,Friday,1,Light_rainsnow,0.68,0.6364,0.69,0.194,9,53,62,500,62,62
5428,2011-08-19,Fall,2011,Aug,1,0,Friday,1,Light_rainsnow,0.64,0.5758,0.89,0.0,1,19,20,500,20,20
5429,2011-08-19,Fall,2011,Aug,2,0,Friday,1,Light_rainsnow,0.64,0.5758,0.83,0.0,0,8,8,500,8,8
5430,2011-08-19,Fall,2011,Aug,3,0,Friday,1,Clear,0.64,0.5909,0.78,0.0,2,1,3,500,3,3
5431,2011-08-19,Fall,2011,Aug,4,0,Friday,1,Clear,0.64,0.5758,0.83,0.0,1,7,8,500,8,8
5432,2011-08-19,Fall,2011,Aug,5,0,Friday,1,Clear,0.64,0.5758,0.83,0.0,1,16,17,500,17,17
5433,2011-08-19,Fall,2011,Aug,6,0,Friday,1,Clear,0.64,0.5758,0.83,0.0,2,91,93,500,93,93
5434,2011-08-19,Fall,2011,Aug,7,0,Friday,1,Misty,0.66,0.6061,0.83,0.0896,12,251,263,500,263,263
5435,2011-08-19,Fall,2011,Aug,8,0,Friday,1,Misty,0.66,0.6061,0.83,0.0,30,368,398,500,398,398
5436,2011-08-19,Fall,2011,Aug,9,0,Friday,1,Clear,0.7,0.6515,0.65,0.1343,31,187,218,500,218,218
5437,2011-08-19,Fall,2011,Aug,10,0,Friday,1,Clear,0.72,0.6818,0.62,0.0896,57,108,165,500,165,165
5438,2011-08-19,Fall,2011,Aug,11,0,Friday,1,Misty,0.72,0.6818,0.66,0.0896,45,120,165,500,165,165
5439,2011-08-19,Fall,2011,Aug,12,0,Friday,1,Misty,0.74,0.6818,0.62,0.0896,54,168,222,500,222,222
5440,2011-08-19,Fall,2011,Aug,13,0,Friday,1,Misty,0.76,0.7121,0.62,0.194,63,169,232,500,232,232
5441,2011-08-19,Fall,2011,Aug,14,0,Friday,1,Clear,0.78,0.7273,0.55,0.194,78,142,220,500,220,220
5442,2011-08-19,Fall,2011,Aug,15,0,Friday,1,Clear,0.8,0.7424,0.49,0.1045,66,156,222,500,222,222
5443,2011-08-19,Fall,2011,Aug,16,0,Friday,1,Clear,0.8,0.7424,0.49,0.0,66,261,327,500,327,327
5444,2011-08-19,Fall,2011,Aug,17,0,Friday,1,Clear,0.76,0.7121,0.58,0.5224,85,442,527,500,527,527
5445,2011-08-19,Fall,2011,Aug,18,0,Friday,1,Clear,0.76,0.7121,0.58,0.5224,88,337,425,500,425,425
5446,2011-08-19,Fall,2011,Aug,19,0,Friday,1,Light_rainsnow,0.62,0.5909,0.73,0.4627,33,132,165,500,165,165
5447,2011-08-19,Fall,2011,Aug,20,0,Friday,1,Light_rainsnow,0.62,0.5758,0.83,0.2985,12,46,58,500,58,58
5448,2011-08-19,Fall,2011,Aug,21,0,Friday,1,Clear,0.62,0.5758,0.83,0.1343,18,89,107,500,107,107
5449,2011-08-19,Fall,2011,Aug,22,0,Friday,1,Clear,0.6,0.5455,0.88,0.1343,25,97,122,500,122,122
5450,2011-08-19,Fall,2011,Aug,23,0,Friday,1,Misty,0.6,0.5455,0.88,0.0896,18,88,106,500,106,106
5451,2011-08-20,Fall,2011,Aug,0,0,Saturday,0,Clear,0.6,0.5455,0.88,0.0,21,107,128,499,128,128
5452,2011-08-20,Fall,2011,Aug,1,0,Saturday,0,Clear,0.62,0.5758,0.83,0.0,12,35,47,499,47,47
5453,2011-08-20,Fall,2011,Aug,2,0,Saturday,0,Clear,0.62,0.5909,0.78,0.0,10,59,69,499,69,69
5454,2011-08-20,Fall,2011,Aug,3,0,Saturday,0,Clear,0.62,0.5909,0.78,0.0,9,42,51,499,51,51
5455,2011-08-20,Fall,2011,Aug,4,0,Saturday,0,Misty,0.6,0.5455,0.88,0.0,1,6,7,499,7,7
5456,2011-08-20,Fall,2011,Aug,5,0,Saturday,0,Clear,0.6,0.5606,0.83,0.0,0,8,8,499,8,8
5457,2011-08-20,Fall,2011,Aug,6,0,Saturday,0,Misty,0.6,0.5606,0.83,0.1343,6,18,24,499,24,24
5458,2011-08-20,Fall,2011,Aug,7,0,Saturday,0,Clear,0.62,0.5758,0.83,0.0,8,36,44,499,44,44
5459,2011-08-20,Fall,2011,Aug,8,0,Saturday,0,Clear,0.66,0.6212,0.69,0.0,27,106,133,499,133,133
5460,2011-08-20,Fall,2011,Aug,9,0,Saturday,0,Clear,0.7,0.6515,0.65,0.0,51,139,190,499,190,190
5461,2011-08-20,Fall,2011,Aug,10,0,Saturday,0,Clear,0.72,0.6818,0.62,0.1045,114,192,306,499,306,306
5462,2011-08-20,Fall,2011,Aug,11,0,Saturday,0,Clear,0.72,0.6667,0.58,0.0,115,223,338,499,338,338
5463,2011-08-20,Fall,2011,Aug,12,0,Saturday,0,Clear,0.74,0.6818,0.58,0.1343,156,253,409,499,409,409
5464,2011-08-20,Fall,2011,Aug,13,0,Saturday,0,Clear,0.76,0.697,0.55,0.1343,158,220,378,499,378,378
5465,2011-08-20,Fall,2011,Aug,14,0,Saturday,0,Clear,0.8,0.7424,0.49,0.194,147,228,375,499,375,375
5466,2011-08-20,Fall,2011,Aug,15,0,Saturday,0,Clear,0.8,0.7273,0.43,0.194,175,215,390,499,390,390
5467,2011-08-20,Fall,2011,Aug,16,0,Saturday,0,Clear,0.8,0.7273,0.46,0.194,151,222,373,499,373,373
5468,2011-08-20,Fall,2011,Aug,17,0,Saturday,0,Clear,0.8,0.7424,0.49,0.194,180,203,383,499,383,383
5469,2011-08-20,Fall,2011,Aug,18,0,Saturday,0,Clear,0.76,0.7121,0.58,0.2537,169,225,394,499,394,394
5470,2011-08-20,Fall,2011,Aug,19,0,Saturday,0,Clear,0.74,0.6818,0.62,0.194,109,182,291,499,291,291
5471,2011-08-20,Fall,2011,Aug,20,0,Saturday,0,Clear,0.74,0.6818,0.62,0.2239,78,170,248,499,248,248
5472,2011-08-20,Fall,2011,Aug,21,0,Saturday,0,Clear,0.72,0.6818,0.7,0.2239,81,144,225,499,225,225
5473,2011-08-20,Fall,2011,Aug,22,0,Saturday,0,Misty,0.7,0.6667,0.74,0.194,77,146,223,499,223,223
5474,2011-08-20,Fall,2011,Aug,23,0,Saturday,0,Clear,0.7,0.6667,0.74,0.1343,59,98,157,499,157,157
5475,2011-08-21,Fall,2011,Aug,0,0,Sunday,0,Clear,0.7,0.6667,0.74,0.194,6,68,74,498,74,74
5476,2011-08-21,Fall,2011,Aug,1,0,Sunday,0,Clear,0.68,0.6364,0.79,0.2239,17,69,86,498,86,86
5477,2011-08-21,Fall,2011,Aug,2,0,Sunday,0,Clear,0.68,0.6364,0.79,0.194,13,51,64,498,64,64
5478,2011-08-21,Fall,2011,Aug,3,0,Sunday,0,Clear,0.66,0.6061,0.83,0.2239,25,26,51,498,51,51
5479,2011-08-21,Fall,2011,Aug,4,0,Sunday,0,Clear,0.68,0.6364,0.83,0.2239,1,5,6,498,6,6
5480,2011-08-21,Fall,2011,Aug,5,0,Sunday,0,Clear,0.66,0.5909,0.89,0.2985,0,8,8,498,8,8
5481,2011-08-21,Fall,2011,Aug,6,0,Sunday,0,Clear,0.66,0.5909,0.89,0.2836,4,10,14,498,14,14
5482,2011-08-21,Fall,2011,Aug,7,0,Sunday,0,Clear,0.68,0.6364,0.83,0.2985,12,19,31,498,31,31
5483,2011-08-21,Fall,2011,Aug,8,0,Sunday,0,Clear,0.7,0.6667,0.79,0.2239,30,62,92,498,92,92
5484,2011-08-21,Fall,2011,Aug,9,0,Sunday,0,Clear,0.72,0.697,0.74,0.2239,80,151,231,498,231,231
5485,2011-08-21,Fall,2011,Aug,10,0,Sunday,0,Clear,0.74,0.7121,0.74,0.2537,97,177,274,498,274,274
5486,2011-08-21,Fall,2011,Aug,11,0,Sunday,0,Clear,0.8,0.7879,0.63,0.2836,132,181,313,498,313,313
5487,2011-08-21,Fall,2011,Aug,12,0,Sunday,0,Clear,0.82,0.803,0.59,0.2836,135,239,374,498,374,374
5488,2011-08-21,Fall,2011,Aug,13,0,Sunday,0,Clear,0.8,0.7727,0.59,0.4179,94,216,310,498,310,310
5489,2011-08-21,Fall,2011,Aug,14,0,Sunday,0,Light_rainsnow,0.7,0.6667,0.79,0.3881,78,157,235,498,235,235
5490,2011-08-21,Fall,2011,Aug,15,0,Sunday,0,Clear,0.7,0.6667,0.84,0.2836,17,51,68,498,68,68
5491,2011-08-21,Fall,2011,Aug,16,0,Sunday,0,Clear,0.72,0.697,0.79,0.1642,97,161,258,498,258,258
5492,2011-08-21,Fall,2011,Aug,17,0,Sunday,0,Clear,0.72,0.697,0.79,0.1343,91,179,270,498,270,270
5493,2011-08-21,Fall,2011,Aug,18,0,Sunday,0,Clear,0.72,0.697,0.79,0.2537,96,215,311,498,311,311
5494,2011-08-21,Fall,2011,Aug,19,0,Sunday,0,Clear,0.72,0.6818,0.7,0.2537,81,201,282,498,282,282
5495,2011-08-21,Fall,2011,Aug,20,0,Sunday,0,Clear,0.7,0.6667,0.79,0.2537,41,140,181,498,181,181
5496,2011-08-21,Fall,2011,Aug,21,0,Sunday,0,Clear,0.7,0.6667,0.79,0.2537,45,93,138,498,138,138
5497,2011-08-21,Fall,2011,Aug,22,0,Sunday,0,Misty,0.7,0.6667,0.79,0.194,37,97,134,498,134,134
5498,2011-08-21,Fall,2011,Aug,23,0,Sunday,0,Clear,0.7,0.6667,0.74,0.1642,20,48,68,498,68,68
5499,2011-08-22,Fall,2011,Aug,0,0,Monday,1,Clear,0.68,0.6364,0.79,0.1642,18,22,40,497,40,40
5500,2011-08-22,Fall,2011,Aug,1,0,Monday,1,Clear,0.68,0.6364,0.79,0.0896,8,13,21,497,21,21
5501,2011-08-22,Fall,2011,Aug,2,0,Monday,1,Misty,0.7,0.6515,0.65,0.1045,2,6,8,497,8,8
5502,2011-08-22,Fall,2011,Aug,3,0,Monday,1,Light_rainsnow,0.7,0.6515,0.65,0.1343,0,5,5,497,5,5
5503,2011-08-22,Fall,2011,Aug,4,0,Monday,1,Clear,0.68,0.6364,0.65,0.194,2,10,12,497,12,12
5504,2011-08-22,Fall,2011,Aug,5,0,Monday,1,Clear,0.66,0.6212,0.65,0.3582,1,23,24,497,24,24
5505,2011-08-22,Fall,2011,Aug,6,0,Monday,1,Clear,0.66,0.6212,0.61,0.2985,6,106,112,497,112,112
5506,2011-08-22,Fall,2011,Aug,7,0,Monday,1,Clear,0.66,0.6212,0.61,0.3284,11,270,281,497,281,281
5507,2011-08-22,Fall,2011,Aug,8,0,Monday,1,Clear,0.66,0.6212,0.61,0.3284,20,331,351,497,351,351
5508,2011-08-22,Fall,2011,Aug,9,0,Monday,1,Clear,0.68,0.6364,0.54,0.2537,36,151,187,497,187,187
5509,2011-08-22,Fall,2011,Aug,10,0,Monday,1,Clear,0.7,0.6515,0.48,0.2836,36,85,121,497,121,121
5510,2011-08-22,Fall,2011,Aug,11,0,Monday,1,Clear,0.72,0.6515,0.34,0.3284,46,85,131,497,131,131
5511,2011-08-22,Fall,2011,Aug,12,0,Monday,1,Clear,0.74,0.6515,0.35,0.3881,54,153,207,497,207,207
5512,2011-08-22,Fall,2011,Aug,13,0,Monday,1,Clear,0.74,0.6515,0.3,0.4627,47,158,205,497,205,205
5513,2011-08-22,Fall,2011,Aug,14,0,Monday,1,Clear,0.74,0.6515,0.3,0.3881,88,137,225,497,225,225
5514,2011-08-22,Fall,2011,Aug,15,0,Monday,1,Clear,0.74,0.6515,0.3,0.2985,72,127,199,497,199,199
5515,2011-08-22,Fall,2011,Aug,16,0,Monday,1,Clear,0.74,0.6515,0.3,0.3881,66,254,320,497,320,320
5516,2011-08-22,Fall,2011,Aug,17,0,Monday,1,Clear,0.74,0.6515,0.27,0.3284,82,509,591,497,591,591
5517,2011-08-22,Fall,2011,Aug,18,0,Monday,1,Clear,0.72,0.6515,0.28,0.2985,72,537,609,497,609,609
5518,2011-08-22,Fall,2011,Aug,19,0,Monday,1,Clear,0.7,0.6364,0.3,0.2836,66,350,416,497,416,416
5519,2011-08-22,Fall,2011,Aug,20,0,Monday,1,Clear,0.66,0.6212,0.34,0.194,21,247,268,497,268,268
5520,2011-08-22,Fall,2011,Aug,21,0,Monday,1,Clear,0.64,0.6212,0.38,0.194,28,180,208,497,208,208
5521,2011-08-22,Fall,2011,Aug,22,0,Monday,1,Clear,0.64,0.6212,0.38,0.2985,32,121,153,497,153,153
5522,2011-08-22,Fall,2011,Aug,23,0,Monday,1,Clear,0.62,0.6212,0.41,0.2537,19,45,64,497,64,64
5523,2011-08-23,Fall,2011,Aug,0,0,Tuesday,1,Clear,0.6,0.6212,0.43,0.194,13,22,35,496,35,35
5524,2011-08-23,Fall,2011,Aug,1,0,Tuesday,1,Clear,0.58,0.5455,0.49,0.194,6,13,19,496,19,19
5525,2011-08-23,Fall,2011,Aug,2,0,Tuesday,1,Clear,0.56,0.5303,0.52,0.194,2,4,6,496,6,6
5526,2011-08-23,Fall,2011,Aug,3,0,Tuesday,1,Clear,0.56,0.5303,0.52,0.2836,2,4,6,496,6,6
5527,2011-08-23,Fall,2011,Aug,4,0,Tuesday,1,Clear,0.54,0.5152,0.56,0.1642,0,5,5,496,5,5
5528,2011-08-23,Fall,2011,Aug,5,0,Tuesday,1,Clear,0.54,0.5152,0.56,0.194,1,35,36,496,36,36
5529,2011-08-23,Fall,2011,Aug,6,0,Tuesday,1,Clear,0.54,0.5152,0.6,0.194,3,111,114,496,114,114
5530,2011-08-23,Fall,2011,Aug,7,0,Tuesday,1,Clear,0.6,0.6212,0.49,0.194,11,333,344,496,344,344
5531,2011-08-23,Fall,2011,Aug,8,0,Tuesday,1,Misty,0.62,0.6212,0.5,0.0,43,461,504,496,504,504
5532,2011-08-23,Fall,2011,Aug,9,0,Tuesday,1,Misty,0.66,0.6212,0.44,0.0,34,191,225,496,225,225
5533,2011-08-23,Fall,2011,Aug,10,0,Tuesday,1,Clear,0.7,0.6364,0.37,0.0,56,92,148,496,148,148
5534,2011-08-23,Fall,2011,Aug,11,0,Tuesday,1,Clear,0.7,0.6364,0.34,0.1045,62,124,186,496,186,186
5535,2011-08-23,Fall,2011,Aug,12,0,Tuesday,1,Clear,0.7,0.6364,0.39,0.0896,60,177,237,496,237,237
5536,2011-08-23,Fall,2011,Aug,13,0,Tuesday,1,Clear,0.72,0.6515,0.3,0.1045,70,164,234,496,234,234
5537,2011-08-23,Fall,2011,Aug,14,0,Tuesday,1,Clear,0.72,0.6515,0.3,0.0896,149,502,651,496,651,651
5538,2011-08-23,Fall,2011,Aug,15,0,Tuesday,1,Clear,0.72,0.6515,0.34,0.2239,178,423,601,496,601,601
5539,2011-08-23,Fall,2011,Aug,16,0,Tuesday,1,Clear,0.72,0.6515,0.32,0.1343,133,311,444,496,444,444
5540,2011-08-23,Fall,2011,Aug,17,0,Tuesday,1,Clear,0.72,0.6515,0.34,0.2239,133,339,472,496,472,472
5541,2011-08-23,Fall,2011,Aug,18,0,Tuesday,1,Clear,0.72,0.6515,0.34,0.194,98,421,519,496,519,519
5542,2011-08-23,Fall,2011,Aug,19,0,Tuesday,1,Clear,0.66,0.6212,0.5,0.2239,70,297,367,496,367,367
5543,2011-08-23,Fall,2011,Aug,20,0,Tuesday,1,Clear,0.64,0.6212,0.53,0.2537,54,206,260,496,260,260
5544,2011-08-23,Fall,2011,Aug,21,0,Tuesday,1,Clear,0.62,0.6212,0.57,0.0,38,173,211,496,211,211
5545,2011-08-23,Fall,2011,Aug,22,0,Tuesday,1,Clear,0.62,0.6212,0.57,0.1343,46,145,191,496,191,191
5546,2011-08-23,Fall,2011,Aug,23,0,Tuesday,1,Clear,0.62,0.6061,0.61,0.1343,19,61,80,496,80,80
5547,2011-08-24,Fall,2011,Aug,0,0,Wednesday,1,Clear,0.62,0.6212,0.57,0.1343,9,29,38,495,38,38
5548,2011-08-24,Fall,2011,Aug,1,0,Wednesday,1,Clear,0.6,0.6061,0.6,0.1045,7,17,24,495,24,24
5549,2011-08-24,Fall,2011,Aug,2,0,Wednesday,1,Clear,0.58,0.5455,0.68,0.1343,2,4,6,495,6,6
5550,2011-08-24,Fall,2011,Aug,3,0,Wednesday,1,Clear,0.58,0.5455,0.68,0.1343,0,1,1,495,1,1
5551,2011-08-24,Fall,2011,Aug,4,0,Wednesday,1,Clear,0.56,0.5303,0.73,0.1045,0,7,7,495,7,7
5552,2011-08-24,Fall,2011,Aug,5,0,Wednesday,1,Clear,0.56,0.5303,0.73,0.1045,1,26,27,495,27,27
5553,2011-08-24,Fall,2011,Aug,6,0,Wednesday,1,Clear,0.56,0.5303,0.73,0.0,3,105,108,495,108,108
5554,2011-08-24,Fall,2011,Aug,7,0,Wednesday,1,Clear,0.6,0.6061,0.64,0.0896,11,297,308,495,308,308
5555,2011-08-24,Fall,2011,Aug,8,0,Wednesday,1,Clear,0.62,0.6061,0.69,0.1343,32,436,468,495,468,468
5556,2011-08-24,Fall,2011,Aug,9,0,Wednesday,1,Clear,0.64,0.6061,0.69,0.2537,44,169,213,495,213,213
5557,2011-08-24,Fall,2011,Aug,10,0,Wednesday,1,Clear,0.7,0.6515,0.58,0.2836,51,95,146,495,146,146
5558,2011-08-24,Fall,2011,Aug,11,0,Wednesday,1,Clear,0.72,0.6667,0.54,0.2985,57,128,185,495,185,185
5559,2011-08-24,Fall,2011,Aug,12,0,Wednesday,1,Clear,0.74,0.6818,0.55,0.3284,60,175,235,495,235,235
5560,2011-08-24,Fall,2011,Aug,13,0,Wednesday,1,Clear,0.76,0.6818,0.48,0.4179,56,180,236,495,236,236
5561,2011-08-24,Fall,2011,Aug,14,0,Wednesday,1,Clear,0.76,0.6818,0.48,0.4179,77,127,204,495,204,204
5562,2011-08-24,Fall,2011,Aug,15,0,Wednesday,1,Clear,0.76,0.6818,0.48,0.4478,63,141,204,495,204,204
5563,2011-08-24,Fall,2011,Aug,16,0,Wednesday,1,Clear,0.76,0.697,0.52,0.4179,49,222,271,495,271,271
5564,2011-08-24,Fall,2011,Aug,17,0,Wednesday,1,Clear,0.76,0.697,0.52,0.3582,83,484,567,495,567,567
5565,2011-08-24,Fall,2011,Aug,18,0,Wednesday,1,Clear,0.74,0.6818,0.55,0.2985,102,519,621,495,621,621
5566,2011-08-24,Fall,2011,Aug,19,0,Wednesday,1,Clear,0.74,0.6818,0.55,0.2985,93,347,440,495,440,440
5567,2011-08-24,Fall,2011,Aug,20,0,Wednesday,1,Clear,0.72,0.6667,0.58,0.2985,45,289,334,495,334,334
5568,2011-08-24,Fall,2011,Aug,21,0,Wednesday,1,Clear,0.7,0.6515,0.61,0.3582,47,189,236,495,236,236
5569,2011-08-24,Fall,2011,Aug,22,0,Wednesday,1,Clear,0.7,0.6515,0.65,0.3582,41,140,181,495,181,181
5570,2011-08-24,Fall,2011,Aug,23,0,Wednesday,1,Clear,0.68,0.6364,0.69,0.2985,16,54,70,495,70,70
5571,2011-08-25,Fall,2011,Aug,0,0,Thursday,1,Clear,0.68,0.6364,0.74,0.2985,11,41,52,494,52,52
5572,2011-08-25,Fall,2011,Aug,1,0,Thursday,1,Clear,0.68,0.6364,0.69,0.3881,4,11,15,494,15,15
5573,2011-08-25,Fall,2011,Aug,2,0,Thursday,1,Clear,0.68,0.6364,0.69,0.3881,3,2,5,494,5,5
5574,2011-08-25,Fall,2011,Aug,3,0,Thursday,1,Clear,0.66,0.6212,0.74,0.3284,2,2,4,494,4,4
5575,2011-08-25,Fall,2011,Aug,4,0,Thursday,1,Clear,0.66,0.6061,0.78,0.3881,1,6,7,494,7,7
5576,2011-08-25,Fall,2011,Aug,5,0,Thursday,1,Clear,0.66,0.6061,0.83,0.4179,1,25,26,494,26,26
5577,2011-08-25,Fall,2011,Aug,6,0,Thursday,1,Clear,0.66,0.6061,0.83,0.3284,1,101,102,494,102,102
5578,2011-08-25,Fall,2011,Aug,7,0,Thursday,1,Misty,0.68,0.6364,0.79,0.3284,17,296,313,494,313,313
5579,2011-08-25,Fall,2011,Aug,8,0,Thursday,1,Misty,0.7,0.6667,0.74,0.2985,23,461,484,494,484,484
5580,2011-08-25,Fall,2011,Aug,9,0,Thursday,1,Misty,0.72,0.6818,0.7,0.2985,21,141,162,494,162,162
5581,2011-08-25,Fall,2011,Aug,10,0,Thursday,1,Misty,0.74,0.697,0.66,0.2985,37,105,142,494,142,142
5582,2011-08-25,Fall,2011,Aug,11,0,Thursday,1,Light_rainsnow,0.7,0.6667,0.79,0.0,39,112,151,494,151,151
5583,2011-08-25,Fall,2011,Aug,12,0,Thursday,1,Light_rainsnow,0.7,0.6667,0.79,0.0,9,32,41,494,41,41
5584,2011-08-25,Fall,2011,Aug,13,0,Thursday,1,Clear,0.7,0.6667,0.79,0.1045,7,30,37,494,37,37
5585,2011-08-25,Fall,2011,Aug,14,0,Thursday,1,Misty,0.72,0.697,0.74,0.0,27,86,113,494,113,113
5586,2011-08-25,Fall,2011,Aug,15,0,Thursday,1,Misty,0.74,0.697,0.7,0.0,28,104,132,494,132,132
5587,2011-08-25,Fall,2011,Aug,16,0,Thursday,1,Clear,0.72,0.7121,0.84,0.0,16,105,121,494,121,121
5588,2011-08-25,Fall,2011,Aug,17,0,Thursday,1,Clear,0.72,0.7121,0.84,0.0,28,284,312,494,312,312
5589,2011-08-25,Fall,2011,Aug,18,0,Thursday,1,Misty,0.72,0.7121,0.84,0.1343,31,377,408,494,408,408
5590,2011-08-25,Fall,2011,Aug,19,0,Thursday,1,Misty,0.66,0.6061,0.78,0.3284,31,241,272,494,272,272
5591,2011-08-25,Fall,2011,Aug,20,0,Thursday,1,Clear,0.64,0.5909,0.78,0.3582,33,192,225,494,225,225
5592,2011-08-25,Fall,2011,Aug,21,0,Thursday,1,Clear,0.64,0.5909,0.78,0.2836,29,158,187,494,187,187
5593,2011-08-25,Fall,2011,Aug,22,0,Thursday,1,Clear,0.62,0.5758,0.83,0.0,21,126,147,494,147,147
5594,2011-08-25,Fall,2011,Aug,23,0,Thursday,1,Clear,0.62,0.5758,0.83,0.0896,15,69,84,494,84,84
5595,2011-08-26,Fall,2011,Aug,0,0,Friday,1,Clear,0.62,0.5758,0.83,0.1343,9,42,51,493,51,51
5596,2011-08-26,Fall,2011,Aug,1,0,Friday,1,Clear,0.62,0.5758,0.83,0.0,10,13,23,493,23,23
5597,2011-08-26,Fall,2011,Aug,2,0,Friday,1,Clear,0.62,0.5606,0.88,0.1343,4,16,20,493,20,20
5598,2011-08-26,Fall,2011,Aug,3,0,Friday,1,Clear,0.6,0.5455,0.88,0.1045,3,8,11,493,11,11
5599,2011-08-26,Fall,2011,Aug,4,0,Friday,1,Clear,0.62,0.5606,0.88,0.0,2,6,8,493,8,8
5600,2011-08-26,Fall,2011,Aug,5,0,Friday,1,Misty,0.62,0.5606,0.88,0.0,3,23,26,493,26,26
5601,2011-08-26,Fall,2011,Aug,6,0,Friday,1,Clear,0.62,0.5606,0.88,0.0,5,100,105,493,105,105
5602,2011-08-26,Fall,2011,Aug,7,0,Friday,1,Clear,0.64,0.5758,0.83,0.0,3,263,266,493,266,266
5603,2011-08-26,Fall,2011,Aug,8,0,Friday,1,Clear,0.66,0.6061,0.83,0.1045,17,387,404,493,404,404
5604,2011-08-26,Fall,2011,Aug,9,0,Friday,1,Clear,0.7,0.6667,0.74,0.0,39,191,230,493,230,230
5605,2011-08-26,Fall,2011,Aug,10,0,Friday,1,Clear,0.74,0.697,0.66,0.0896,34,89,123,493,123,123
5606,2011-08-26,Fall,2011,Aug,11,0,Friday,1,Misty,0.76,0.7121,0.62,0.0,63,151,214,493,214,214
5607,2011-08-26,Fall,2011,Aug,12,0,Friday,1,Misty,0.76,0.7273,0.66,0.1045,70,173,243,493,243,243
5608,2011-08-26,Fall,2011,Aug,13,0,Friday,1,Misty,0.78,0.7424,0.59,0.1045,72,165,237,493,237,237
5609,2011-08-26,Fall,2011,Aug,14,0,Friday,1,Clear,0.8,0.7727,0.59,0.0,55,164,219,493,219,219
5610,2011-08-26,Fall,2011,Aug,15,0,Friday,1,Misty,0.8,0.7727,0.59,0.194,53,196,249,493,249,249
5611,2011-08-26,Fall,2011,Aug,16,0,Friday,1,Clear,0.78,0.7424,0.62,0.1045,50,293,343,493,343,343
5612,2011-08-26,Fall,2011,Aug,17,0,Friday,1,Clear,0.74,0.7121,0.74,0.2537,56,433,489,493,489,489
5613,2011-08-26,Fall,2011,Aug,18,0,Friday,1,Misty,0.74,0.7121,0.74,0.1343,40,370,410,493,410,410
5614,2011-08-26,Fall,2011,Aug,19,0,Friday,1,Clear,0.72,0.697,0.79,0.1045,55,235,290,493,290,290
5615,2011-08-26,Fall,2011,Aug,20,0,Friday,1,Clear,0.72,0.697,0.79,0.0896,39,183,222,493,222,222
5616,2011-08-26,Fall,2011,Aug,21,0,Friday,1,Clear,0.72,0.697,0.79,0.1642,38,152,190,493,190,190
5617,2011-08-26,Fall,2011,Aug,22,0,Friday,1,Clear,0.72,0.697,0.79,0.1045,26,126,152,493,152,152
5618,2011-08-26,Fall,2011,Aug,23,0,Friday,1,Clear,0.7,0.6667,0.84,0.0896,22,114,136,493,136,136
5619,2011-08-27,Fall,2011,Aug,0,0,Saturday,0,Clear,0.7,0.6667,0.84,0.1045,33,112,145,492,145,145
5620,2011-08-27,Fall,2011,Aug,1,0,Saturday,0,Clear,0.7,0.6667,0.84,0.1642,13,51,64,492,64,64
5621,2011-08-27,Fall,2011,Aug,2,0,Saturday,0,Clear,0.7,0.6667,0.84,0.194,18,59,77,492,77,77
5622,2011-08-27,Fall,2011,Aug,3,0,Saturday,0,Misty,0.7,0.6667,0.84,0.2239,8,22,30,492,30,30
5623,2011-08-27,Fall,2011,Aug,4,0,Saturday,0,Misty,0.7,0.6667,0.84,0.2239,1,3,4,492,4,4
5624,2011-08-27,Fall,2011,Aug,5,0,Saturday,0,Misty,0.7,0.6667,0.84,0.2985,1,11,12,492,12,12
5625,2011-08-27,Fall,2011,Aug,6,0,Saturday,0,Misty,0.7,0.6667,0.84,0.2985,3,15,18,492,18,18
5626,2011-08-27,Fall,2011,Aug,7,0,Saturday,0,Misty,0.7,0.6667,0.84,0.3582,2,26,28,492,28,28
5627,2011-08-27,Fall,2011,Aug,8,0,Saturday,0,Misty,0.7,0.6667,0.84,0.2537,14,62,76,492,76,76
5628,2011-08-27,Fall,2011,Aug,9,0,Saturday,0,Misty,0.7,0.6667,0.84,0.4179,28,128,156,492,156,156
5629,2011-08-27,Fall,2011,Aug,10,0,Saturday,0,Misty,0.7,0.6667,0.79,0.4627,51,154,205,492,205,205
5630,2011-08-27,Fall,2011,Aug,11,0,Saturday,0,Light_rainsnow,0.66,0.5909,0.89,0.4179,15,73,88,492,88,88
5631,2011-08-27,Fall,2011,Aug,12,0,Saturday,0,Light_rainsnow,0.66,0.6061,0.83,0.4925,11,65,76,492,76,76
5632,2011-08-27,Fall,2011,Aug,13,0,Saturday,0,Light_rainsnow,0.66,0.6061,0.83,0.3881,10,33,43,492,43,43
5633,2011-08-27,Fall,2011,Aug,14,0,Saturday,0,Light_rainsnow,0.64,0.5758,0.89,0.5522,4,19,23,492,23,23
5634,2011-08-27,Fall,2011,Aug,15,0,Saturday,0,Light_rainsnow,0.64,0.5758,0.89,0.5522,2,28,30,492,30,30
5635,2011-08-27,Fall,2011,Aug,16,0,Saturday,0,Light_rainsnow,0.64,0.5758,0.89,0.5224,10,14,24,492,24,24
5636,2011-08-27,Fall,2011,Aug,17,0,Saturday,0,Light_rainsnow,0.64,0.5758,0.89,0.8358,2,14,16,492,16,16
5637,2011-08-28,Fall,2011,Aug,7,0,Sunday,0,Light_rainsnow,0.62,0.5758,0.83,0.3582,0,1,1,491,1,1
5638,2011-08-28,Fall,2011,Aug,8,0,Sunday,0,Light_rainsnow,0.62,0.5758,0.83,0.4179,2,6,8,491,8,8
5639,2011-08-28,Fall,2011,Aug,9,0,Sunday,0,Clear,0.66,0.6212,0.74,0.4179,7,46,53,491,53,53
5640,2011-08-28,Fall,2011,Aug,10,0,Sunday,0,Clear,0.7,0.6515,0.61,0.6119,27,115,142,491,142,142
5641,2011-08-28,Fall,2011,Aug,11,0,Sunday,0,Clear,0.7,0.6515,0.58,0.3881,59,178,237,491,237,237
5642,2011-08-28,Fall,2011,Aug,12,0,Sunday,0,Clear,0.74,0.6667,0.51,0.3881,88,218,306,491,306,306
5643,2011-08-28,Fall,2011,Aug,13,0,Sunday,0,Clear,0.76,0.6818,0.45,0.3582,129,302,431,491,431,431
5644,2011-08-28,Fall,2011,Aug,14,0,Sunday,0,Clear,0.78,0.697,0.43,0.4179,157,290,447,491,447,447
5645,2011-08-28,Fall,2011,Aug,15,0,Sunday,0,Clear,0.78,0.697,0.43,0.3582,155,314,469,491,469,469
5646,2011-08-28,Fall,2011,Aug,16,0,Sunday,0,Clear,0.8,0.7121,0.36,0.3881,196,295,491,491,491,491
5647,2011-08-28,Fall,2011,Aug,17,0,Sunday,0,Clear,0.76,0.6818,0.4,0.2985,145,253,398,491,398,398
5648,2011-08-28,Fall,2011,Aug,18,0,Sunday,0,Clear,0.74,0.6667,0.42,0.2239,145,257,402,491,402,402
5649,2011-08-28,Fall,2011,Aug,19,0,Sunday,0,Clear,0.72,0.6667,0.48,0.1045,140,247,387,491,387,387
5650,2011-08-28,Fall,2011,Aug,20,0,Sunday,0,Clear,0.72,0.6515,0.45,0.1045,64,150,214,491,214,214
5651,2011-08-28,Fall,2011,Aug,21,0,Sunday,0,Clear,0.66,0.6212,0.61,0.1343,60,126,186,491,186,186
5652,2011-08-28,Fall,2011,Aug,22,0,Sunday,0,Clear,0.64,0.6061,0.69,0.1045,25,73,98,491,98,98
5653,2011-08-28,Fall,2011,Aug,23,0,Sunday,0,Clear,0.62,0.5909,0.73,0.1045,16,48,64,491,64,64
5654,2011-08-29,Fall,2011,Aug,0,0,Monday,1,Clear,0.62,0.5909,0.73,0.1045,13,21,34,490,34,34
5655,2011-08-29,Fall,2011,Aug,1,0,Monday,1,Clear,0.6,0.5909,0.69,0.1045,5,15,20,490,20,20
5656,2011-08-29,Fall,2011,Aug,2,0,Monday,1,Clear,0.6,0.5909,0.69,0.194,8,5,13,490,13,13
5657,2011-08-29,Fall,2011,Aug,3,0,Monday,1,Clear,0.6,0.5909,0.69,0.1045,1,5,6,490,6,6
5658,2011-08-29,Fall,2011,Aug,4,0,Monday,1,Clear,0.56,0.5303,0.68,0.1343,0,3,3,490,3,3
5659,2011-08-29,Fall,2011,Aug,5,0,Monday,1,Clear,0.56,0.5303,0.73,0.1343,0,17,17,490,17,17
5660,2011-08-29,Fall,2011,Aug,6,0,Monday,1,Clear,0.56,0.5303,0.73,0.1343,3,99,102,490,102,102
5661,2011-08-29,Fall,2011,Aug,7,0,Monday,1,Clear,0.6,0.6061,0.6,0.2239,11,273,284,490,284,284
5662,2011-08-29,Fall,2011,Aug,8,0,Monday,1,Clear,0.62,0.6212,0.57,0.2537,20,384,404,490,404,404
5663,2011-08-29,Fall,2011,Aug,9,0,Monday,1,Clear,0.62,0.6212,0.53,0.2537,22,166,188,490,188,188
5664,2011-08-29,Fall,2011,Aug,10,0,Monday,1,Clear,0.66,0.6212,0.47,0.2239,42,73,115,490,115,115
5665,2011-08-29,Fall,2011,Aug,11,0,Monday,1,Clear,0.66,0.6212,0.47,0.1642,38,100,138,490,138,138
5666,2011-08-29,Fall,2011,Aug,12,0,Monday,1,Misty,0.68,0.6364,0.44,0.1642,48,159,207,490,207,207
5667,2011-08-29,Fall,2011,Aug,13,0,Monday,1,Misty,0.7,0.6364,0.39,0.0,48,170,218,490,218,218
5668,2011-08-29,Fall,2011,Aug,14,0,Monday,1,Clear,0.7,0.6364,0.42,0.0,55,127,182,490,182,182
5669,2011-08-29,Fall,2011,Aug,15,0,Monday,1,Clear,0.7,0.6364,0.42,0.1642,56,164,220,490,220,220
5670,2011-08-29,Fall,2011,Aug,16,0,Monday,1,Clear,0.72,0.6515,0.42,0.1642,56,226,282,490,282,282
5671,2011-08-29,Fall,2011,Aug,17,0,Monday,1,Misty,0.7,0.6364,0.47,0.2239,67,524,591,490,591,591
5672,2011-08-29,Fall,2011,Aug,18,0,Monday,1,Clear,0.66,0.6212,0.47,0.2537,60,487,547,490,547,547
5673,2011-08-29,Fall,2011,Aug,19,0,Monday,1,Clear,0.66,0.6212,0.47,0.2537,50,317,367,490,367,367
5674,2011-08-29,Fall,2011,Aug,20,0,Monday,1,Clear,0.64,0.6212,0.53,0.1642,50,227,277,490,277,277
5675,2011-08-29,Fall,2011,Aug,21,0,Monday,1,Clear,0.64,0.6212,0.53,0.194,34,168,202,490,202,202
5676,2011-08-29,Fall,2011,Aug,22,0,Monday,1,Clear,0.62,0.6212,0.57,0.1343,23,119,142,490,142,142
5677,2011-08-29,Fall,2011,Aug,23,0,Monday,1,Clear,0.6,0.6061,0.6,0.0896,19,56,75,490,75,75
5678,2011-08-30,Fall,2011,Aug,0,0,Tuesday,1,Clear,0.56,0.5303,0.73,0.1343,10,17,27,489,27,27
5679,2011-08-30,Fall,2011,Aug,1,0,Tuesday,1,Clear,0.56,0.5303,0.68,0.1045,6,7,13,489,13,13
5680,2011-08-30,Fall,2011,Aug,2,0,Tuesday,1,Clear,0.54,0.5152,0.73,0.1045,2,8,10,489,10,10
5681,2011-08-30,Fall,2011,Aug,3,0,Tuesday,1,Clear,0.54,0.5152,0.73,0.194,2,2,4,489,4,4
5682,2011-08-30,Fall,2011,Aug,4,0,Tuesday,1,Clear,0.52,0.5,0.77,0.1642,0,6,6,489,6,6
5683,2011-08-30,Fall,2011,Aug,5,0,Tuesday,1,Clear,0.52,0.5,0.77,0.0896,1,27,28,489,28,28
5684,2011-08-30,Fall,2011,Aug,6,0,Tuesday,1,Clear,0.54,0.5152,0.73,0.1045,4,115,119,489,119,119
5685,2011-08-30,Fall,2011,Aug,7,0,Tuesday,1,Clear,0.56,0.5303,0.68,0.1343,19,338,357,489,357,357
5686,2011-08-30,Fall,2011,Aug,8,0,Tuesday,1,Clear,0.62,0.6212,0.57,0.1343,34,459,493,489,493,493
5687,2011-08-30,Fall,2011,Aug,9,0,Tuesday,1,Clear,0.66,0.6212,0.5,0.2239,38,180,218,489,218,218
5688,2011-08-30,Fall,2011,Aug,10,0,Tuesday,1,Clear,0.7,0.6364,0.39,0.2239,28,109,137,489,137,137
5689,2011-08-30,Fall,2011,Aug,11,0,Tuesday,1,Clear,0.72,0.6515,0.37,0.194,60,115,175,489,175,175
5690,2011-08-30,Fall,2011,Aug,12,0,Tuesday,1,Clear,0.72,0.6515,0.37,0.0,65,172,237,489,237,237
5691,2011-08-30,Fall,2011,Aug,13,0,Tuesday,1,Clear,0.74,0.6515,0.35,0.1045,59,170,229,489,229,229
5692,2011-08-30,Fall,2011,Aug,14,0,Tuesday,1,Clear,0.74,0.6515,0.33,0.1642,58,151,209,489,209,209
5693,2011-08-30,Fall,2011,Aug,15,0,Tuesday,1,Clear,0.74,0.6515,0.35,0.2239,34,162,196,489,196,196
5694,2011-08-30,Fall,2011,Aug,16,0,Tuesday,1,Clear,0.74,0.6515,0.37,0.1642,42,295,337,489,337,337
5695,2011-08-30,Fall,2011,Aug,17,0,Tuesday,1,Clear,0.72,0.6515,0.42,0.194,62,549,611,489,611,611
5696,2011-08-30,Fall,2011,Aug,18,0,Tuesday,1,Clear,0.7,0.6364,0.45,0.1642,60,516,576,489,576,576
5697,2011-08-30,Fall,2011,Aug,19,0,Tuesday,1,Clear,0.66,0.6212,0.5,0.0896,68,397,465,489,465,465
5698,2011-08-30,Fall,2011,Aug,20,0,Tuesday,1,Clear,0.66,0.6212,0.5,0.0,39,259,298,489,298,298
5699,2011-08-30,Fall,2011,Aug,21,0,Tuesday,1,Clear,0.64,0.6061,0.65,0.0896,43,180,223,489,223,223
5700,2011-08-30,Fall,2011,Aug,22,0,Tuesday,1,Clear,0.62,0.6061,0.61,0.0,22,121,143,489,143,143
5701,2011-08-30,Fall,2011,Aug,23,0,Tuesday,1,Clear,0.62,0.6061,0.61,0.0,19,74,93,489,93,93
5702,2011-08-31,Fall,2011,Aug,0,0,Wednesday,1,Clear,0.6,0.5909,0.69,0.0,8,24,32,488,32,32
5703,2011-08-31,Fall,2011,Aug,1,0,Wednesday,1,Clear,0.6,0.5909,0.69,0.0,2,13,15,488,15,15
5704,2011-08-31,Fall,2011,Aug,2,0,Wednesday,1,Clear,0.56,0.5303,0.73,0.0,1,5,6,488,6,6
5705,2011-08-31,Fall,2011,Aug,3,0,Wednesday,1,Clear,0.56,0.5303,0.78,0.0,2,4,6,488,6,6
5706,2011-08-31,Fall,2011,Aug,4,0,Wednesday,1,Clear,0.56,0.5303,0.73,0.0,0,5,5,488,5,5
5707,2011-08-31,Fall,2011,Aug,5,0,Wednesday,1,Clear,0.54,0.5152,0.83,0.0896,2,25,27,488,27,27
5708,2011-08-31,Fall,2011,Aug,6,0,Wednesday,1,Clear,0.54,0.5152,0.77,0.0,4,107,111,488,111,111
5709,2011-08-31,Fall,2011,Aug,7,0,Wednesday,1,Clear,0.6,0.5758,0.78,0.0,12,316,328,488,328,328
5710,2011-08-31,Fall,2011,Aug,8,0,Wednesday,1,Clear,0.62,0.6061,0.69,0.0,27,440,467,488,467,467
5711,2011-08-31,Fall,2011,Aug,9,0,Wednesday,1,Clear,0.64,0.6061,0.69,0.0896,27,217,244,488,244,244
5712,2011-08-31,Fall,2011,Aug,10,0,Wednesday,1,Clear,0.7,0.6364,0.45,0.1045,33,105,138,488,138,138
5713,2011-08-31,Fall,2011,Aug,11,0,Wednesday,1,Clear,0.72,0.6515,0.42,0.1343,28,143,171,488,171,171
5714,2011-08-31,Fall,2011,Aug,12,0,Wednesday,1,Clear,0.74,0.6667,0.43,0.1343,68,192,260,488,260,260
5715,2011-08-31,Fall,2011,Aug,13,0,Wednesday,1,Clear,0.74,0.6515,0.37,0.1045,39,182,221,488,221,221
5716,2011-08-31,Fall,2011,Aug,14,0,Wednesday,1,Clear,0.74,0.6515,0.4,0.1343,48,148,196,488,196,196
5717,2011-08-31,Fall,2011,Aug,15,0,Wednesday,1,Clear,0.74,0.6515,0.4,0.1343,34,138,172,488,172,172
5718,2011-08-31,Fall,2011,Aug,16,0,Wednesday,1,Clear,0.74,0.6667,0.42,0.1343,46,263,309,488,309,309
5719,2011-08-31,Fall,2011,Aug,17,0,Wednesday,1,Clear,0.72,0.6515,0.45,0.1343,83,525,608,488,608,608
5720,2011-08-31,Fall,2011,Aug,18,0,Wednesday,1,Clear,0.7,0.6515,0.51,0.2239,70,495,565,488,565,565
5721,2011-08-31,Fall,2011,Aug,19,0,Wednesday,1,Clear,0.84,0.7727,0.47,0.2537,53,393,446,488,446,446
5722,2011-08-31,Fall,2011,Aug,20,0,Wednesday,1,Clear,0.66,0.6212,0.57,0.1343,30,259,289,488,289,289
5723,2011-08-31,Fall,2011,Aug,21,0,Wednesday,1,Clear,0.66,0.6212,0.61,0.0896,27,174,201,488,201,201
5724,2011-08-31,Fall,2011,Aug,22,0,Wednesday,1,Clear,0.64,0.6061,0.69,0.0,20,137,157,488,157,157
5725,2011-08-31,Fall,2011,Aug,23,0,Wednesday,1,Clear,0.6,0.5758,0.78,0.1045,24,60,84,488,84,84
5726,2011-09-01,Fall,2011,Sep,0,0,Thursday,1,Clear,0.6,0.5758,0.78,0.1045,18,33,51,487,51,51
5727,2011-09-01,Fall,2011,Sep,1,0,Thursday,1,Clear,0.6,0.5909,0.73,0.0896,7,14,21,487,21,21
5728,2011-09-01,Fall,2011,Sep,2,0,Thursday,1,Clear,0.58,0.5455,0.78,0.0896,14,11,25,487,25,25
5729,2011-09-01,Fall,2011,Sep,3,0,Thursday,1,Clear,0.58,0.5455,0.78,0.0896,7,7,14,487,14,14
5730,2011-09-01,Fall,2011,Sep,4,0,Thursday,1,Clear,0.56,0.5303,0.83,0.0896,0,7,7,487,7,7
5731,2011-09-01,Fall,2011,Sep,5,0,Thursday,1,Clear,0.56,0.5303,0.73,0.0896,1,22,23,487,23,23
5732,2011-09-01,Fall,2011,Sep,6,0,Thursday,1,Clear,0.6,0.5758,0.78,0.0,2,103,105,487,105,105
5733,2011-09-01,Fall,2011,Sep,7,0,Thursday,1,Clear,0.6,0.5758,0.78,0.0,7,335,342,487,342,342
5734,2011-09-01,Fall,2011,Sep,8,0,Thursday,1,Clear,0.62,0.5909,0.73,0.1343,31,467,498,487,498,498
5735,2011-09-01,Fall,2011,Sep,9,0,Thursday,1,Clear,0.64,0.6061,0.69,0.1045,29,178,207,487,207,207
5736,2011-09-01,Fall,2011,Sep,10,0,Thursday,1,Clear,0.68,0.6364,0.61,0.1343,46,92,138,487,138,138
5737,2011-09-01,Fall,2011,Sep,11,0,Thursday,1,Clear,0.72,0.6667,0.51,0.1343,51,141,192,487,192,192
5738,2011-09-01,Fall,2011,Sep,12,0,Thursday,1,Misty,0.72,0.6667,0.51,0.1343,64,165,229,487,229,229
5739,2011-09-01,Fall,2011,Sep,13,0,Thursday,1,Misty,0.72,0.6667,0.48,0.0896,50,169,219,487,219,219
5740,2011-09-01,Fall,2011,Sep,14,0,Thursday,1,Light_rainsnow,0.72,0.6667,0.54,0.2537,54,144,198,487,198,198
5741,2011-09-01,Fall,2011,Sep,15,0,Thursday,1,Clear,0.72,0.6667,0.51,0.1343,39,135,174,487,174,174
5742,2011-09-01,Fall,2011,Sep,16,0,Thursday,1,Clear,0.74,0.6667,0.51,0.194,55,253,308,487,308,308
5743,2011-09-01,Fall,2011,Sep,17,0,Thursday,1,Clear,0.72,0.6667,0.54,0.2537,61,567,628,487,628,628
5744,2011-09-01,Fall,2011,Sep,18,0,Thursday,1,Clear,0.72,0.6667,0.54,0.2239,69,462,531,487,531,531
5745,2011-09-01,Fall,2011,Sep,19,0,Thursday,1,Clear,0.7,0.6515,0.58,0.1642,79,364,443,487,443,443
5746,2011-09-01,Fall,2011,Sep,20,0,Thursday,1,Clear,0.66,0.6212,0.61,0.2239,33,247,280,487,280,280
5747,2011-09-01,Fall,2011,Sep,21,0,Thursday,1,Misty,0.66,0.6212,0.57,0.194,17,160,177,487,177,177
5748,2011-09-01,Fall,2011,Sep,22,0,Thursday,1,Misty,0.66,0.6212,0.57,0.2239,34,145,179,487,179,179
5749,2011-09-01,Fall,2011,Sep,23,0,Thursday,1,Clear,0.64,0.6061,0.65,0.2537,15,111,126,487,126,126
5750,2011-09-02,Fall,2011,Sep,0,0,Friday,1,Clear,0.64,0.6061,0.65,0.194,6,58,64,486,64,64
5751,2011-09-02,Fall,2011,Sep,1,0,Friday,1,Light_rainsnow,0.62,0.5909,0.73,0.1045,4,28,32,486,32,32
5752,2011-09-02,Fall,2011,Sep,2,0,Friday,1,Light_rainsnow,0.62,0.5909,0.73,0.1045,9,11,20,486,20,20
5753,2011-09-02,Fall,2011,Sep,3,0,Friday,1,Misty,0.6,0.5606,0.83,0.1642,4,4,8,486,8,8
5754,2011-09-02,Fall,2011,Sep,4,0,Friday,1,Clear,0.6,0.5606,0.83,0.0896,2,2,4,486,4,4
5755,2011-09-02,Fall,2011,Sep,5,0,Friday,1,Misty,0.6,0.5606,0.83,0.1343,0,20,20,486,20,20
5756,2011-09-02,Fall,2011,Sep,6,0,Friday,1,Clear,0.6,0.5606,0.83,0.1343,3,73,76,486,76,76
5757,2011-09-02,Fall,2011,Sep,7,0,Friday,1,Clear,0.6,0.5606,0.83,0.1045,6,253,259,486,259,259
5758,2011-09-02,Fall,2011,Sep,8,0,Friday,1,Clear,0.62,0.5909,0.78,0.194,22,434,456,486,456,456
5759,2011-09-02,Fall,2011,Sep,9,0,Friday,1,Misty,0.62,0.5758,0.83,0.1045,30,190,220,486,220,220
5760,2011-09-02,Fall,2011,Sep,10,0,Friday,1,Misty,0.64,0.6061,0.76,0.1642,34,106,140,486,140,140
5761,2011-09-02,Fall,2011,Sep,11,0,Friday,1,Misty,0.66,0.6212,0.74,0.1045,51,141,192,486,192,192
5762,2011-09-02,Fall,2011,Sep,12,0,Friday,1,Misty,0.66,0.6212,0.69,0.2239,82,178,260,486,260,260
5763,2011-09-02,Fall,2011,Sep,13,0,Friday,1,Misty,0.68,0.6364,0.65,0.1343,72,207,279,486,279,279
5764,2011-09-02,Fall,2011,Sep,14,0,Friday,1,Misty,0.7,0.6515,0.61,0.1045,75,208,283,486,283,283
5765,2011-09-02,Fall,2011,Sep,15,0,Friday,1,Misty,0.7,0.6515,0.61,0.2537,69,277,346,486,346,346
5766,2011-09-02,Fall,2011,Sep,16,0,Friday,1,Misty,0.7,0.6515,0.61,0.1343,82,299,381,486,381,381
5767,2011-09-02,Fall,2011,Sep,17,0,Friday,1,Misty,0.68,0.6364,0.65,0.1642,78,377,455,486,455,455
5768,2011-09-02,Fall,2011,Sep,18,0,Friday,1,Misty,0.68,0.6364,0.65,0.194,50,305,355,486,355,355
5769,2011-09-02,Fall,2011,Sep,19,0,Friday,1,Clear,0.66,0.6212,0.69,0.1343,67,220,287,486,287,287
5770,2011-09-02,Fall,2011,Sep,20,0,Friday,1,Clear,0.64,0.6061,0.73,0.0,38,158,196,486,196,196
5771,2011-09-02,Fall,2011,Sep,21,0,Friday,1,Misty,0.64,0.6061,0.73,0.0896,28,121,149,486,149,149
5772,2011-09-02,Fall,2011,Sep,22,0,Friday,1,Misty,0.64,0.6061,0.73,0.1642,33,114,147,486,147,147
5773,2011-09-02,Fall,2011,Sep,23,0,Friday,1,Misty,0.64,0.6061,0.73,0.1642,30,68,98,486,98,98
5774,2011-09-03,Fall,2011,Sep,0,0,Saturday,0,Misty,0.64,0.6061,0.73,0.1045,22,65,87,485,87,87
5775,2011-09-03,Fall,2011,Sep,1,0,Saturday,0,Misty,0.64,0.6061,0.69,0.2537,17,57,74,485,74,74
5776,2011-09-03,Fall,2011,Sep,2,0,Saturday,0,Misty,0.64,0.6061,0.69,0.2239,15,26,41,485,41,41
5777,2011-09-03,Fall,2011,Sep,3,0,Saturday,0,Clear,0.62,0.5909,0.73,0.1642,17,18,35,485,35,35
5778,2011-09-03,Fall,2011,Sep,4,0,Saturday,0,Clear,0.62,0.5909,0.73,0.1642,3,4,7,485,7,7
5779,2011-09-03,Fall,2011,Sep,5,0,Saturday,0,Clear,0.62,0.6061,0.69,0.194,3,9,12,485,12,12
5780,2011-09-03,Fall,2011,Sep,6,0,Saturday,0,Clear,0.62,0.5909,0.73,0.1642,4,19,23,485,23,23
5781,2011-09-03,Fall,2011,Sep,7,0,Saturday,0,Clear,0.62,0.5909,0.73,0.194,5,33,38,485,38,38
5782,2011-09-03,Fall,2011,Sep,8,0,Saturday,0,Clear,0.64,0.6061,0.69,0.1642,24,65,89,485,89,89
5783,2011-09-03,Fall,2011,Sep,9,0,Saturday,0,Misty,0.66,0.6212,0.69,0.2537,83,118,201,485,201,201
5784,2011-09-03,Fall,2011,Sep,10,0,Saturday,0,Light_rainsnow,0.66,0.6212,0.65,0.2537,90,168,258,485,258,258
5785,2011-09-03,Fall,2011,Sep,11,0,Saturday,0,Light_rainsnow,0.66,0.6212,0.69,0.2836,66,128,194,485,194,194
5786,2011-09-03,Fall,2011,Sep,12,0,Saturday,0,Clear,0.7,0.6515,0.61,0.2239,97,160,257,485,257,257
5787,2011-09-03,Fall,2011,Sep,13,0,Saturday,0,Clear,0.7,0.6515,0.65,0.2239,153,200,353,485,353,353
5788,2011-09-03,Fall,2011,Sep,14,0,Saturday,0,Misty,0.72,0.6818,0.66,0.1642,204,176,380,485,380,380
5789,2011-09-03,Fall,2011,Sep,15,0,Saturday,0,Clear,0.72,0.6818,0.7,0.1642,187,201,388,485,388,388
5790,2011-09-03,Fall,2011,Sep,16,0,Saturday,0,Clear,0.72,0.6818,0.7,0.194,186,188,374,485,374,374
5791,2011-09-03,Fall,2011,Sep,17,0,Saturday,0,Clear,0.72,0.6818,0.7,0.2239,170,201,371,485,371,371
5792,2011-09-03,Fall,2011,Sep,18,0,Saturday,0,Clear,0.72,0.6818,0.7,0.1642,160,179,339,485,339,339
5793,2011-09-03,Fall,2011,Sep,19,0,Saturday,0,Clear,0.7,0.6667,0.74,0.1343,147,148,295,485,295,295
5794,2011-09-03,Fall,2011,Sep,20,0,Saturday,0,Clear,0.7,0.6667,0.79,0.1642,99,120,219,485,219,219
5795,2011-09-03,Fall,2011,Sep,21,0,Saturday,0,Clear,0.68,0.6364,0.83,0.1343,71,93,164,485,164,164
5796,2011-09-03,Fall,2011,Sep,22,0,Saturday,0,Clear,0.68,0.6364,0.83,0.1045,66,96,162,485,162,162
5797,2011-09-03,Fall,2011,Sep,23,0,Saturday,0,Clear,0.66,0.6212,0.85,0.1343,46,77,123,485,123,123
5798,2011-09-04,Fall,2011,Sep,0,0,Sunday,0,Clear,0.66,0.5909,0.89,0.194,33,76,109,484,109,109
5799,2011-09-04,Fall,2011,Sep,1,0,Sunday,0,Clear,0.66,0.6061,0.83,0.1343,37,38,75,484,75,75
5800,2011-09-04,Fall,2011,Sep,2,0,Sunday,0,Clear,0.66,0.6061,0.83,0.194,17,43,60,484,60,60
5801,2011-09-04,Fall,2011,Sep,3,0,Sunday,0,Clear,0.64,0.5758,0.89,0.194,20,23,43,484,43,43
5802,2011-09-04,Fall,2011,Sep,4,0,Sunday,0,Clear,0.64,0.5758,0.83,0.1642,0,4,4,484,4,4
5803,2011-09-04,Fall,2011,Sep,5,0,Sunday,0,Clear,0.64,0.5758,0.83,0.1343,1,5,6,484,6,6
5804,2011-09-04,Fall,2011,Sep,6,0,Sunday,0,Clear,0.64,0.5758,0.84,0.2239,0,3,3,484,3,3
5805,2011-09-04,Fall,2011,Sep,7,0,Sunday,0,Clear,0.66,0.6061,0.78,0.194,10,20,30,484,30,30
5806,2011-09-04,Fall,2011,Sep,8,0,Sunday,0,Clear,0.66,0.6061,0.78,0.1642,21,49,70,484,70,70
5807,2011-09-04,Fall,2011,Sep,9,0,Sunday,0,Clear,0.66,0.6061,0.78,0.1642,87,102,189,484,189,189
5808,2011-09-04,Fall,2011,Sep,10,0,Sunday,0,Clear,0.7,0.6667,0.74,0.1343,150,147,297,484,297,297
5809,2011-09-04,Fall,2011,Sep,11,0,Sunday,0,Clear,0.74,0.697,0.7,0.1642,174,163,337,484,337,337
5810,2011-09-04,Fall,2011,Sep,12,0,Sunday,0,Clear,0.76,0.7273,0.66,0.1642,214,221,435,484,435,435
5811,2011-09-04,Fall,2011,Sep,13,0,Sunday,0,Misty,0.78,0.7424,0.62,0.2836,245,174,419,484,419,419
5812,2011-09-04,Fall,2011,Sep,14,0,Sunday,0,Clear,0.78,0.7576,0.66,0.3284,205,156,361,484,361,361
5813,2011-09-04,Fall,2011,Sep,15,0,Sunday,0,Clear,0.78,0.7576,0.66,0.2836,218,192,410,484,410,410
5814,2011-09-04,Fall,2011,Sep,16,0,Sunday,0,Clear,0.8,0.7727,0.59,0.2239,196,141,337,484,337,337
5815,2011-09-04,Fall,2011,Sep,17,0,Sunday,0,Clear,0.76,0.7273,0.66,0.2239,204,172,376,484,376,376
5816,2011-09-04,Fall,2011,Sep,18,0,Sunday,0,Clear,0.76,0.7273,0.66,0.194,187,169,356,484,356,356
5817,2011-09-04,Fall,2011,Sep,19,0,Sunday,0,Clear,0.74,0.697,0.7,0.194,178,150,328,484,328,328
5818,2011-09-04,Fall,2011,Sep,20,0,Sunday,0,Clear,0.74,0.697,0.7,0.2985,104,125,229,484,229,229
5819,2011-09-04,Fall,2011,Sep,21,0,Sunday,0,Clear,0.72,0.697,0.74,0.2537,104,103,207,484,207,207
5820,2011-09-04,Fall,2011,Sep,22,0,Sunday,0,Misty,0.72,0.697,0.74,0.2836,70,85,155,484,155,155
5821,2011-09-04,Fall,2011,Sep,23,0,Sunday,0,Misty,0.72,0.6818,0.7,0.1642,46,58,104,484,104,104
5822,2011-09-05,Fall,2011,Sep,0,1,Monday,0,Misty,0.7,0.6667,0.74,0.2239,31,66,97,483,97,97
5823,2011-09-05,Fall,2011,Sep,1,1,Monday,0,Misty,0.68,0.6364,0.79,0.1045,19,35,54,483,54,54
5824,2011-09-05,Fall,2011,Sep,2,1,Monday,0,Misty,0.68,0.6364,0.79,0.1642,17,22,39,483,39,39
5825,2011-09-05,Fall,2011,Sep,3,1,Monday,0,Misty,0.68,0.6364,0.74,0.2985,4,12,16,483,16,16
5826,2011-09-05,Fall,2011,Sep,4,1,Monday,0,Misty,0.68,0.6364,0.69,0.2836,3,5,8,483,8,8
5827,2011-09-05,Fall,2011,Sep,5,1,Monday,0,Misty,0.66,0.6212,0.74,0.1642,2,4,6,483,6,6
5828,2011-09-05,Fall,2011,Sep,6,1,Monday,0,Misty,0.66,0.6212,0.74,0.1343,6,5,11,483,11,11
5829,2011-09-05,Fall,2011,Sep,7,1,Monday,0,Clear,0.66,0.6212,0.74,0.1642,11,30,41,483,41,41
5830,2011-09-05,Fall,2011,Sep,8,1,Monday,0,Misty,0.66,0.6061,0.78,0.194,45,56,101,483,101,101
5831,2011-09-05,Fall,2011,Sep,9,1,Monday,0,Light_rainsnow,0.68,0.6364,0.74,0.1642,63,89,152,483,152,152
5832,2011-09-05,Fall,2011,Sep,10,1,Monday,0,Misty,0.7,0.6515,0.7,0.1642,107,137,244,483,244,244
5833,2011-09-05,Fall,2011,Sep,11,1,Monday,0,Misty,0.7,0.6667,0.74,0.1642,101,207,308,483,308,308
5834,2011-09-05,Fall,2011,Sep,12,1,Monday,0,Misty,0.72,0.6818,0.7,0.194,141,212,353,483,353,353
5835,2011-09-05,Fall,2011,Sep,13,1,Monday,0,Misty,0.74,0.697,0.7,0.1343,154,235,389,483,389,389
5836,2011-09-05,Fall,2011,Sep,14,1,Monday,0,Clear,0.74,0.697,0.7,0.1642,145,212,357,483,357,357
5837,2011-09-05,Fall,2011,Sep,15,1,Monday,0,Misty,0.68,0.6364,0.79,0.2836,111,142,253,483,253,253
5838,2011-09-05,Fall,2011,Sep,16,1,Monday,0,Misty,0.68,0.6364,0.79,0.2836,92,192,284,483,284,284
5839,2011-09-05,Fall,2011,Sep,17,1,Monday,0,Misty,0.66,0.5909,0.89,0.1045,37,77,114,483,114,114
5840,2011-09-05,Fall,2011,Sep,18,1,Monday,0,Clear,0.66,0.5909,0.89,0.0896,31,92,123,483,123,123
5841,2011-09-05,Fall,2011,Sep,19,1,Monday,0,Light_rainsnow,0.66,0.5909,0.94,0.1045,52,123,175,483,175,175
5842,2011-09-05,Fall,2011,Sep,20,1,Monday,0,Light_rainsnow,0.66,0.5909,0.94,0.2537,26,56,82,483,82,82
5843,2011-09-05,Fall,2011,Sep,21,1,Monday,0,Misty,0.66,0.5909,0.94,0.2985,20,40,60,483,60,60
5844,2011-09-05,Fall,2011,Sep,22,1,Monday,0,Misty,0.6,0.5455,0.88,0.5821,15,49,64,483,64,64
5845,2011-09-05,Fall,2011,Sep,23,1,Monday,0,Light_rainsnow,0.56,0.5303,0.88,0.3881,3,17,20,483,20,20
5846,2011-09-06,Fall,2011,Sep,0,0,Tuesday,1,Light_rainsnow,0.54,0.5152,0.94,0.3582,1,7,8,482,8,8
5847,2011-09-06,Fall,2011,Sep,2,0,Tuesday,1,Light_rainsnow,0.54,0.5152,0.94,0.2537,0,2,2,482,2,2
5848,2011-09-06,Fall,2011,Sep,3,0,Tuesday,1,Light_rainsnow,0.54,0.5152,0.94,0.2985,1,0,1,482,1,1
5849,2011-09-06,Fall,2011,Sep,4,0,Tuesday,1,Misty,0.54,0.5152,0.94,0.2985,1,3,4,482,4,4
5850,2011-09-06,Fall,2011,Sep,5,0,Tuesday,1,Light_rainsnow,0.54,0.5152,0.88,0.3582,1,20,21,482,21,21
5851,2011-09-06,Fall,2011,Sep,6,0,Tuesday,1,Misty,0.54,0.5152,0.88,0.3284,0,72,72,482,72,72
5852,2011-09-06,Fall,2011,Sep,7,0,Tuesday,1,Misty,0.54,0.5152,0.83,0.3582,6,166,172,482,172,172
5853,2011-09-06,Fall,2011,Sep,8,0,Tuesday,1,Light_rainsnow,0.54,0.5152,0.83,0.3881,15,349,364,482,364,364
5854,2011-09-06,Fall,2011,Sep,9,0,Tuesday,1,Misty,0.54,0.5152,0.81,0.4179,18,167,185,482,185,185
5855,2011-09-06,Fall,2011,Sep,10,0,Tuesday,1,Light_rainsnow,0.54,0.5152,0.83,0.3582,16,90,106,482,106,106
5856,2011-09-06,Fall,2011,Sep,11,0,Tuesday,1,Light_rainsnow,0.54,0.5152,0.83,0.3881,11,78,89,482,89,89
5857,2011-09-06,Fall,2011,Sep,12,0,Tuesday,1,Light_rainsnow,0.54,0.5152,0.83,0.3881,16,51,67,482,67,67
5858,2011-09-06,Fall,2011,Sep,13,0,Tuesday,1,Light_rainsnow,0.54,0.5152,0.88,0.2985,5,24,29,482,29,29
5859,2011-09-06,Fall,2011,Sep,14,0,Tuesday,1,Light_rainsnow,0.54,0.5152,0.88,0.2836,3,21,24,482,24,24
5860,2011-09-06,Fall,2011,Sep,15,0,Tuesday,1,Light_rainsnow,0.54,0.5152,0.94,0.3881,18,71,89,482,89,89
5861,2011-09-06,Fall,2011,Sep,16,0,Tuesday,1,Light_rainsnow,0.54,0.5152,0.94,0.3881,11,95,106,482,106,106
5862,2011-09-06,Fall,2011,Sep,17,0,Tuesday,1,Misty,0.54,0.5152,0.88,0.3881,15,276,291,482,291,291
5863,2011-09-06,Fall,2011,Sep,18,0,Tuesday,1,Misty,0.54,0.5152,0.88,0.3881,22,351,373,482,373,373
5864,2011-09-06,Fall,2011,Sep,19,0,Tuesday,1,Misty,0.54,0.5152,0.88,0.4179,12,269,281,482,281,281
5865,2011-09-06,Fall,2011,Sep,20,0,Tuesday,1,Light_rainsnow,0.54,0.5152,0.88,0.2985,13,150,163,482,163,163
5866,2011-09-06,Fall,2011,Sep,21,0,Tuesday,1,Light_rainsnow,0.54,0.5152,0.88,0.2836,12,109,121,482,121,121
5867,2011-09-06,Fall,2011,Sep,22,0,Tuesday,1,Misty,0.54,0.5152,0.94,0.3284,5,79,84,482,84,84
5868,2011-09-06,Fall,2011,Sep,23,0,Tuesday,1,Light_rainsnow,0.54,0.5152,0.94,0.2537,2,56,58,482,58,58
5869,2011-09-07,Fall,2011,Sep,0,0,Wednesday,1,Misty,0.54,0.5152,0.94,0.2239,1,12,13,481,13,13
5870,2011-09-07,Fall,2011,Sep,1,0,Wednesday,1,Light_rainsnow,0.54,0.5152,0.94,0.2537,2,3,5,481,5,5
5871,2011-09-07,Fall,2011,Sep,2,0,Wednesday,1,Misty,0.54,0.5152,0.94,0.2239,2,4,6,481,6,6
5872,2011-09-07,Fall,2011,Sep,3,0,Wednesday,1,Light_rainsnow,0.56,0.5303,0.94,0.1343,1,1,2,481,2,2
5873,2011-09-07,Fall,2011,Sep,4,0,Wednesday,1,Light_rainsnow,0.56,0.5303,0.94,0.1642,0,4,4,481,4,4
5874,2011-09-07,Fall,2011,Sep,5,0,Wednesday,1,Misty,0.56,0.5303,1.0,0.1343,1,15,16,481,16,16
5875,2011-09-07,Fall,2011,Sep,6,0,Wednesday,1,Light_rainsnow,0.6,0.5455,0.88,0.1045,1,74,75,481,75,75
5876,2011-09-07,Fall,2011,Sep,7,0,Wednesday,1,Light_rainsnow,0.6,0.5455,0.88,0.0896,3,83,86,481,86,86
5877,2011-09-07,Fall,2011,Sep,8,0,Wednesday,1,Light_rainsnow,0.62,0.5455,0.94,0.0896,9,319,328,481,328,328
5878,2011-09-07,Fall,2011,Sep,9,0,Wednesday,1,Light_rainsnow,0.6,0.5455,0.88,0.1343,14,176,190,481,190,190
5879,2011-09-07,Fall,2011,Sep,10,0,Wednesday,1,Light_rainsnow,0.6,0.5455,0.88,0.1343,3,63,66,481,66,66
5880,2011-09-07,Fall,2011,Sep,11,0,Wednesday,1,Light_rainsnow,0.6,0.5152,0.94,0.0,1,9,10,481,10,10
5881,2011-09-07,Fall,2011,Sep,12,0,Wednesday,1,Light_rainsnow,0.56,0.5303,0.94,0.0,1,21,22,481,22,22
5882,2011-09-07,Fall,2011,Sep,13,0,Wednesday,1,Light_rainsnow,0.6,0.5455,0.88,0.0,2,9,11,481,11,11
5883,2011-09-07,Fall,2011,Sep,14,0,Wednesday,1,Light_rainsnow,0.6,0.5152,0.93,0.0,1,24,25,481,25,25
5884,2011-09-07,Fall,2011,Sep,15,0,Wednesday,1,Light_rainsnow,0.62,0.5455,0.94,0.1045,3,55,58,481,58,58
5885,2011-09-07,Fall,2011,Sep,16,0,Wednesday,1,Clear,0.64,0.5758,0.89,0.0,7,137,144,481,144,144
5886,2011-09-07,Fall,2011,Sep,17,0,Wednesday,1,Light_rainsnow,0.64,0.5758,0.89,0.0,21,264,285,481,285,285
5887,2011-09-07,Fall,2011,Sep,18,0,Wednesday,1,Light_rainsnow,0.64,0.5758,0.89,0.0,18,219,237,481,237,237
5888,2011-09-07,Fall,2011,Sep,19,0,Wednesday,1,Misty,0.64,0.5758,0.89,0.0,14,212,226,481,226,226
5889,2011-09-07,Fall,2011,Sep,20,0,Wednesday,1,Light_rainsnow,0.64,0.5758,0.89,0.0896,3,93,96,481,96,96
5890,2011-09-07,Fall,2011,Sep,21,0,Wednesday,1,Light_rainsnow,0.64,0.5758,0.89,0.0896,4,34,38,481,38,38
5891,2011-09-07,Fall,2011,Sep,22,0,Wednesday,1,Light_rainsnow,0.62,0.5455,0.94,0.1642,3,26,29,481,29,29
5892,2011-09-07,Fall,2011,Sep,23,0,Wednesday,1,Light_rainsnow,0.62,0.5455,0.94,0.194,3,21,24,481,24,24
5893,2011-09-08,Fall,2011,Sep,0,0,Thursday,1,Light_rainsnow,0.6,0.5,1.0,0.194,3,11,14,480,14,14
5894,2011-09-08,Fall,2011,Sep,1,0,Thursday,1,Light_rainsnow,0.62,0.5455,0.94,0.1045,0,4,4,480,4,4
5895,2011-09-08,Fall,2011,Sep,3,0,Thursday,1,Light_rainsnow,0.62,0.5455,0.94,0.0,0,2,2,480,2,2
5896,2011-09-08,Fall,2011,Sep,4,0,Thursday,1,Misty,0.62,0.5455,0.94,0.0896,0,3,3,480,3,3
5897,2011-09-08,Fall,2011,Sep,5,0,Thursday,1,Light_rainsnow,0.62,0.5455,0.94,0.0896,1,13,14,480,14,14
5898,2011-09-08,Fall,2011,Sep,6,0,Thursday,1,Light_rainsnow,0.62,0.5455,0.94,0.1642,1,55,56,480,56,56
5899,2011-09-08,Fall,2011,Sep,7,0,Thursday,1,Light_rainsnow,0.62,0.5455,0.94,0.1045,7,172,179,480,179,179
5900,2011-09-08,Fall,2011,Sep,8,0,Thursday,1,Light_rainsnow,0.62,0.5455,0.94,0.1343,7,188,195,480,195,195
5901,2011-09-08,Fall,2011,Sep,9,0,Thursday,1,Misty,0.62,0.5152,1.0,0.2537,4,65,69,480,69,69
5902,2011-09-08,Fall,2011,Sep,10,0,Thursday,1,Misty,0.64,0.5606,0.94,0.1045,8,57,65,480,65,65
5903,2011-09-08,Fall,2011,Sep,11,0,Thursday,1,Misty,0.64,0.5606,0.94,0.2239,16,82,98,480,98,98
5904,2011-09-08,Fall,2011,Sep,12,0,Thursday,1,Misty,0.66,0.5909,0.94,0.2239,17,85,102,480,102,102
5905,2011-09-08,Fall,2011,Sep,13,0,Thursday,1,Misty,0.68,0.6364,0.83,0.3881,14,112,126,480,126,126
5906,2011-09-08,Fall,2011,Sep,14,0,Thursday,1,Misty,0.7,0.6667,0.79,0.3582,15,105,120,480,120,120
5907,2011-09-08,Fall,2011,Sep,15,0,Thursday,1,Light_rainsnow,0.66,0.5909,0.89,0.2985,24,115,139,480,139,139
5908,2011-09-08,Fall,2011,Sep,16,0,Thursday,1,Light_rainsnow,0.64,0.5606,0.94,0.2836,5,151,156,480,156,156
5909,2011-09-08,Fall,2011,Sep,17,0,Thursday,1,Light_rainsnow,0.64,0.5606,0.94,0.2836,11,102,113,480,113,113
5910,2011-09-08,Fall,2011,Sep,18,0,Thursday,1,Light_rainsnow,0.64,0.5606,0.94,0.3582,2,66,68,480,68,68
5911,2011-09-08,Fall,2011,Sep,19,0,Thursday,1,Light_rainsnow,0.62,0.5152,1.0,0.3284,1,51,52,480,52,52
5912,2011-09-08,Fall,2011,Sep,20,0,Thursday,1,Misty,0.62,0.5455,0.94,0.1642,6,83,89,480,89,89
5913,2011-09-08,Fall,2011,Sep,21,0,Thursday,1,Light_rainsnow,0.64,0.5606,0.94,0.1045,6,76,82,480,82,82
5914,2011-09-08,Fall,2011,Sep,22,0,Thursday,1,Light_rainsnow,0.62,0.5152,1.0,0.0896,5,65,70,480,70,70
5915,2011-09-08,Fall,2011,Sep,23,0,Thursday,1,Light_rainsnow,0.62,0.5152,1.0,0.0896,0,26,26,480,26,26
5916,2011-09-09,Fall,2011,Sep,0,0,Friday,1,Light_rainsnow,0.64,0.5606,0.94,0.194,1,15,16,479,16,16
5917,2011-09-09,Fall,2011,Sep,1,0,Friday,1,Misty,0.62,0.5152,1.0,0.1642,0,8,8,479,8,8
5918,2011-09-09,Fall,2011,Sep,2,0,Friday,1,Misty,0.62,0.5152,1.0,0.2537,1,7,8,479,8,8
5919,2011-09-09,Fall,2011,Sep,3,0,Friday,1,Misty,0.62,0.5455,0.94,0.2537,1,1,2,479,2,2
5920,2011-09-09,Fall,2011,Sep,4,0,Friday,1,Light_rainsnow,0.62,0.5455,0.94,0.1642,0,3,3,479,3,3
5921,2011-09-09,Fall,2011,Sep,5,0,Friday,1,Misty,0.62,0.5455,0.94,0.1343,0,14,14,479,14,14
5922,2011-09-09,Fall,2011,Sep,6,0,Friday,1,Misty,0.62,0.5152,1.0,0.1343,3,54,57,479,57,57
5923,2011-09-09,Fall,2011,Sep,7,0,Friday,1,Light_rainsnow,0.62,0.5152,1.0,0.2537,4,104,108,479,108,108
5924,2011-09-09,Fall,2011,Sep,8,0,Friday,1,Light_rainsnow,0.62,0.5455,0.94,0.1642,12,276,288,479,288,288
5925,2011-09-09,Fall,2011,Sep,9,0,Friday,1,Light_rainsnow,0.62,0.5455,0.94,0.1642,5,131,136,479,136,136
5926,2011-09-09,Fall,2011,Sep,10,0,Friday,1,Misty,0.62,0.5152,1.0,0.0,2,27,29,479,29,29
5927,2011-09-09,Fall,2011,Sep,11,0,Friday,1,Misty,0.62,0.5455,0.94,0.0,6,66,72,479,72,72
5928,2011-09-09,Fall,2011,Sep,12,0,Friday,1,Clear,0.64,0.5606,0.94,0.0,4,71,75,479,75,75
5929,2011-09-09,Fall,2011,Sep,13,0,Friday,1,Clear,0.7,0.6667,0.79,0.0896,14,108,122,479,122,122
5930,2011-09-09,Fall,2011,Sep,14,0,Friday,1,Clear,0.72,0.697,0.74,0.0896,29,119,148,479,148,148
5931,2011-09-09,Fall,2011,Sep,15,0,Friday,1,Clear,0.74,0.697,0.66,0.0,27,161,188,479,188,188
5932,2011-09-09,Fall,2011,Sep,16,0,Friday,1,Clear,0.74,0.697,0.66,0.1343,41,244,285,479,285,285
5933,2011-09-09,Fall,2011,Sep,17,0,Friday,1,Clear,0.7,0.6667,0.79,0.2537,54,451,505,479,505,505
5934,2011-09-09,Fall,2011,Sep,18,0,Friday,1,Clear,0.7,0.6667,0.79,0.194,33,377,410,479,410,410
5935,2011-09-09,Fall,2011,Sep,19,0,Friday,1,Clear,0.66,0.5909,0.89,0.1642,33,316,349,479,349,349
5936,2011-09-09,Fall,2011,Sep,20,0,Friday,1,Clear,0.64,0.5606,0.94,0.0896,30,180,210,479,210,210
5937,2011-09-09,Fall,2011,Sep,21,0,Friday,1,Clear,0.66,0.5909,0.89,0.0,49,154,203,479,203,203
5938,2011-09-09,Fall,2011,Sep,22,0,Friday,1,Clear,0.62,0.5455,0.94,0.0,33,127,160,479,160,160
5939,2011-09-09,Fall,2011,Sep,23,0,Friday,1,Clear,0.62,0.5455,0.94,0.0896,35,113,148,479,148,148
5940,2011-09-10,Fall,2011,Sep,0,0,Saturday,0,Clear,0.62,0.5455,0.94,0.0,32,84,116,478,116,116
5941,2011-09-10,Fall,2011,Sep,1,0,Saturday,0,Misty,0.62,0.5455,0.94,0.0,16,67,83,478,83,83
5942,2011-09-10,Fall,2011,Sep,2,0,Saturday,0,Misty,0.6,0.5,0.97,0.1045,18,46,64,478,64,64
5943,2011-09-10,Fall,2011,Sep,3,0,Saturday,0,Clear,0.58,0.5455,1.0,0.1343,8,29,37,478,37,37
5944,2011-09-10,Fall,2011,Sep,4,0,Saturday,0,Clear,0.58,0.5455,0.94,0.0896,3,4,7,478,7,7
5945,2011-09-10,Fall,2011,Sep,5,0,Saturday,0,Clear,0.58,0.5455,0.94,0.1343,2,6,8,478,8,8
5946,2011-09-10,Fall,2011,Sep,6,0,Saturday,0,Clear,0.58,0.5455,0.94,0.1642,0,6,6,478,6,6
5947,2011-09-10,Fall,2011,Sep,7,0,Saturday,0,Clear,0.6,0.5455,0.88,0.1343,9,43,52,478,52,52
5948,2011-09-10,Fall,2011,Sep,8,0,Saturday,0,Clear,0.62,0.5758,0.83,0.1642,16,103,119,478,119,119
5949,2011-09-10,Fall,2011,Sep,9,0,Saturday,0,Clear,0.64,0.5909,0.78,0.2985,39,168,207,478,207,207
5950,2011-09-10,Fall,2011,Sep,10,0,Saturday,0,Clear,0.7,0.6515,0.65,0.2537,85,233,318,478,318,318
5951,2011-09-10,Fall,2011,Sep,11,0,Saturday,0,Clear,0.72,0.6818,0.62,0.2537,108,252,360,478,360,360
5952,2011-09-10,Fall,2011,Sep,12,0,Saturday,0,Clear,0.72,0.6818,0.62,0.2239,144,260,404,478,404,404
5953,2011-09-10,Fall,2011,Sep,13,0,Saturday,0,Clear,0.74,0.6818,0.55,0.2836,131,239,370,478,370,370
5954,2011-09-10,Fall,2011,Sep,14,0,Saturday,0,Clear,0.74,0.6818,0.55,0.2836,129,230,359,478,359,359
5955,2011-09-10,Fall,2011,Sep,15,0,Saturday,0,Clear,0.74,0.6818,0.55,0.2239,217,263,480,478,480,480
5956,2011-09-10,Fall,2011,Sep,16,0,Saturday,0,Clear,0.74,0.6818,0.55,0.194,170,261,431,478,431,431
5957,2011-09-10,Fall,2011,Sep,17,0,Saturday,0,Clear,0.74,0.6818,0.55,0.2239,185,275,460,478,460,460
5958,2011-09-10,Fall,2011,Sep,18,0,Saturday,0,Clear,0.72,0.6667,0.58,0.194,119,241,360,478,360,360
5959,2011-09-10,Fall,2011,Sep,19,0,Saturday,0,Clear,0.7,0.6515,0.58,0.1343,101,214,315,478,315,315
5960,2011-09-10,Fall,2011,Sep,20,0,Saturday,0,Clear,0.66,0.6212,0.69,0.1045,78,167,245,478,245,245
5961,2011-09-10,Fall,2011,Sep,21,0,Saturday,0,Clear,0.64,0.5909,0.78,0.0896,59,171,230,478,230,230
5962,2011-09-10,Fall,2011,Sep,22,0,Saturday,0,Clear,0.64,0.5909,0.78,0.0,49,126,175,478,175,175
5963,2011-09-10,Fall,2011,Sep,23,0,Saturday,0,Misty,0.62,0.5606,0.88,0.0,32,107,139,478,139,139
5964,2011-09-11,Fall,2011,Sep,0,0,Sunday,0,Clear,0.62,0.5606,0.88,0.0,29,79,108,477,108,108
5965,2011-09-11,Fall,2011,Sep,1,0,Sunday,0,Misty,0.62,0.5606,0.88,0.0,22,66,88,477,88,88
5966,2011-09-11,Fall,2011,Sep,2,0,Sunday,0,Misty,0.62,0.5909,0.78,0.194,16,60,76,477,76,76
5967,2011-09-11,Fall,2011,Sep,3,0,Sunday,0,Misty,0.62,0.5909,0.78,0.0896,15,30,45,477,45,45
5968,2011-09-11,Fall,2011,Sep,4,0,Sunday,0,Clear,0.6,0.5606,0.83,0.1343,3,6,9,477,9,9
5969,2011-09-11,Fall,2011,Sep,5,0,Sunday,0,Clear,0.6,0.5606,0.83,0.1343,15,24,39,477,39,39
5970,2011-09-11,Fall,2011,Sep,6,0,Sunday,0,Clear,0.58,0.5455,0.88,0.1045,4,16,20,477,20,20
5971,2011-09-11,Fall,2011,Sep,7,0,Sunday,0,Clear,0.6,0.5455,0.88,0.0,9,28,37,477,37,37
5972,2011-09-11,Fall,2011,Sep,8,0,Sunday,0,Clear,0.64,0.5909,0.78,0.0,25,69,94,477,94,94
5973,2011-09-11,Fall,2011,Sep,9,0,Sunday,0,Clear,0.66,0.6212,0.74,0.0,59,168,227,477,227,227
5974,2011-09-11,Fall,2011,Sep,10,0,Sunday,0,Clear,0.7,0.6515,0.65,0.0,120,214,334,477,334,334
5975,2011-09-11,Fall,2011,Sep,11,0,Sunday,0,Clear,0.7,0.6515,0.65,0.0,144,258,402,477,402,402
5976,2011-09-11,Fall,2011,Sep,12,0,Sunday,0,Clear,0.7,0.6515,0.65,0.0,113,298,411,477,411,411
5977,2011-09-11,Fall,2011,Sep,13,0,Sunday,0,Clear,0.74,0.6818,0.58,0.1045,119,231,350,477,350,350
5978,2011-09-11,Fall,2011,Sep,14,0,Sunday,0,Clear,0.72,0.6667,0.58,0.2836,120,222,342,477,342,342
5979,2011-09-11,Fall,2011,Sep,15,0,Sunday,0,Clear,0.74,0.6667,0.51,0.2985,134,270,404,477,404,404
5980,2011-09-11,Fall,2011,Sep,16,0,Sunday,0,Clear,0.72,0.6667,0.51,0.2985,180,303,483,477,483,483
5981,2011-09-11,Fall,2011,Sep,17,0,Sunday,0,Clear,0.72,0.6667,0.51,0.1343,152,228,380,477,380,380
5982,2011-09-11,Fall,2011,Sep,18,0,Sunday,0,Clear,0.68,0.6364,0.65,0.2985,110,229,339,477,339,339
5983,2011-09-11,Fall,2011,Sep,19,0,Sunday,0,Clear,0.64,0.6061,0.69,0.1045,101,232,333,477,333,333
5984,2011-09-11,Fall,2011,Sep,20,0,Sunday,0,Clear,0.62,0.5909,0.73,0.1045,65,161,226,477,226,226
5985,2011-09-11,Fall,2011,Sep,21,0,Sunday,0,Clear,0.64,0.6061,0.69,0.0,45,114,159,477,159,159
5986,2011-09-11,Fall,2011,Sep,22,0,Sunday,0,Clear,0.62,0.6061,0.69,0.3881,21,74,95,477,95,95
5987,2011-09-11,Fall,2011,Sep,23,0,Sunday,0,Light_rainsnow,0.58,0.5455,0.78,0.0896,12,33,45,477,45,45
5988,2011-09-12,Fall,2011,Sep,0,0,Monday,1,Clear,0.56,0.5303,0.88,0.0896,5,11,16,476,16,16
5989,2011-09-12,Fall,2011,Sep,1,0,Monday,1,Clear,0.56,0.5303,0.88,0.0,1,11,12,476,12,12
5990,2011-09-12,Fall,2011,Sep,2,0,Monday,1,Clear,0.56,0.5303,0.88,0.0,2,0,2,476,2,2
5991,2011-09-12,Fall,2011,Sep,4,0,Monday,1,Clear,0.54,0.5152,0.94,0.1045,0,4,4,476,4,4
5992,2011-09-12,Fall,2011,Sep,5,0,Monday,1,Clear,0.56,0.5303,0.83,0.0,1,23,24,476,24,24
5993,2011-09-12,Fall,2011,Sep,6,0,Monday,1,Clear,0.56,0.5303,0.83,0.0,1,108,109,476,109,109
5994,2011-09-12,Fall,2011,Sep,7,0,Monday,1,Clear,0.58,0.5455,0.83,0.0,12,300,312,476,312,312
5995,2011-09-12,Fall,2011,Sep,8,0,Monday,1,Clear,0.6,0.5758,0.78,0.0896,26,382,408,476,408,408
5996,2011-09-12,Fall,2011,Sep,9,0,Monday,1,Clear,0.64,0.6061,0.69,0.0,21,155,176,476,176,176
5997,2011-09-12,Fall,2011,Sep,10,0,Monday,1,Clear,0.68,0.6364,0.62,0.1642,40,89,129,476,129,129
5998,2011-09-12,Fall,2011,Sep,11,0,Monday,1,Clear,0.7,0.6515,0.58,0.194,34,131,165,476,165,165
5999,2011-09-12,Fall,2011,Sep,12,0,Monday,1,Clear,0.72,0.6667,0.51,0.194,37,147,184,476,184,184
6000,2011-09-12,Fall,2011,Sep,13,0,Monday,1,Clear,0.72,0.6667,0.54,0.1045,43,120,163,476,163,163
6001,2011-09-12,Fall,2011,Sep,14,0,Monday,1,Clear,0.74,0.6667,0.51,0.1642,60,129,189,476,189,189
6002,2011-09-12,Fall,2011,Sep,15,0,Monday,1,Clear,0.74,0.6667,0.48,0.0896,60,152,212,476,212,212
6003,2011-09-12,Fall,2011,Sep,16,0,Monday,1,Clear,0.72,0.6667,0.48,0.0,60,238,298,476,298,298
6004,2011-09-12,Fall,2011,Sep,17,0,Monday,1,Clear,0.72,0.6667,0.51,0.1642,75,515,590,476,590,590
6005,2011-09-12,Fall,2011,Sep,18,0,Monday,1,Clear,0.7,0.6515,0.54,0.194,56,515,571,476,571,571
6006,2011-09-12,Fall,2011,Sep,19,0,Monday,1,Clear,0.68,0.6364,0.57,0.1343,63,373,436,476,436,436
6007,2011-09-12,Fall,2011,Sep,20,0,Monday,1,Clear,0.66,0.6212,0.65,0.0,41,258,299,476,299,299
6008,2011-09-12,Fall,2011,Sep,21,0,Monday,1,Clear,0.64,0.6061,0.73,0.0896,29,166,195,476,195,195
6009,2011-09-12,Fall,2011,Sep,22,0,Monday,1,Clear,0.62,0.5758,0.83,0.1642,16,134,150,476,150,150
6010,2011-09-12,Fall,2011,Sep,23,0,Monday,1,Clear,0.62,0.5758,0.83,0.1045,7,62,69,476,69,69
6011,2011-09-13,Fall,2011,Sep,0,0,Tuesday,1,Clear,0.6,0.5455,0.88,0.1045,7,19,26,475,26,26
6012,2011-09-13,Fall,2011,Sep,1,0,Tuesday,1,Clear,0.58,0.5455,0.83,0.1045,4,6,10,475,10,10
6013,2011-09-13,Fall,2011,Sep,2,0,Tuesday,1,Clear,0.6,0.5758,0.78,0.0,2,0,2,475,2,2
6014,2011-09-13,Fall,2011,Sep,3,0,Tuesday,1,Clear,0.58,0.5455,0.83,0.0,2,2,4,475,4,4
6015,2011-09-13,Fall,2011,Sep,4,0,Tuesday,1,Clear,0.56,0.5303,0.88,0.0,2,6,8,475,8,8
6016,2011-09-13,Fall,2011,Sep,5,0,Tuesday,1,Clear,0.56,0.5303,0.88,0.0,1,19,20,475,20,20
6017,2011-09-13,Fall,2011,Sep,6,0,Tuesday,1,Clear,0.56,0.5303,0.88,0.1045,6,116,122,475,122,122
6018,2011-09-13,Fall,2011,Sep,7,0,Tuesday,1,Clear,0.58,0.5455,0.83,0.0896,14,348,362,475,362,362
6019,2011-09-13,Fall,2011,Sep,8,0,Tuesday,1,Clear,0.6,0.5606,0.81,0.1045,26,399,425,475,425,425
6020,2011-09-13,Fall,2011,Sep,9,0,Tuesday,1,Clear,0.64,0.6061,0.69,0.0896,35,179,214,475,214,214
6021,2011-09-13,Fall,2011,Sep,10,0,Tuesday,1,Clear,0.68,0.6364,0.69,0.1343,42,93,135,475,135,135
6022,2011-09-13,Fall,2011,Sep,11,0,Tuesday,1,Clear,0.7,0.6515,0.61,0.1642,33,120,153,475,153,153
6023,2011-09-13,Fall,2011,Sep,12,0,Tuesday,1,Clear,0.72,0.6667,0.58,0.2239,43,144,187,475,187,187
6024,2011-09-13,Fall,2011,Sep,13,0,Tuesday,1,Clear,0.74,0.6667,0.51,0.2836,48,136,184,475,184,184
6025,2011-09-13,Fall,2011,Sep,14,0,Tuesday,1,Clear,0.74,0.6667,0.51,0.3284,51,139,190,475,190,190
6026,2011-09-13,Fall,2011,Sep,15,0,Tuesday,1,Clear,0.74,0.6667,0.51,0.2985,35,145,180,475,180,180
6027,2011-09-13,Fall,2011,Sep,16,0,Tuesday,1,Clear,0.74,0.6667,0.51,0.2239,41,251,292,475,292,292
6028,2011-09-13,Fall,2011,Sep,17,0,Tuesday,1,Clear,0.74,0.6667,0.51,0.2239,72,507,579,475,579,579
6029,2011-09-13,Fall,2011,Sep,18,0,Tuesday,1,Clear,0.7,0.6515,0.61,0.1642,67,472,539,475,539,539
6030,2011-09-13,Fall,2011,Sep,19,0,Tuesday,1,Clear,0.68,0.6364,0.69,0.1642,55,341,396,475,396,396
6031,2011-09-13,Fall,2011,Sep,20,0,Tuesday,1,Clear,0.66,0.6212,0.74,0.194,31,241,272,475,272,272
6032,2011-09-13,Fall,2011,Sep,21,0,Tuesday,1,Clear,0.64,0.5909,0.78,0.1642,45,200,245,475,245,245
6033,2011-09-13,Fall,2011,Sep,22,0,Tuesday,1,Clear,0.64,0.5909,0.78,0.1343,24,120,144,475,144,144
6034,2011-09-13,Fall,2011,Sep,23,0,Tuesday,1,Clear,0.64,0.5909,0.78,0.1045,15,59,74,475,74,74
6035,2011-09-14,Fall,2011,Sep,0,0,Wednesday,1,Clear,0.62,0.5909,0.78,0.0896,5,28,33,474,33,33
6036,2011-09-14,Fall,2011,Sep,1,0,Wednesday,1,Clear,0.62,0.5909,0.78,0.0896,1,7,8,474,8,8
6037,2011-09-14,Fall,2011,Sep,2,0,Wednesday,1,Clear,0.6,0.5606,0.83,0.0,1,4,5,474,5,5
6038,2011-09-14,Fall,2011,Sep,3,0,Wednesday,1,Clear,0.6,0.5455,0.88,0.1343,1,7,8,474,8,8
6039,2011-09-14,Fall,2011,Sep,4,0,Wednesday,1,Clear,0.6,0.5606,0.83,0.0896,1,8,9,474,9,9
6040,2011-09-14,Fall,2011,Sep,5,0,Wednesday,1,Clear,0.58,0.5455,0.88,0.1045,1,30,31,474,31,31
6041,2011-09-14,Fall,2011,Sep,6,0,Wednesday,1,Clear,0.58,0.5455,0.88,0.1045,7,138,145,474,145,145
6042,2011-09-14,Fall,2011,Sep,7,0,Wednesday,1,Clear,0.6,0.5606,0.83,0.1045,20,350,370,474,370,370
6043,2011-09-14,Fall,2011,Sep,8,0,Wednesday,1,Clear,0.62,0.5758,0.83,0.1642,33,396,429,474,429,429
6044,2011-09-14,Fall,2011,Sep,9,0,Wednesday,1,Clear,0.64,0.5909,0.78,0.1642,19,183,202,474,202,202
6045,2011-09-14,Fall,2011,Sep,10,0,Wednesday,1,Clear,0.7,0.6515,0.7,0.1343,27,115,142,474,142,142
6046,2011-09-14,Fall,2011,Sep,11,0,Wednesday,1,Clear,0.72,0.6818,0.66,0.1642,43,121,164,474,164,164
6047,2011-09-14,Fall,2011,Sep,12,0,Wednesday,1,Clear,0.74,0.6818,0.58,0.2239,56,156,212,474,212,212
6048,2011-09-14,Fall,2011,Sep,13,0,Wednesday,1,Clear,0.76,0.697,0.55,0.2537,39,139,178,474,178,178
6049,2011-09-14,Fall,2011,Sep,14,0,Wednesday,1,Clear,0.78,0.7121,0.52,0.2239,19,105,124,474,124,124
6050,2011-09-14,Fall,2011,Sep,15,0,Wednesday,1,Clear,0.78,0.7121,0.49,0.2537,30,146,176,474,176,176
6051,2011-09-14,Fall,2011,Sep,16,0,Wednesday,1,Clear,0.76,0.697,0.52,0.2836,36,241,277,474,277,277
6052,2011-09-14,Fall,2011,Sep,17,0,Wednesday,1,Clear,0.76,0.697,0.52,0.2836,87,512,599,474,599,599
6053,2011-09-14,Fall,2011,Sep,18,0,Wednesday,1,Clear,0.72,0.6818,0.62,0.1642,83,503,586,474,586,586
6054,2011-09-14,Fall,2011,Sep,19,0,Wednesday,1,Misty,0.7,0.6515,0.7,0.1045,44,337,381,474,381,381
6055,2011-09-14,Fall,2011,Sep,20,0,Wednesday,1,Misty,0.72,0.6667,0.58,0.4179,40,221,261,474,261,261
6056,2011-09-14,Fall,2011,Sep,21,0,Wednesday,1,Misty,0.66,0.6212,0.65,0.2239,24,189,213,474,213,213
6057,2011-09-14,Fall,2011,Sep,22,0,Wednesday,1,Misty,0.66,0.6212,0.65,0.1343,20,140,160,474,160,160
6058,2011-09-14,Fall,2011,Sep,23,0,Wednesday,1,Misty,0.64,0.6061,0.69,0.1045,10,62,72,474,72,72
6059,2011-09-15,Fall,2011,Sep,0,0,Thursday,1,Clear,0.64,0.6061,0.69,0.1343,3,34,37,473,37,37
6060,2011-09-15,Fall,2011,Sep,1,0,Thursday,1,Clear,0.64,0.6061,0.69,0.1642,0,20,20,473,20,20
6061,2011-09-15,Fall,2011,Sep,2,0,Thursday,1,Clear,0.62,0.5909,0.73,0.1045,0,5,5,473,5,5
6062,2011-09-15,Fall,2011,Sep,3,0,Thursday,1,Clear,0.62,0.5909,0.73,0.0896,3,5,8,473,8,8
6063,2011-09-15,Fall,2011,Sep,4,0,Thursday,1,Clear,0.6,0.5758,0.78,0.1045,2,5,7,473,7,7
6064,2011-09-15,Fall,2011,Sep,5,0,Thursday,1,Clear,0.6,0.5758,0.78,0.0,1,30,31,473,31,31
6065,2011-09-15,Fall,2011,Sep,6,0,Thursday,1,Misty,0.6,0.5606,0.83,0.2537,5,119,124,473,124,124
6066,2011-09-15,Fall,2011,Sep,7,0,Thursday,1,Misty,0.62,0.5909,0.78,0.194,17,321,338,473,338,338
6067,2011-09-15,Fall,2011,Sep,8,0,Thursday,1,Clear,0.64,0.6061,0.73,0.1343,27,364,391,473,391,391
6068,2011-09-15,Fall,2011,Sep,9,0,Thursday,1,Misty,0.64,0.6061,0.73,0.3582,23,186,209,473,209,209
6069,2011-09-15,Fall,2011,Sep,10,0,Thursday,1,Misty,0.66,0.6212,0.69,0.2537,25,96,121,473,121,121
6070,2011-09-15,Fall,2011,Sep,11,0,Thursday,1,Misty,0.68,0.6364,0.65,0.1343,39,120,159,473,159,159
6071,2011-09-15,Fall,2011,Sep,12,0,Thursday,1,Misty,0.66,0.6212,0.69,0.2985,31,148,179,473,179,179
6072,2011-09-15,Fall,2011,Sep,13,0,Thursday,1,Misty,0.64,0.6061,0.65,0.2836,38,151,189,473,189,189
6073,2011-09-15,Fall,2011,Sep,14,0,Thursday,1,Misty,0.64,0.6061,0.65,0.4179,36,134,170,473,170,170
6074,2011-09-15,Fall,2011,Sep,15,0,Thursday,1,Misty,0.6,0.5909,0.69,0.4179,25,110,135,473,135,135
6075,2011-09-15,Fall,2011,Sep,16,0,Thursday,1,Misty,0.54,0.5152,0.77,0.4627,29,193,222,473,222,222
6076,2011-09-15,Fall,2011,Sep,17,0,Thursday,1,Light_rainsnow,0.48,0.4697,0.82,0.4627,31,230,261,473,261,261
6077,2011-09-15,Fall,2011,Sep,18,0,Thursday,1,Light_rainsnow,0.48,0.4697,0.67,0.6119,22,222,244,473,244,244
6078,2011-09-15,Fall,2011,Sep,19,0,Thursday,1,Clear,0.46,0.4545,0.67,0.4627,20,212,232,473,232,232
6079,2011-09-15,Fall,2011,Sep,20,0,Thursday,1,Clear,0.46,0.4545,0.63,0.3284,25,223,248,473,248,248
6080,2011-09-15,Fall,2011,Sep,21,0,Thursday,1,Clear,0.46,0.4545,0.63,0.3284,11,134,145,473,145,145
6081,2011-09-15,Fall,2011,Sep,22,0,Thursday,1,Clear,0.44,0.4394,0.67,0.2836,7,108,115,473,115,115
6082,2011-09-15,Fall,2011,Sep,23,0,Thursday,1,Clear,0.44,0.4394,0.67,0.2239,8,61,69,473,69,69
6083,2011-09-16,Fall,2011,Sep,0,0,Friday,1,Clear,0.42,0.4242,0.71,0.2239,5,43,48,472,48,48
6084,2011-09-16,Fall,2011,Sep,1,0,Friday,1,Clear,0.42,0.4242,0.67,0.194,7,19,26,472,26,26
6085,2011-09-16,Fall,2011,Sep,2,0,Friday,1,Clear,0.4,0.4091,0.71,0.2836,3,7,10,472,10,10
6086,2011-09-16,Fall,2011,Sep,3,0,Friday,1,Clear,0.4,0.4091,0.71,0.2537,2,4,6,472,6,6
6087,2011-09-16,Fall,2011,Sep,4,0,Friday,1,Clear,0.4,0.4091,0.71,0.2836,1,3,4,472,4,4
6088,2011-09-16,Fall,2011,Sep,5,0,Friday,1,Clear,0.38,0.3939,0.76,0.194,2,30,32,472,32,32
6089,2011-09-16,Fall,2011,Sep,6,0,Friday,1,Clear,0.38,0.3939,0.71,0.2239,6,87,93,472,93,93
6090,2011-09-16,Fall,2011,Sep,7,0,Friday,1,Clear,0.4,0.4091,0.71,0.2836,16,283,299,472,299,299
6091,2011-09-16,Fall,2011,Sep,8,0,Friday,1,Clear,0.42,0.4242,0.67,0.2239,23,386,409,472,409,409
6092,2011-09-16,Fall,2011,Sep,9,0,Friday,1,Clear,0.46,0.4545,0.55,0.2537,21,189,210,472,210,210
6093,2011-09-16,Fall,2011,Sep,10,0,Friday,1,Misty,0.5,0.4848,0.51,0.2836,36,104,140,472,140,140
6094,2011-09-16,Fall,2011,Sep,11,0,Friday,1,Misty,0.5,0.4848,0.51,0.1343,40,139,179,472,179,179
6095,2011-09-16,Fall,2011,Sep,12,0,Friday,1,Misty,0.52,0.5,0.45,0.0,39,212,251,472,251,251
6096,2011-09-16,Fall,2011,Sep,13,0,Friday,1,Misty,0.54,0.5152,0.42,0.0,55,168,223,472,223,223
6097,2011-09-16,Fall,2011,Sep,14,0,Friday,1,Misty,0.54,0.5152,0.45,0.1642,49,176,225,472,225,225
6098,2011-09-16,Fall,2011,Sep,15,0,Friday,1,Misty,0.54,0.5152,0.45,0.2239,38,165,203,472,203,203
6099,2011-09-16,Fall,2011,Sep,16,0,Friday,1,Misty,0.52,0.5,0.48,0.1642,67,291,358,472,358,358
6100,2011-09-16,Fall,2011,Sep,17,0,Friday,1,Misty,0.52,0.5,0.48,0.1343,86,480,566,472,566,566
6101,2011-09-16,Fall,2011,Sep,18,0,Friday,1,Misty,0.52,0.5,0.52,0.1642,55,427,482,472,482,482
6102,2011-09-16,Fall,2011,Sep,19,0,Friday,1,Misty,0.5,0.4848,0.55,0.1642,59,256,315,472,315,315
6103,2011-09-16,Fall,2011,Sep,20,0,Friday,1,Misty,0.5,0.4848,0.55,0.0,41,184,225,472,225,225
6104,2011-09-16,Fall,2011,Sep,21,0,Friday,1,Misty,0.5,0.4848,0.63,0.0,39,124,163,472,163,163
6105,2011-09-16,Fall,2011,Sep,22,0,Friday,1,Clear,0.48,0.4697,0.67,0.0896,32,135,167,472,167,167
6106,2011-09-16,Fall,2011,Sep,23,0,Friday,1,Clear,0.5,0.4848,0.59,0.0,20,106,126,472,126,126
6107,2011-09-17,Fall,2011,Sep,0,0,Saturday,0,Clear,0.46,0.4545,0.72,0.1642,28,80,108,471,108,108
6108,2011-09-17,Fall,2011,Sep,1,0,Saturday,0,Clear,0.46,0.4545,0.72,0.1045,28,52,80,471,80,80
6109,2011-09-17,Fall,2011,Sep,2,0,Saturday,0,Clear,0.46,0.4545,0.82,0.0896,18,61,79,471,79,79
6110,2011-09-17,Fall,2011,Sep,3,0,Saturday,0,Clear,0.46,0.4545,0.72,0.1343,7,21,28,471,28,28
6111,2011-09-17,Fall,2011,Sep,4,0,Saturday,0,Clear,0.46,0.4545,0.72,0.1343,1,4,5,471,5,5
6112,2011-09-17,Fall,2011,Sep,5,0,Saturday,0,Clear,0.46,0.4545,0.72,0.1642,2,3,5,471,5,5
6113,2011-09-17,Fall,2011,Sep,6,0,Saturday,0,Misty,0.46,0.4545,0.72,0.2239,5,17,22,471,22,22
6114,2011-09-17,Fall,2011,Sep,7,0,Saturday,0,Misty,0.46,0.4545,0.77,0.194,4,33,37,471,37,37
6115,2011-09-17,Fall,2011,Sep,8,0,Saturday,0,Misty,0.46,0.4545,0.77,0.2537,27,81,108,471,108,108
6116,2011-09-17,Fall,2011,Sep,9,0,Saturday,0,Misty,0.48,0.4697,0.67,0.2239,32,145,177,471,177,177
6117,2011-09-17,Fall,2011,Sep,10,0,Saturday,0,Misty,0.5,0.4848,0.68,0.2836,72,177,249,471,249,249
6118,2011-09-17,Fall,2011,Sep,11,0,Saturday,0,Misty,0.52,0.5,0.68,0.2239,119,248,367,471,367,367
6119,2011-09-17,Fall,2011,Sep,12,0,Saturday,0,Misty,0.52,0.5,0.67,0.2239,115,257,372,471,372,372
6120,2011-09-17,Fall,2011,Sep,13,0,Saturday,0,Misty,0.52,0.5,0.68,0.194,124,225,349,471,349,349
6121,2011-09-17,Fall,2011,Sep,14,0,Saturday,0,Misty,0.52,0.5,0.72,0.194,123,174,297,471,297,297
6122,2011-09-17,Fall,2011,Sep,15,0,Saturday,0,Misty,0.52,0.5,0.72,0.194,148,206,354,471,354,354
6123,2011-09-17,Fall,2011,Sep,16,0,Saturday,0,Clear,0.54,0.5152,0.68,0.2537,116,189,305,471,305,305
6124,2011-09-17,Fall,2011,Sep,17,0,Saturday,0,Clear,0.52,0.5,0.72,0.2239,141,218,359,471,359,359
6125,2011-09-17,Fall,2011,Sep,18,0,Saturday,0,Misty,0.52,0.5,0.72,0.2239,95,234,329,471,329,329
6126,2011-09-17,Fall,2011,Sep,19,0,Saturday,0,Clear,0.52,0.5,0.68,0.1343,70,186,256,471,256,256
6127,2011-09-17,Fall,2011,Sep,20,0,Saturday,0,Clear,0.52,0.5,0.68,0.1343,43,133,176,471,176,176
6128,2011-09-17,Fall,2011,Sep,21,0,Saturday,0,Misty,0.5,0.4848,0.72,0.194,49,121,170,471,170,170
6129,2011-09-17,Fall,2011,Sep,22,0,Saturday,0,Clear,0.5,0.4848,0.72,0.2239,31,112,143,471,143,143
6130,2011-09-17,Fall,2011,Sep,23,0,Saturday,0,Clear,0.46,0.4545,0.82,0.1642,36,100,136,471,136,136
6131,2011-09-18,Fall,2011,Sep,0,0,Sunday,0,Clear,0.46,0.4545,0.77,0.2239,24,88,112,470,112,112
6132,2011-09-18,Fall,2011,Sep,1,0,Sunday,0,Clear,0.46,0.4545,0.77,0.2239,13,66,79,470,79,79
6133,2011-09-18,Fall,2011,Sep,2,0,Sunday,0,Clear,0.44,0.4394,0.82,0.2537,21,68,89,470,89,89
6134,2011-09-18,Fall,2011,Sep,3,0,Sunday,0,Clear,0.44,0.4394,0.82,0.194,11,25,36,470,36,36
6135,2011-09-18,Fall,2011,Sep,4,0,Sunday,0,Clear,0.44,0.4394,0.77,0.2239,1,0,1,470,1,1
6136,2011-09-18,Fall,2011,Sep,5,0,Sunday,0,Clear,0.44,0.4394,0.77,0.2239,1,5,6,470,6,6
6137,2011-09-18,Fall,2011,Sep,6,0,Sunday,0,Clear,0.44,0.4394,0.77,0.2537,2,10,12,470,12,12
6138,2011-09-18,Fall,2011,Sep,7,0,Sunday,0,Clear,0.46,0.4545,0.72,0.2239,15,29,44,470,44,44
6139,2011-09-18,Fall,2011,Sep,8,0,Sunday,0,Clear,0.46,0.4545,0.72,0.2537,16,53,69,470,69,69
6140,2011-09-18,Fall,2011,Sep,9,0,Sunday,0,Clear,0.48,0.4697,0.67,0.2537,46,94,140,470,140,140
6141,2011-09-18,Fall,2011,Sep,10,0,Sunday,0,Clear,0.5,0.4848,0.72,0.1642,82,178,260,470,260,260
6142,2011-09-18,Fall,2011,Sep,11,0,Sunday,0,Clear,0.52,0.5,0.68,0.2239,116,201,317,470,317,317
6143,2011-09-18,Fall,2011,Sep,12,0,Sunday,0,Clear,0.54,0.5152,0.64,0.1343,135,229,364,470,364,364
6144,2011-09-18,Fall,2011,Sep,13,0,Sunday,0,Clear,0.56,0.5303,0.6,0.1343,162,214,376,470,376,376
6145,2011-09-18,Fall,2011,Sep,14,0,Sunday,0,Misty,0.58,0.5455,0.56,0.1343,127,184,311,470,311,311
6146,2011-09-18,Fall,2011,Sep,15,0,Sunday,0,Misty,0.58,0.5455,0.6,0.1343,132,233,365,470,365,365
6147,2011-09-18,Fall,2011,Sep,16,0,Sunday,0,Misty,0.56,0.5303,0.64,0.1642,134,235,369,470,369,369
6148,2011-09-18,Fall,2011,Sep,17,0,Sunday,0,Misty,0.56,0.5303,0.64,0.194,95,230,325,470,325,325
6149,2011-09-18,Fall,2011,Sep,18,0,Sunday,0,Misty,0.56,0.5303,0.6,0.1045,66,223,289,470,289,289
6150,2011-09-18,Fall,2011,Sep,19,0,Sunday,0,Misty,0.54,0.5152,0.68,0.1045,54,191,245,470,245,245
6151,2011-09-18,Fall,2011,Sep,20,0,Sunday,0,Misty,0.54,0.5152,0.68,0.0896,44,136,180,470,180,180
6152,2011-09-18,Fall,2011,Sep,21,0,Sunday,0,Misty,0.54,0.5152,0.68,0.0896,37,110,147,470,147,147
6153,2011-09-18,Fall,2011,Sep,22,0,Sunday,0,Misty,0.54,0.5152,0.68,0.0896,9,75,84,470,84,84
6154,2011-09-18,Fall,2011,Sep,23,0,Sunday,0,Clear,0.54,0.5152,0.68,0.194,10,44,54,470,54,54
6155,2011-09-19,Fall,2011,Sep,0,0,Monday,1,Misty,0.52,0.5,0.72,0.1642,14,23,37,469,37,37
6156,2011-09-19,Fall,2011,Sep,1,0,Monday,1,Misty,0.52,0.5,0.72,0.1045,3,7,10,469,10,10
6157,2011-09-19,Fall,2011,Sep,2,0,Monday,1,Misty,0.52,0.5,0.72,0.1343,6,7,13,469,13,13
6158,2011-09-19,Fall,2011,Sep,3,0,Monday,1,Misty,0.5,0.4848,0.77,0.1343,1,4,5,469,5,5
6159,2011-09-19,Fall,2011,Sep,4,0,Monday,1,Misty,0.5,0.4848,0.77,0.1642,2,6,8,469,8,8
6160,2011-09-19,Fall,2011,Sep,5,0,Monday,1,Misty,0.5,0.4848,0.77,0.194,2,26,28,469,28,28
6161,2011-09-19,Fall,2011,Sep,6,0,Monday,1,Clear,0.5,0.4848,0.77,0.2239,6,107,113,469,113,113
6162,2011-09-19,Fall,2011,Sep,7,0,Monday,1,Misty,0.5,0.4848,0.82,0.2239,20,312,332,469,332,332
6163,2011-09-19,Fall,2011,Sep,8,0,Monday,1,Misty,0.52,0.5,0.77,0.1343,29,391,420,469,420,420
6164,2011-09-19,Fall,2011,Sep,9,0,Monday,1,Misty,0.54,0.5152,0.68,0.1642,32,183,215,469,215,215
6165,2011-09-19,Fall,2011,Sep,10,0,Monday,1,Misty,0.56,0.5303,0.64,0.1343,21,84,105,469,105,105
6166,2011-09-19,Fall,2011,Sep,11,0,Monday,1,Misty,0.58,0.5455,0.64,0.1642,41,98,139,469,139,139
6167,2011-09-19,Fall,2011,Sep,12,0,Monday,1,Misty,0.58,0.5455,0.6,0.0896,51,138,189,469,189,189
6168,2011-09-19,Fall,2011,Sep,13,0,Monday,1,Misty,0.6,0.6061,0.6,0.0,53,124,177,469,177,177
6169,2011-09-19,Fall,2011,Sep,14,0,Monday,1,Misty,0.6,0.6061,0.6,0.194,45,143,188,469,188,188
6170,2011-09-19,Fall,2011,Sep,15,0,Monday,1,Misty,0.6,0.6061,0.6,0.2239,44,143,187,469,187,187
6171,2011-09-19,Fall,2011,Sep,16,0,Monday,1,Misty,0.6,0.6061,0.6,0.1642,55,208,263,469,263,263
6172,2011-09-19,Fall,2011,Sep,17,0,Monday,1,Misty,0.58,0.5455,0.64,0.1343,85,483,568,469,568,568
6173,2011-09-19,Fall,2011,Sep,18,0,Monday,1,Misty,0.56,0.5303,0.68,0.1343,56,484,540,469,540,540
6174,2011-09-19,Fall,2011,Sep,19,0,Monday,1,Misty,0.56,0.5303,0.68,0.1045,41,333,374,469,374,374
6175,2011-09-19,Fall,2011,Sep,20,0,Monday,1,Misty,0.56,0.5303,0.68,0.1343,27,204,231,469,231,231
6176,2011-09-19,Fall,2011,Sep,21,0,Monday,1,Misty,0.56,0.5303,0.68,0.1642,19,181,200,469,200,200
6177,2011-09-19,Fall,2011,Sep,22,0,Monday,1,Misty,0.56,0.5303,0.68,0.1642,25,104,129,469,129,129
6178,2011-09-19,Fall,2011,Sep,23,0,Monday,1,Misty,0.56,0.5303,0.73,0.194,13,55,68,469,68,68
6179,2011-09-20,Fall,2011,Sep,0,0,Tuesday,1,Misty,0.56,0.5303,0.73,0.1642,4,21,25,468,25,25
6180,2011-09-20,Fall,2011,Sep,1,0,Tuesday,1,Misty,0.54,0.5152,0.88,0.1642,3,11,14,468,14,14
6181,2011-09-20,Fall,2011,Sep,2,0,Tuesday,1,Misty,0.54,0.5152,0.88,0.1642,1,4,5,468,5,5
6182,2011-09-20,Fall,2011,Sep,3,0,Tuesday,1,Misty,0.54,0.5152,0.83,0.2239,0,3,3,468,3,3
6183,2011-09-20,Fall,2011,Sep,4,0,Tuesday,1,Clear,0.54,0.5152,0.88,0.194,2,4,6,468,6,6
6184,2011-09-20,Fall,2011,Sep,5,0,Tuesday,1,Misty,0.54,0.5152,0.88,0.194,1,21,22,468,22,22
6185,2011-09-20,Fall,2011,Sep,6,0,Tuesday,1,Misty,0.54,0.5152,0.88,0.194,3,111,114,468,114,114
6186,2011-09-20,Fall,2011,Sep,7,0,Tuesday,1,Misty,0.54,0.5152,0.88,0.1642,23,306,329,468,329,329
6187,2011-09-20,Fall,2011,Sep,8,0,Tuesday,1,Light_rainsnow,0.54,0.5152,0.94,0.2537,13,196,209,468,209,209
6188,2011-09-20,Fall,2011,Sep,9,0,Tuesday,1,Light_rainsnow,0.54,0.5152,0.94,0.2239,5,64,69,468,69,69
6189,2011-09-20,Fall,2011,Sep,10,0,Tuesday,1,Light_rainsnow,0.56,0.5303,0.88,0.1642,4,26,30,468,30,30
6190,2011-09-20,Fall,2011,Sep,11,0,Tuesday,1,Light_rainsnow,0.56,0.5303,0.88,0.1642,8,48,56,468,56,56
6191,2011-09-20,Fall,2011,Sep,12,0,Tuesday,1,Misty,0.56,0.5303,0.94,0.1642,13,47,60,468,60,60
6192,2011-09-20,Fall,2011,Sep,13,0,Tuesday,1,Misty,0.56,0.5303,0.94,0.1343,22,81,103,468,103,103
6193,2011-09-20,Fall,2011,Sep,14,0,Tuesday,1,Misty,0.58,0.5455,0.88,0.194,27,85,112,468,112,112
6194,2011-09-20,Fall,2011,Sep,15,0,Tuesday,1,Misty,0.62,0.5909,0.78,0.1045,34,158,192,468,192,192
6195,2011-09-20,Fall,2011,Sep,16,0,Tuesday,1,Misty,0.6,0.5606,0.83,0.1642,23,241,264,468,264,264
6196,2011-09-20,Fall,2011,Sep,17,0,Tuesday,1,Clear,0.6,0.5606,0.83,0.1045,66,445,511,468,511,511
6197,2011-09-20,Fall,2011,Sep,18,0,Tuesday,1,Clear,0.6,0.5606,0.83,0.1045,39,453,492,468,492,492
6198,2011-09-20,Fall,2011,Sep,19,0,Tuesday,1,Clear,0.58,0.5455,0.88,0.0,43,294,337,468,337,337
6199,2011-09-20,Fall,2011,Sep,20,0,Tuesday,1,Clear,0.56,0.5303,0.94,0.0,41,212,253,468,253,253
6200,2011-09-20,Fall,2011,Sep,21,0,Tuesday,1,Clear,0.56,0.5303,0.94,0.0,29,177,206,468,206,206
6201,2011-09-20,Fall,2011,Sep,22,0,Tuesday,1,Clear,0.56,0.5303,0.94,0.0,23,125,148,468,148,148
6202,2011-09-20,Fall,2011,Sep,23,0,Tuesday,1,Clear,0.56,0.5303,0.94,0.0,11,70,81,468,81,81
6203,2011-09-21,Fall,2011,Sep,0,0,Wednesday,1,Clear,0.54,0.5152,1.0,0.0,7,20,27,467,27,27
6204,2011-09-21,Fall,2011,Sep,1,0,Wednesday,1,Clear,0.54,0.5152,0.94,0.0,0,17,17,467,17,17
6205,2011-09-21,Fall,2011,Sep,2,0,Wednesday,1,Clear,0.54,0.5152,0.94,0.0,1,5,6,467,6,6
6206,2011-09-21,Fall,2011,Sep,3,0,Wednesday,1,Misty,0.54,0.5152,0.94,0.0896,0,6,6,467,6,6
6207,2011-09-21,Fall,2011,Sep,4,0,Wednesday,1,Misty,0.54,0.5152,1.0,0.1343,2,5,7,467,7,7
6208,2011-09-21,Fall,2011,Sep,5,0,Wednesday,1,Misty,0.54,0.5152,1.0,0.1642,1,30,31,467,31,31
6209,2011-09-21,Fall,2011,Sep,6,0,Wednesday,1,Misty,0.54,0.5152,1.0,0.194,5,112,117,467,117,117
6210,2011-09-21,Fall,2011,Sep,7,0,Wednesday,1,Misty,0.54,0.5152,1.0,0.194,18,312,330,467,330,330
6211,2011-09-21,Fall,2011,Sep,8,0,Wednesday,1,Misty,0.54,0.5152,1.0,0.1045,18,444,462,467,462,462
6212,2011-09-21,Fall,2011,Sep,9,0,Wednesday,1,Misty,0.56,0.5303,1.0,0.0896,21,187,208,467,208,208
6213,2011-09-21,Fall,2011,Sep,10,0,Wednesday,1,Misty,0.6,0.5455,0.88,0.0,30,103,133,467,133,133
6214,2011-09-21,Fall,2011,Sep,11,0,Wednesday,1,Misty,0.62,0.5758,0.83,0.1642,42,138,180,467,180,180
6215,2011-09-21,Fall,2011,Sep,12,0,Wednesday,1,Misty,0.64,0.5909,0.78,0.0896,42,151,193,467,193,193
6216,2011-09-21,Fall,2011,Sep,13,0,Wednesday,1,Misty,0.66,0.6212,0.74,0.1642,37,144,181,467,181,181
6217,2011-09-21,Fall,2011,Sep,14,0,Wednesday,1,Misty,0.66,0.6212,0.74,0.194,40,139,179,467,179,179
6218,2011-09-21,Fall,2011,Sep,15,0,Wednesday,1,Misty,0.66,0.6212,0.74,0.1045,43,142,185,467,185,185
6219,2011-09-21,Fall,2011,Sep,16,0,Wednesday,1,Misty,0.66,0.6212,0.74,0.1045,51,230,281,467,281,281
6220,2011-09-21,Fall,2011,Sep,17,0,Wednesday,1,Light_rainsnow,0.66,0.6212,0.74,0.1642,61,475,536,467,536,536
6221,2011-09-21,Fall,2011,Sep,18,0,Wednesday,1,Light_rainsnow,0.64,0.5758,0.83,0.1642,24,384,408,467,408,408
6222,2011-09-21,Fall,2011,Sep,19,0,Wednesday,1,Light_rainsnow,0.62,0.5455,0.94,0.0,30,253,283,467,283,283
6223,2011-09-21,Fall,2011,Sep,20,0,Wednesday,1,Light_rainsnow,0.62,0.5455,0.94,0.0,11,149,160,467,160,160
6224,2011-09-21,Fall,2011,Sep,21,0,Wednesday,1,Misty,0.6,0.5,1.0,0.0896,25,175,200,467,200,200
6225,2011-09-21,Fall,2011,Sep,22,0,Wednesday,1,Misty,0.62,0.5455,0.94,0.0,15,112,127,467,127,127
6226,2011-09-21,Fall,2011,Sep,23,0,Wednesday,1,Clear,0.6,0.5152,0.94,0.1045,15,80,95,467,95,95
6227,2011-09-22,Fall,2011,Sep,0,0,Thursday,1,Clear,0.6,0.5152,0.94,0.1045,11,30,41,466,41,41
6228,2011-09-22,Fall,2011,Sep,1,0,Thursday,1,Misty,0.6,0.5152,0.94,0.0896,5,6,11,466,11,11
6229,2011-09-22,Fall,2011,Sep,2,0,Thursday,1,Misty,0.6,0.5152,0.94,0.1045,2,8,10,466,10,10
6230,2011-09-22,Fall,2011,Sep,3,0,Thursday,1,Misty,0.6,0.5152,0.94,0.0896,5,7,12,466,12,12
6231,2011-09-22,Fall,2011,Sep,4,0,Thursday,1,Misty,0.6,0.5152,0.94,0.0896,0,2,2,466,2,2
6232,2011-09-22,Fall,2011,Sep,5,0,Thursday,1,Misty,0.6,0.5152,0.94,0.1045,2,28,30,466,30,30
6233,2011-09-22,Fall,2011,Sep,6,0,Thursday,1,Misty,0.6,0.5,1.0,0.1343,7,94,101,466,101,101
6234,2011-09-22,Fall,2011,Sep,7,0,Thursday,1,Misty,0.6,0.5,1.0,0.1045,16,295,311,466,311,311
6235,2011-09-22,Fall,2011,Sep,8,0,Thursday,1,Misty,0.6,0.5,1.0,0.1642,26,389,415,466,415,415
6236,2011-09-22,Fall,2011,Sep,9,0,Thursday,1,Misty,0.62,0.5455,0.94,0.194,35,168,203,466,203,203
6237,2011-09-22,Fall,2011,Sep,10,0,Thursday,1,Misty,0.64,0.5758,0.89,0.2239,19,101,120,466,120,120
6238,2011-09-22,Fall,2011,Sep,11,0,Thursday,1,Misty,0.64,0.5758,0.89,0.194,23,142,165,466,165,165
6239,2011-09-22,Fall,2011,Sep,12,0,Thursday,1,Misty,0.66,0.6061,0.83,0.1642,25,151,176,466,176,176
6240,2011-09-22,Fall,2011,Sep,13,0,Thursday,1,Misty,0.66,0.6061,0.83,0.194,38,155,193,466,193,193
6241,2011-09-22,Fall,2011,Sep,14,0,Thursday,1,Misty,0.66,0.6061,0.83,0.2239,41,142,183,466,183,183
6242,2011-09-22,Fall,2011,Sep,15,0,Thursday,1,Misty,0.68,0.6364,0.79,0.1642,32,149,181,466,181,181
6243,2011-09-22,Fall,2011,Sep,16,0,Thursday,1,Misty,0.68,0.6364,0.74,0.1343,39,262,301,466,301,301
6244,2011-09-22,Fall,2011,Sep,17,0,Thursday,1,Misty,0.66,0.6061,0.78,0.0896,50,513,563,466,563,563
6245,2011-09-22,Fall,2011,Sep,18,0,Thursday,1,Misty,0.64,0.5758,0.83,0.1045,50,501,551,466,551,551
6246,2011-09-22,Fall,2011,Sep,19,0,Thursday,1,Misty,0.64,0.5758,0.89,0.0896,32,388,420,466,420,420
6247,2011-09-22,Fall,2011,Sep,20,0,Thursday,1,Misty,0.62,0.5455,0.94,0.1343,35,250,285,466,285,285
6248,2011-09-22,Fall,2011,Sep,21,0,Thursday,1,Misty,0.64,0.5758,0.89,0.0896,27,194,221,466,221,221
6249,2011-09-22,Fall,2011,Sep,22,0,Thursday,1,Misty,0.62,0.5152,1.0,0.0896,21,166,187,466,187,187
6250,2011-09-22,Fall,2011,Sep,23,0,Thursday,1,Misty,0.62,0.5455,0.94,0.0,14,99,113,466,113,113
6251,2011-09-23,Winter,2011,Sep,0,0,Friday,1,Misty,0.62,0.5455,0.94,0.0896,11,41,52,465,52,52
6252,2011-09-23,Winter,2011,Sep,1,0,Friday,1,Misty,0.6,0.5,1.0,0.0,2,29,31,465,31,31
6253,2011-09-23,Winter,2011,Sep,2,0,Friday,1,Misty,0.6,0.5,1.0,0.1045,6,14,20,465,20,20
6254,2011-09-23,Winter,2011,Sep,3,0,Friday,1,Misty,0.6,0.5,1.0,0.0,3,5,8,465,8,8
6255,2011-09-23,Winter,2011,Sep,4,0,Friday,1,Light_rainsnow,0.6,0.5,1.0,0.0,6,7,13,465,13,13
6256,2011-09-23,Winter,2011,Sep,5,0,Friday,1,Misty,0.62,0.5455,0.94,0.0,2,20,22,465,22,22
6257,2011-09-23,Winter,2011,Sep,6,0,Friday,1,Misty,0.62,0.5455,0.94,0.0896,5,99,104,465,104,104
6258,2011-09-23,Winter,2011,Sep,7,0,Friday,1,Light_rainsnow,0.62,0.5455,0.94,0.1343,14,240,254,465,254,254
6259,2011-09-23,Winter,2011,Sep,8,0,Friday,1,Light_rainsnow,0.62,0.5455,0.94,0.1343,20,297,317,465,317,317
6260,2011-09-23,Winter,2011,Sep,9,0,Friday,1,Light_rainsnow,0.62,0.5152,1.0,0.1343,3,108,111,465,111,111
6261,2011-09-23,Winter,2011,Sep,10,0,Friday,1,Light_rainsnow,0.62,0.5152,1.0,0.1045,7,28,35,465,35,35
6262,2011-09-23,Winter,2011,Sep,11,0,Friday,1,Light_rainsnow,0.62,0.5152,1.0,0.1045,1,20,21,465,21,21
6263,2011-09-23,Winter,2011,Sep,12,0,Friday,1,Light_rainsnow,0.62,0.5455,0.94,0.1045,1,28,29,465,29,29
6264,2011-09-23,Winter,2011,Sep,13,0,Friday,1,Light_rainsnow,0.6,0.5,1.0,0.0896,7,27,34,465,34,34
6265,2011-09-23,Winter,2011,Sep,14,0,Friday,1,Light_rainsnow,0.6,0.5,1.0,0.0896,3,21,24,465,24,24
6266,2011-09-23,Winter,2011,Sep,15,0,Friday,1,Light_rainsnow,0.62,0.5455,0.94,0.1045,9,52,61,465,61,61
6267,2011-09-23,Winter,2011,Sep,16,0,Friday,1,Light_rainsnow,0.62,0.5455,0.94,0.0,5,51,56,465,56,56
6268,2011-09-23,Winter,2011,Sep,17,0,Friday,1,Misty,0.6,0.5,1.0,0.0,13,86,99,465,99,99
6269,2011-09-23,Winter,2011,Sep,18,0,Friday,1,Clear,0.6,0.5,1.0,0.0,14,220,234,465,234,234
6270,2011-09-23,Winter,2011,Sep,19,0,Friday,1,Clear,0.62,0.5455,0.94,0.1343,16,232,248,465,248,248
6271,2011-09-23,Winter,2011,Sep,20,0,Friday,1,Clear,0.6,0.5152,0.94,0.0,21,158,179,465,179,179
6272,2011-09-23,Winter,2011,Sep,21,0,Friday,1,Clear,0.6,0.5,1.0,0.1642,17,121,138,465,138,138
6273,2011-09-23,Winter,2011,Sep,22,0,Friday,1,Clear,0.6,0.5152,0.94,0.1642,31,126,157,465,157,157
6274,2011-09-23,Winter,2011,Sep,23,0,Friday,1,Misty,0.58,0.5455,1.0,0.1343,41,107,148,465,148,148
6275,2011-09-24,Winter,2011,Sep,0,0,Saturday,0,Clear,0.58,0.5455,1.0,0.0896,7,86,93,464,93,93
6276,2011-09-24,Winter,2011,Sep,1,0,Saturday,0,Misty,0.58,0.5455,0.94,0.0896,18,61,79,464,79,79
6277,2011-09-24,Winter,2011,Sep,2,0,Saturday,0,Misty,0.58,0.5455,0.94,0.0896,14,54,68,464,68,68
6278,2011-09-24,Winter,2011,Sep,3,0,Saturday,0,Clear,0.58,0.5455,0.94,0.0,4,27,31,464,31,31
6279,2011-09-24,Winter,2011,Sep,4,0,Saturday,0,Clear,0.56,0.5303,0.94,0.1045,1,7,8,464,8,8
6280,2011-09-24,Winter,2011,Sep,5,0,Saturday,0,Misty,0.56,0.5303,0.94,0.1045,2,3,5,464,5,5
6281,2011-09-24,Winter,2011,Sep,6,0,Saturday,0,Misty,0.56,0.5303,0.94,0.1045,6,12,18,464,18,18
6282,2011-09-24,Winter,2011,Sep,7,0,Saturday,0,Misty,0.56,0.5303,0.88,0.1045,12,34,46,464,46,46
6283,2011-09-24,Winter,2011,Sep,8,0,Saturday,0,Misty,0.58,0.5455,0.9,0.0896,19,102,121,464,121,121
6284,2011-09-24,Winter,2011,Sep,9,0,Saturday,0,Misty,0.6,0.5455,0.88,0.0896,41,134,175,464,175,175
6285,2011-09-24,Winter,2011,Sep,10,0,Saturday,0,Misty,0.6,0.5455,0.88,0.0896,90,203,293,464,293,293
6286,2011-09-24,Winter,2011,Sep,11,0,Saturday,0,Misty,0.62,0.5758,0.83,0.0896,118,268,386,464,386,386
6287,2011-09-24,Winter,2011,Sep,12,0,Saturday,0,Misty,0.62,0.5758,0.83,0.0896,141,266,407,464,407,407
6288,2011-09-24,Winter,2011,Sep,13,0,Saturday,0,Clear,0.64,0.5909,0.78,0.0,170,290,460,464,460,460
6289,2011-09-24,Winter,2011,Sep,14,0,Saturday,0,Misty,0.66,0.6212,0.74,0.1343,164,226,390,464,390,390
6290,2011-09-24,Winter,2011,Sep,15,0,Saturday,0,Misty,0.66,0.6212,0.74,0.1343,168,284,452,464,452,452
6291,2011-09-24,Winter,2011,Sep,16,0,Saturday,0,Misty,0.64,0.5909,0.78,0.0896,167,282,449,464,449,449
6292,2011-09-24,Winter,2011,Sep,17,0,Saturday,0,Clear,0.66,0.6212,0.74,0.1045,180,246,426,464,426,426
6293,2011-09-24,Winter,2011,Sep,18,0,Saturday,0,Clear,0.64,0.5909,0.78,0.1045,157,243,400,464,400,400
6294,2011-09-24,Winter,2011,Sep,19,0,Saturday,0,Clear,0.62,0.5606,0.88,0.0,77,231,308,464,308,308
6295,2011-09-24,Winter,2011,Sep,20,0,Saturday,0,Clear,0.62,0.5758,0.83,0.0,77,166,243,464,243,243
6296,2011-09-24,Winter,2011,Sep,21,0,Saturday,0,Clear,0.62,0.5758,0.83,0.0896,66,156,222,464,222,222
6297,2011-09-24,Winter,2011,Sep,22,0,Saturday,0,Misty,0.62,0.5606,0.88,0.0,50,143,193,464,193,193
6298,2011-09-24,Winter,2011,Sep,23,0,Saturday,0,Misty,0.6,0.5455,0.88,0.0896,27,123,150,464,150,150
6299,2011-09-25,Winter,2011,Sep,0,0,Sunday,0,Misty,0.6,0.5455,0.88,0.0,37,136,173,463,173,173
6300,2011-09-25,Winter,2011,Sep,1,0,Sunday,0,Misty,0.6,0.5455,0.88,0.1045,31,93,124,463,124,124
6301,2011-09-25,Winter,2011,Sep,2,0,Sunday,0,Light_rainsnow,0.6,0.5152,0.94,0.0,27,79,106,463,106,106
6302,2011-09-25,Winter,2011,Sep,3,0,Sunday,0,Light_rainsnow,0.6,0.5152,0.94,0.0,20,39,59,463,59,59
6303,2011-09-25,Winter,2011,Sep,4,0,Sunday,0,Light_rainsnow,0.6,0.5152,0.94,0.1343,3,5,8,463,8,8
6304,2011-09-25,Winter,2011,Sep,5,0,Sunday,0,Clear,0.6,0.5455,0.88,0.0896,1,2,3,463,3,3
6305,2011-09-25,Winter,2011,Sep,6,0,Sunday,0,Misty,0.6,0.5455,0.88,0.1045,4,13,17,463,17,17
6306,2011-09-25,Winter,2011,Sep,7,0,Sunday,0,Misty,0.6,0.5152,0.94,0.1343,15,23,38,463,38,38
6307,2011-09-25,Winter,2011,Sep,8,0,Sunday,0,Misty,0.62,0.5606,0.88,0.0,27,59,86,463,86,86
6308,2011-09-25,Winter,2011,Sep,9,0,Sunday,0,Misty,0.64,0.5758,0.83,0.0,55,100,155,463,155,155
6309,2011-09-25,Winter,2011,Sep,10,0,Sunday,0,Misty,0.64,0.5758,0.83,0.0,85,190,275,463,275,275
6310,2011-09-25,Winter,2011,Sep,11,0,Sunday,0,Misty,0.66,0.6061,0.78,0.1343,131,230,361,463,361,361
6311,2011-09-25,Winter,2011,Sep,12,0,Sunday,0,Misty,0.66,0.6061,0.78,0.0,143,270,413,463,413,413
6312,2011-09-25,Winter,2011,Sep,13,0,Sunday,0,Misty,0.68,0.6364,0.74,0.0,122,247,369,463,369,369
6313,2011-09-25,Winter,2011,Sep,14,0,Sunday,0,Misty,0.66,0.6061,0.78,0.0,116,231,347,463,347,347
6314,2011-09-25,Winter,2011,Sep,15,0,Sunday,0,Misty,0.66,0.6061,0.78,0.0,119,234,353,463,353,353
6315,2011-09-25,Winter,2011,Sep,16,0,Sunday,0,Clear,0.7,0.6515,0.7,0.0,144,320,464,463,464,464
6316,2011-09-25,Winter,2011,Sep,17,0,Sunday,0,Clear,0.68,0.6364,0.74,0.0,145,275,420,463,420,420
6317,2011-09-25,Winter,2011,Sep,18,0,Sunday,0,Clear,0.68,0.6364,0.74,0.0,125,279,404,463,404,404
6318,2011-09-25,Winter,2011,Sep,19,0,Sunday,0,Clear,0.64,0.5758,0.83,0.1343,87,242,329,463,329,329
6319,2011-09-25,Winter,2011,Sep,20,0,Sunday,0,Clear,0.64,0.5758,0.83,0.0896,51,135,186,463,186,186
6320,2011-09-25,Winter,2011,Sep,21,0,Sunday,0,Clear,0.62,0.5455,0.94,0.0896,24,113,137,463,137,137
6321,2011-09-25,Winter,2011,Sep,22,0,Sunday,0,Clear,0.62,0.5606,0.88,0.0896,20,84,104,463,104,104
6322,2011-09-25,Winter,2011,Sep,23,0,Sunday,0,Misty,0.62,0.5455,0.94,0.1045,12,67,79,463,79,79
6323,2011-09-26,Winter,2011,Sep,0,0,Monday,1,Misty,0.62,0.5455,0.94,0.0,6,23,29,462,29,29
6324,2011-09-26,Winter,2011,Sep,1,0,Monday,1,Misty,0.62,0.5606,0.88,0.1045,3,14,17,462,17,17
6325,2011-09-26,Winter,2011,Sep,2,0,Monday,1,Misty,0.62,0.5606,0.88,0.1045,4,4,8,462,8,8
6326,2011-09-26,Winter,2011,Sep,3,0,Monday,1,Misty,0.62,0.5455,0.94,0.0,0,5,5,462,5,5
6327,2011-09-26,Winter,2011,Sep,4,0,Monday,1,Misty,0.62,0.5455,0.94,0.0896,2,4,6,462,6,6
6328,2011-09-26,Winter,2011,Sep,5,0,Monday,1,Misty,0.62,0.5606,0.88,0.0,0,25,25,462,25,25
6329,2011-09-26,Winter,2011,Sep,6,0,Monday,1,Misty,0.62,0.5455,0.94,0.0896,6,107,113,462,113,113
6330,2011-09-26,Winter,2011,Sep,7,0,Monday,1,Misty,0.62,0.5455,0.94,0.0,17,315,332,462,332,332
6331,2011-09-26,Winter,2011,Sep,8,0,Monday,1,Misty,0.62,0.5455,0.94,0.0,29,326,355,462,355,355
6332,2011-09-26,Winter,2011,Sep,9,0,Monday,1,Misty,0.64,0.5758,0.89,0.194,44,161,205,462,205,205
6333,2011-09-26,Winter,2011,Sep,10,0,Monday,1,Misty,0.64,0.5758,0.89,0.194,37,117,154,462,154,154
6334,2011-09-26,Winter,2011,Sep,11,0,Monday,1,Clear,0.68,0.6364,0.79,0.2239,43,116,159,462,159,159
6335,2011-09-26,Winter,2011,Sep,12,0,Monday,1,Misty,0.68,0.6364,0.79,0.1642,48,161,209,462,209,209
6336,2011-09-26,Winter,2011,Sep,13,0,Monday,1,Misty,0.7,0.6667,0.74,0.1642,48,139,187,462,187,187
6337,2011-09-26,Winter,2011,Sep,14,0,Monday,1,Clear,0.7,0.6515,0.7,0.1642,44,110,154,462,154,154
6338,2011-09-26,Winter,2011,Sep,15,0,Monday,1,Clear,0.72,0.6818,0.62,0.1343,52,157,209,462,209,209
6339,2011-09-26,Winter,2011,Sep,16,0,Monday,1,Clear,0.7,0.6515,0.65,0.1642,74,239,313,462,313,313
6340,2011-09-26,Winter,2011,Sep,17,0,Monday,1,Clear,0.7,0.6515,0.7,0.1343,61,509,570,462,570,570
6341,2011-09-26,Winter,2011,Sep,18,0,Monday,1,Clear,0.66,0.6061,0.83,0.1045,63,490,553,462,553,553
6342,2011-09-26,Winter,2011,Sep,19,0,Monday,1,Clear,0.66,0.6061,0.82,0.0896,36,347,383,462,383,383
6343,2011-09-26,Winter,2011,Sep,20,0,Monday,1,Clear,0.64,0.5758,0.89,0.1343,24,227,251,462,251,251
6344,2011-09-26,Winter,2011,Sep,21,0,Monday,1,Clear,0.64,0.5758,0.89,0.1343,18,164,182,462,182,182
6345,2011-09-26,Winter,2011,Sep,22,0,Monday,1,Clear,0.62,0.5455,0.94,0.1343,14,122,136,462,136,136
6346,2011-09-26,Winter,2011,Sep,23,0,Monday,1,Clear,0.62,0.5455,0.94,0.1343,11,64,75,462,75,75
6347,2011-09-27,Winter,2011,Sep,0,0,Tuesday,1,Clear,0.62,0.5455,0.94,0.1343,9,28,37,461,37,37
6348,2011-09-27,Winter,2011,Sep,1,0,Tuesday,1,Clear,0.62,0.5455,0.94,0.1642,4,6,10,461,10,10
6349,2011-09-27,Winter,2011,Sep,2,0,Tuesday,1,Clear,0.62,0.5455,0.94,0.1045,7,4,11,461,11,11
6350,2011-09-27,Winter,2011,Sep,3,0,Tuesday,1,Misty,0.62,0.5455,0.94,0.0,5,5,10,461,10,10
6351,2011-09-27,Winter,2011,Sep,4,0,Tuesday,1,Light_rainsnow,0.62,0.5455,0.94,0.0896,5,3,8,461,8,8
6352,2011-09-27,Winter,2011,Sep,5,0,Tuesday,1,Light_rainsnow,0.62,0.5455,0.94,0.0896,0,24,24,461,24,24
6353,2011-09-27,Winter,2011,Sep,6,0,Tuesday,1,Misty,0.62,0.5455,0.94,0.1045,8,116,124,461,124,124
6354,2011-09-27,Winter,2011,Sep,7,0,Tuesday,1,Misty,0.62,0.5455,0.94,0.1045,15,234,249,461,249,249
6355,2011-09-27,Winter,2011,Sep,8,0,Tuesday,1,Misty,0.64,0.5758,0.89,0.1045,27,400,427,461,427,427
6356,2011-09-27,Winter,2011,Sep,9,0,Tuesday,1,Light_rainsnow,0.64,0.5758,0.89,0.194,20,173,193,461,193,193
6357,2011-09-27,Winter,2011,Sep,10,0,Tuesday,1,Light_rainsnow,0.64,0.5606,0.94,0.1642,21,101,122,461,122,122
6358,2011-09-27,Winter,2011,Sep,11,0,Tuesday,1,Misty,0.66,0.5909,0.89,0.1045,26,97,123,461,123,123
6359,2011-09-27,Winter,2011,Sep,12,0,Tuesday,1,Misty,0.66,0.5909,0.89,0.1343,33,129,162,461,162,162
6360,2011-09-27,Winter,2011,Sep,13,0,Tuesday,1,Misty,0.7,0.6667,0.74,0.2239,29,122,151,461,151,151
6361,2011-09-27,Winter,2011,Sep,14,0,Tuesday,1,Misty,0.68,0.6364,0.79,0.1045,29,123,152,461,152,152
6362,2011-09-27,Winter,2011,Sep,15,0,Tuesday,1,Misty,0.68,0.6364,0.83,0.0896,35,170,205,461,205,205
6363,2011-09-27,Winter,2011,Sep,16,0,Tuesday,1,Misty,0.66,0.6061,0.83,0.194,33,225,258,461,258,258
6364,2011-09-27,Winter,2011,Sep,17,0,Tuesday,1,Misty,0.66,0.5909,0.89,0.194,50,480,530,461,530,530
6365,2011-09-27,Winter,2011,Sep,18,0,Tuesday,1,Misty,0.64,0.5758,0.89,0.2239,31,325,356,461,356,356
6366,2011-09-27,Winter,2011,Sep,19,0,Tuesday,1,Misty,0.64,0.5758,0.89,0.1343,26,294,320,461,320,320
6367,2011-09-27,Winter,2011,Sep,20,0,Tuesday,1,Clear,0.62,0.5909,0.78,0.0,17,221,238,461,238,238
6368,2011-09-27,Winter,2011,Sep,21,0,Tuesday,1,Clear,0.6,0.5606,0.83,0.0,17,179,196,461,196,196
6369,2011-09-27,Winter,2011,Sep,22,0,Tuesday,1,Clear,0.6,0.5455,0.88,0.0896,19,102,121,461,121,121
6370,2011-09-27,Winter,2011,Sep,23,0,Tuesday,1,Clear,0.6,0.5455,0.88,0.0896,11,82,93,461,93,93
6371,2011-09-28,Winter,2011,Sep,0,0,Wednesday,1,Clear,0.6,0.5455,0.88,0.0,7,29,36,460,36,36
6372,2011-09-28,Winter,2011,Sep,1,0,Wednesday,1,Clear,0.6,0.5455,0.88,0.0,1,13,14,460,14,14
6373,2011-09-28,Winter,2011,Sep,2,0,Wednesday,1,Clear,0.6,0.5455,0.88,0.2537,0,9,9,460,9,9
6374,2011-09-28,Winter,2011,Sep,3,0,Wednesday,1,Misty,0.6,0.5152,0.94,0.0896,0,3,3,460,3,3
6375,2011-09-28,Winter,2011,Sep,4,0,Wednesday,1,Clear,0.6,0.5455,0.88,0.0,1,3,4,460,4,4
6376,2011-09-28,Winter,2011,Sep,5,0,Wednesday,1,Misty,0.6,0.5152,0.94,0.0,2,20,22,460,22,22
6377,2011-09-28,Winter,2011,Sep,6,0,Wednesday,1,Light_rainsnow,0.6,0.5152,0.94,0.1642,3,111,114,460,114,114
6378,2011-09-28,Winter,2011,Sep,7,0,Wednesday,1,Light_rainsnow,0.6,0.5152,0.94,0.1642,8,177,185,460,185,185
6379,2011-09-28,Winter,2011,Sep,8,0,Wednesday,1,Light_rainsnow,0.62,0.5455,0.94,0.2239,17,270,287,460,287,287
6380,2011-09-28,Winter,2011,Sep,9,0,Wednesday,1,Light_rainsnow,0.62,0.5455,0.94,0.2239,14,141,155,460,155,155
6381,2011-09-28,Winter,2011,Sep,10,0,Wednesday,1,Misty,0.62,0.5455,0.94,0.0,20,109,129,460,129,129
6382,2011-09-28,Winter,2011,Sep,11,0,Wednesday,1,Misty,0.66,0.6061,0.83,0.1045,24,127,151,460,151,151
6383,2011-09-28,Winter,2011,Sep,12,0,Wednesday,1,Misty,0.68,0.6364,0.79,0.0,25,159,184,460,184,184
6384,2011-09-28,Winter,2011,Sep,13,0,Wednesday,1,Clear,0.7,0.6667,0.74,0.2537,24,138,162,460,162,162
6385,2011-09-28,Winter,2011,Sep,14,0,Wednesday,1,Clear,0.72,0.6818,0.62,0.2537,25,145,170,460,170,170
6386,2011-09-28,Winter,2011,Sep,15,0,Wednesday,1,Clear,0.7,0.6515,0.7,0.1343,35,146,181,460,181,181
6387,2011-09-28,Winter,2011,Sep,16,0,Wednesday,1,Clear,0.7,0.6515,0.7,0.194,39,241,280,460,280,280
6388,2011-09-28,Winter,2011,Sep,17,0,Wednesday,1,Clear,0.7,0.6515,0.7,0.2239,64,527,591,460,591,591
6389,2011-09-28,Winter,2011,Sep,18,0,Wednesday,1,Light_rainsnow,0.66,0.6061,0.83,0.2537,65,459,524,460,524,524
6390,2011-09-28,Winter,2011,Sep,19,0,Wednesday,1,Light_rainsnow,0.66,0.6061,0.83,0.2537,57,315,372,460,372,372
6391,2011-09-28,Winter,2011,Sep,20,0,Wednesday,1,Light_rainsnow,0.6,0.5606,0.83,0.2985,11,91,102,460,102,102
6392,2011-09-28,Winter,2011,Sep,21,0,Wednesday,1,Light_rainsnow,0.6,0.5455,0.88,0.2537,7,67,74,460,74,74
6393,2011-09-28,Winter,2011,Sep,22,0,Wednesday,1,Clear,0.6,0.5455,0.88,0.0896,19,68,87,460,87,87
6394,2011-09-28,Winter,2011,Sep,23,0,Wednesday,1,Clear,0.6,0.5152,0.94,0.1343,12,59,71,460,71,71
6395,2011-09-29,Winter,2011,Sep,0,0,Thursday,1,Clear,0.6,0.5152,0.94,0.194,7,33,40,459,40,40
6396,2011-09-29,Winter,2011,Sep,1,0,Thursday,1,Misty,0.6,0.5,1.0,0.194,3,20,23,459,23,23
6397,2011-09-29,Winter,2011,Sep,2,0,Thursday,1,Misty,0.6,0.5,1.0,0.194,0,2,2,459,2,2
6398,2011-09-29,Winter,2011,Sep,3,0,Thursday,1,Misty,0.6,0.5152,0.94,0.194,0,8,8,459,8,8
6399,2011-09-29,Winter,2011,Sep,4,0,Thursday,1,Misty,0.6,0.5455,0.88,0.194,2,5,7,459,7,7
6400,2011-09-29,Winter,2011,Sep,5,0,Thursday,1,Misty,0.6,0.5455,0.88,0.1045,0,22,22,459,22,22
6401,2011-09-29,Winter,2011,Sep,6,0,Thursday,1,Misty,0.6,0.5455,0.88,0.0896,5,106,111,459,111,111
6402,2011-09-29,Winter,2011,Sep,7,0,Thursday,1,Clear,0.6,0.5455,0.88,0.1343,14,269,283,459,283,283
6403,2011-09-29,Winter,2011,Sep,8,0,Thursday,1,Clear,0.6,0.5606,0.83,0.0,29,402,431,459,431,431
6404,2011-09-29,Winter,2011,Sep,9,0,Thursday,1,Clear,0.62,0.5909,0.78,0.2537,27,198,225,459,225,225
6405,2011-09-29,Winter,2011,Sep,10,0,Thursday,1,Clear,0.64,0.6061,0.65,0.194,24,103,127,459,127,127
6406,2011-09-29,Winter,2011,Sep,11,0,Thursday,1,Clear,0.62,0.6061,0.61,0.194,36,122,158,459,158,158
6407,2011-09-29,Winter,2011,Sep,12,0,Thursday,1,Clear,0.66,0.6212,0.61,0.1642,38,157,195,459,195,195
6408,2011-09-29,Winter,2011,Sep,13,0,Thursday,1,Clear,0.64,0.6212,0.61,0.194,36,175,211,459,211,211
6409,2011-09-29,Winter,2011,Sep,14,0,Thursday,1,Clear,0.68,0.6364,0.51,0.2985,33,134,167,459,167,167
6410,2011-09-29,Winter,2011,Sep,15,0,Thursday,1,Clear,0.68,0.6364,0.45,0.3881,42,185,227,459,227,227
6411,2011-09-29,Winter,2011,Sep,16,0,Thursday,1,Clear,0.68,0.6364,0.41,0.3582,64,227,291,459,291,291
6412,2011-09-29,Winter,2011,Sep,17,0,Thursday,1,Clear,0.66,0.6212,0.47,0.2985,62,527,589,459,589,589
6413,2011-09-29,Winter,2011,Sep,18,0,Thursday,1,Clear,0.64,0.6212,0.41,0.2239,84,500,584,459,584,584
6414,2011-09-29,Winter,2011,Sep,19,0,Thursday,1,Clear,0.62,0.6212,0.5,0.0896,36,348,384,459,384,384
6415,2011-09-29,Winter,2011,Sep,20,0,Thursday,1,Clear,0.6,0.6212,0.53,0.0896,39,234,273,459,273,273
6416,2011-09-29,Winter,2011,Sep,21,0,Thursday,1,Clear,0.58,0.5455,0.56,0.0,30,195,225,459,225,225
6417,2011-09-29,Winter,2011,Sep,22,0,Thursday,1,Clear,0.56,0.5303,0.68,0.0,25,150,175,459,175,175
6418,2011-09-29,Winter,2011,Sep,23,0,Thursday,1,Clear,0.52,0.5,0.77,0.1045,17,64,81,459,81,81
6419,2011-09-30,Winter,2011,Sep,0,0,Friday,1,Clear,0.52,0.5,0.83,0.1045,7,53,60,458,60,60
6420,2011-09-30,Winter,2011,Sep,1,0,Friday,1,Clear,0.52,0.5,0.77,0.0896,5,18,23,458,23,23
6421,2011-09-30,Winter,2011,Sep,2,0,Friday,1,Clear,0.52,0.5,0.83,0.1045,6,9,15,458,15,15
6422,2011-09-30,Winter,2011,Sep,3,0,Friday,1,Clear,0.52,0.5,0.83,0.1045,0,3,3,458,3,3
6423,2011-09-30,Winter,2011,Sep,4,0,Friday,1,Clear,0.52,0.5,0.83,0.194,2,6,8,458,8,8
6424,2011-09-30,Winter,2011,Sep,5,0,Friday,1,Clear,0.52,0.5,0.83,0.194,3,23,26,458,26,26
6425,2011-09-30,Winter,2011,Sep,6,0,Friday,1,Clear,0.52,0.5,0.83,0.2239,0,98,98,458,98,98
6426,2011-09-30,Winter,2011,Sep,7,0,Friday,1,Clear,0.52,0.5,0.83,0.2239,14,283,297,458,297,297
6427,2011-09-30,Winter,2011,Sep,8,0,Friday,1,Clear,0.54,0.5152,0.77,0.1343,31,425,456,458,456,456
6428,2011-09-30,Winter,2011,Sep,9,0,Friday,1,Clear,0.56,0.5303,0.73,0.194,23,214,237,458,237,237
6429,2011-09-30,Winter,2011,Sep,10,0,Friday,1,Clear,0.6,0.6061,0.64,0.0,46,122,168,458,168,168
6430,2011-09-30,Winter,2011,Sep,11,0,Friday,1,Clear,0.64,0.6212,0.57,0.0896,49,168,217,458,217,217
6431,2011-09-30,Winter,2011,Sep,12,0,Friday,1,Misty,0.64,0.6212,0.57,0.194,59,195,254,458,254,254
6432,2011-09-30,Winter,2011,Sep,13,0,Friday,1,Misty,0.66,0.6212,0.47,0.3284,72,194,266,458,266,266
6433,2011-09-30,Winter,2011,Sep,14,0,Friday,1,Misty,0.64,0.6212,0.47,0.2985,93,173,266,458,266,266
6434,2011-09-30,Winter,2011,Sep,15,0,Friday,1,Clear,0.64,0.6212,0.5,0.2836,52,193,245,458,245,245
6435,2011-09-30,Winter,2011,Sep,16,0,Friday,1,Clear,0.62,0.6212,0.53,0.2239,62,298,360,458,360,360
6436,2011-09-30,Winter,2011,Sep,17,0,Friday,1,Clear,0.62,0.6212,0.53,0.194,94,497,591,458,591,591
6437,2011-09-30,Winter,2011,Sep,18,0,Friday,1,Clear,0.58,0.5455,0.49,0.3582,62,449,511,458,511,511
6438,2011-09-30,Winter,2011,Sep,19,0,Friday,1,Clear,0.54,0.5152,0.52,0.2836,42,332,374,458,374,374
6439,2011-09-30,Winter,2011,Sep,20,0,Friday,1,Clear,0.54,0.5152,0.52,0.2836,28,202,230,458,230,230
6440,2011-09-30,Winter,2011,Sep,21,0,Friday,1,Clear,0.52,0.5,0.55,0.194,27,179,206,458,206,206
6441,2011-09-30,Winter,2011,Sep,22,0,Friday,1,Clear,0.52,0.5,0.55,0.3284,30,129,159,458,159,159
6442,2011-09-30,Winter,2011,Sep,23,0,Friday,1,Clear,0.52,0.5,0.55,0.3284,23,109,132,458,132,132
6443,2011-10-01,Winter,2011,Oct,0,0,Saturday,0,Clear,0.5,0.4848,0.63,0.3881,24,106,130,457,130,130
6444,2011-10-01,Winter,2011,Oct,1,0,Saturday,0,Clear,0.48,0.4697,0.67,0.3284,11,47,58,457,58,58
6445,2011-10-01,Winter,2011,Oct,2,0,Saturday,0,Clear,0.46,0.4545,0.63,0.4179,21,46,67,457,67,67
6446,2011-10-01,Winter,2011,Oct,3,0,Saturday,0,Clear,0.46,0.4545,0.59,0.4179,8,17,25,457,25,25
6447,2011-10-01,Winter,2011,Oct,4,0,Saturday,0,Clear,0.44,0.4394,0.58,0.4179,2,6,8,457,8,8
6448,2011-10-01,Winter,2011,Oct,5,0,Saturday,0,Misty,0.44,0.4394,0.62,0.2985,1,4,5,457,5,5
6449,2011-10-01,Winter,2011,Oct,6,0,Saturday,0,Clear,0.42,0.4242,0.67,0.3284,4,15,19,457,19,19
6450,2011-10-01,Winter,2011,Oct,7,0,Saturday,0,Light_rainsnow,0.42,0.4242,0.67,0.2537,6,30,36,457,36,36
6451,2011-10-01,Winter,2011,Oct,8,0,Saturday,0,Misty,0.4,0.4091,0.76,0.3284,9,58,67,457,67,67
6452,2011-10-01,Winter,2011,Oct,9,0,Saturday,0,Light_rainsnow,0.4,0.4091,0.82,0.3582,17,112,129,457,129,129
6453,2011-10-01,Winter,2011,Oct,10,0,Saturday,0,Light_rainsnow,0.4,0.4091,0.76,0.3582,21,100,121,457,121,121
6454,2011-10-01,Winter,2011,Oct,11,0,Saturday,0,Light_rainsnow,0.38,0.3939,0.82,0.3284,30,102,132,457,132,132
6455,2011-10-01,Winter,2011,Oct,12,0,Saturday,0,Misty,0.4,0.4091,0.82,0.2537,28,130,158,457,158,158
6456,2011-10-01,Winter,2011,Oct,13,0,Saturday,0,Misty,0.4,0.4091,0.82,0.3284,27,98,125,457,125,125
6457,2011-10-01,Winter,2011,Oct,14,0,Saturday,0,Misty,0.42,0.4242,0.71,0.3582,33,147,180,457,180,180
6458,2011-10-01,Winter,2011,Oct,15,0,Saturday,0,Misty,0.42,0.4242,0.71,0.2836,41,154,195,457,195,195
6459,2011-10-01,Winter,2011,Oct,16,0,Saturday,0,Misty,0.4,0.4091,0.76,0.2985,58,165,223,457,223,223
6460,2011-10-01,Winter,2011,Oct,17,0,Saturday,0,Light_rainsnow,0.4,0.4091,0.76,0.194,58,170,228,457,228,228
6461,2011-10-01,Winter,2011,Oct,18,0,Saturday,0,Light_rainsnow,0.38,0.3939,0.87,0.2239,23,117,140,457,140,140
6462,2011-10-01,Winter,2011,Oct,19,0,Saturday,0,Misty,0.38,0.3939,0.82,0.194,27,99,126,457,126,126
6463,2011-10-01,Winter,2011,Oct,20,0,Saturday,0,Light_rainsnow,0.36,0.3636,0.87,0.1045,8,58,66,457,66,66
6464,2011-10-01,Winter,2011,Oct,21,0,Saturday,0,Light_rainsnow,0.36,0.3636,0.87,0.1045,3,53,56,457,56,56
6465,2011-10-01,Winter,2011,Oct,22,0,Saturday,0,Misty,0.36,0.3485,0.93,0.2239,12,58,70,457,70,70
6466,2011-10-01,Winter,2011,Oct,23,0,Saturday,0,Light_rainsnow,0.36,0.3485,0.93,0.2239,8,57,65,457,65,65
6467,2011-10-02,Winter,2011,Oct,0,0,Sunday,0,Light_rainsnow,0.36,0.3333,0.93,0.2985,4,43,47,456,47,47
6468,2011-10-02,Winter,2011,Oct,1,0,Sunday,0,Light_rainsnow,0.34,0.3182,0.87,0.2537,1,23,24,456,24,24
6469,2011-10-02,Winter,2011,Oct,2,0,Sunday,0,Light_rainsnow,0.34,0.303,0.87,0.2985,3,27,30,456,30,30
6470,2011-10-02,Winter,2011,Oct,3,0,Sunday,0,Light_rainsnow,0.34,0.3182,0.87,0.2836,4,5,9,456,9,9
6471,2011-10-02,Winter,2011,Oct,4,0,Sunday,0,Misty,0.34,0.3182,0.87,0.2537,4,3,7,456,7,7
6472,2011-10-02,Winter,2011,Oct,5,0,Sunday,0,Clear,0.32,0.303,0.87,0.2836,0,7,7,456,7,7
6473,2011-10-02,Winter,2011,Oct,6,0,Sunday,0,Clear,0.32,0.3182,0.81,0.1642,2,13,15,456,15,15
6474,2011-10-02,Winter,2011,Oct,7,0,Sunday,0,Clear,0.34,0.3333,0.76,0.194,5,24,29,456,29,29
6475,2011-10-02,Winter,2011,Oct,8,0,Sunday,0,Misty,0.34,0.3333,0.76,0.194,14,50,64,456,64,64
6476,2011-10-02,Winter,2011,Oct,9,0,Sunday,0,Clear,0.36,0.3333,0.76,0.3582,19,96,115,456,115,115
6477,2011-10-02,Winter,2011,Oct,10,0,Sunday,0,Misty,0.36,0.3333,0.71,0.2836,60,188,248,456,248,248
6478,2011-10-02,Winter,2011,Oct,11,0,Sunday,0,Misty,0.38,0.3939,0.66,0.2537,74,218,292,456,292,292
6479,2011-10-02,Winter,2011,Oct,12,0,Sunday,0,Misty,0.4,0.4091,0.62,0.194,78,243,321,456,321,321
6480,2011-10-02,Winter,2011,Oct,13,0,Sunday,0,Light_rainsnow,0.4,0.4091,0.62,0.2239,84,224,308,456,308,308
6481,2011-10-02,Winter,2011,Oct,14,0,Sunday,0,Light_rainsnow,0.36,0.3485,0.81,0.1642,61,195,256,456,256,256
6482,2011-10-02,Winter,2011,Oct,15,0,Sunday,0,Light_rainsnow,0.36,0.3333,0.81,0.2537,29,144,173,456,173,173
6483,2011-10-02,Winter,2011,Oct,16,0,Sunday,0,Light_rainsnow,0.36,0.3485,0.87,0.194,44,162,206,456,206,206
6484,2011-10-02,Winter,2011,Oct,17,0,Sunday,0,Light_rainsnow,0.36,0.3485,0.87,0.1642,32,135,167,456,167,167
6485,2011-10-02,Winter,2011,Oct,18,0,Sunday,0,Misty,0.36,0.3485,0.81,0.194,16,158,174,456,174,174
6486,2011-10-02,Winter,2011,Oct,19,0,Sunday,0,Misty,0.38,0.3939,0.76,0.1642,34,128,162,456,162,162
6487,2011-10-02,Winter,2011,Oct,20,0,Sunday,0,Misty,0.36,0.3333,0.76,0.2537,16,71,87,456,87,87
6488,2011-10-02,Winter,2011,Oct,21,0,Sunday,0,Clear,0.36,0.3485,0.71,0.2239,17,71,88,456,88,88
6489,2011-10-02,Winter,2011,Oct,22,0,Sunday,0,Light_rainsnow,0.36,0.3636,0.81,0.0896,9,55,64,456,64,64
6490,2011-10-02,Winter,2011,Oct,23,0,Sunday,0,Clear,0.36,0.3636,0.81,0.0896,6,19,25,456,25,25
6491,2011-10-03,Winter,2011,Oct,0,0,Monday,1,Clear,0.34,0.3485,0.87,0.1045,3,13,16,455,16,16
6492,2011-10-03,Winter,2011,Oct,1,0,Monday,1,Clear,0.36,0.3636,0.81,0.0896,1,5,6,455,6,6
6493,2011-10-03,Winter,2011,Oct,2,0,Monday,1,Clear,0.36,0.3636,0.76,0.1045,0,4,4,455,4,4
6494,2011-10-03,Winter,2011,Oct,3,0,Monday,1,Clear,0.36,0.3788,0.81,0.0,1,6,7,455,7,7
6495,2011-10-03,Winter,2011,Oct,4,0,Monday,1,Clear,0.34,0.3485,0.87,0.1045,2,6,8,455,8,8
6496,2011-10-03,Winter,2011,Oct,5,0,Monday,1,Misty,0.36,0.3636,0.76,0.1045,4,17,21,455,21,21
6497,2011-10-03,Winter,2011,Oct,6,0,Monday,1,Misty,0.36,0.3788,0.71,0.0,3,91,94,455,94,94
6498,2011-10-03,Winter,2011,Oct,7,0,Monday,1,Misty,0.36,0.3485,0.71,0.1343,8,241,249,455,249,249
6499,2011-10-03,Winter,2011,Oct,8,0,Monday,1,Misty,0.36,0.3636,0.71,0.1045,13,359,372,455,372,372
6500,2011-10-03,Winter,2011,Oct,9,0,Monday,1,Misty,0.4,0.4091,0.66,0.0896,12,141,153,455,153,153
6501,2011-10-03,Winter,2011,Oct,10,0,Monday,1,Misty,0.4,0.4091,0.66,0.1045,19,82,101,455,101,101
6502,2011-10-03,Winter,2011,Oct,11,0,Monday,1,Misty,0.4,0.4091,0.71,0.2239,26,100,126,455,126,126
6503,2011-10-03,Winter,2011,Oct,12,0,Monday,1,Misty,0.4,0.4091,0.71,0.1343,29,118,147,455,147,147
6504,2011-10-03,Winter,2011,Oct,13,0,Monday,1,Light_rainsnow,0.42,0.4242,0.67,0.1642,16,102,118,455,118,118
6505,2011-10-03,Winter,2011,Oct,14,0,Monday,1,Light_rainsnow,0.4,0.4091,0.76,0.0,26,94,120,455,120,120
6506,2011-10-03,Winter,2011,Oct,15,0,Monday,1,Light_rainsnow,0.4,0.4091,0.76,0.0,22,79,101,455,101,101
6507,2011-10-03,Winter,2011,Oct,16,0,Monday,1,Misty,0.4,0.4091,0.76,0.1045,16,202,218,455,218,218
6508,2011-10-03,Winter,2011,Oct,17,0,Monday,1,Misty,0.4,0.4091,0.76,0.1642,40,455,495,455,495,495
6509,2011-10-03,Winter,2011,Oct,18,0,Monday,1,Misty,0.4,0.4091,0.76,0.1642,28,384,412,455,412,412
6510,2011-10-03,Winter,2011,Oct,19,0,Monday,1,Clear,0.4,0.4091,0.76,0.0,15,300,315,455,315,315
6511,2011-10-03,Winter,2011,Oct,20,0,Monday,1,Light_rainsnow,0.4,0.4091,0.82,0.0,13,191,204,455,204,204
6512,2011-10-03,Winter,2011,Oct,21,0,Monday,1,Misty,0.4,0.4091,0.82,0.0,10,128,138,455,138,138
6513,2011-10-03,Winter,2011,Oct,22,0,Monday,1,Misty,0.4,0.4091,0.82,0.0,12,79,91,455,91,91
6514,2011-10-03,Winter,2011,Oct,23,0,Monday,1,Misty,0.4,0.4091,0.82,0.1045,11,43,54,455,54,54
6515,2011-10-04,Winter,2011,Oct,0,0,Tuesday,1,Misty,0.4,0.4091,0.87,0.0896,5,22,27,454,27,27
6516,2011-10-04,Winter,2011,Oct,1,0,Tuesday,1,Misty,0.4,0.4091,0.87,0.1045,1,8,9,454,9,9
6517,2011-10-04,Winter,2011,Oct,2,0,Tuesday,1,Misty,0.4,0.4091,0.87,0.0,1,2,3,454,3,3
6518,2011-10-04,Winter,2011,Oct,3,0,Tuesday,1,Clear,0.4,0.4091,0.82,0.1045,3,3,6,454,6,6
6519,2011-10-04,Winter,2011,Oct,4,0,Tuesday,1,Clear,0.4,0.4091,0.82,0.0896,3,4,7,454,7,7
6520,2011-10-04,Winter,2011,Oct,5,0,Tuesday,1,Clear,0.4,0.4091,0.82,0.1343,2,25,27,454,27,27
6521,2011-10-04,Winter,2011,Oct,6,0,Tuesday,1,Clear,0.4,0.4091,0.82,0.1045,3,109,112,454,112,112
6522,2011-10-04,Winter,2011,Oct,7,0,Tuesday,1,Clear,0.42,0.4242,0.82,0.2836,11,298,309,454,309,309
6523,2011-10-04,Winter,2011,Oct,8,0,Tuesday,1,Clear,0.44,0.4394,0.77,0.2239,28,372,400,454,400,400
6524,2011-10-04,Winter,2011,Oct,9,0,Tuesday,1,Clear,0.46,0.4545,0.67,0.2537,19,168,187,454,187,187
6525,2011-10-04,Winter,2011,Oct,10,0,Tuesday,1,Clear,0.48,0.4697,0.67,0.2836,19,107,126,454,126,126
6526,2011-10-04,Winter,2011,Oct,11,0,Tuesday,1,Clear,0.54,0.5152,0.64,0.2836,22,102,124,454,124,124
6527,2011-10-04,Winter,2011,Oct,12,0,Tuesday,1,Clear,0.56,0.5303,0.56,0.2985,39,160,199,454,199,199
6528,2011-10-04,Winter,2011,Oct,13,0,Tuesday,1,Clear,0.56,0.5303,0.56,0.2985,20,153,173,454,173,173
6529,2011-10-04,Winter,2011,Oct,14,0,Tuesday,1,Clear,0.58,0.5455,0.53,0.2537,27,156,183,454,183,183
6530,2011-10-04,Winter,2011,Oct,15,0,Tuesday,1,Clear,0.58,0.5455,0.56,0.2836,28,166,194,454,194,194
6531,2011-10-04,Winter,2011,Oct,16,0,Tuesday,1,Clear,0.58,0.5455,0.56,0.3284,36,273,309,454,309,309
6532,2011-10-04,Winter,2011,Oct,17,0,Tuesday,1,Clear,0.56,0.5303,0.6,0.3881,55,530,585,454,585,585
6533,2011-10-04,Winter,2011,Oct,18,0,Tuesday,1,Clear,0.54,0.5152,0.64,0.2836,68,456,524,454,524,524
6534,2011-10-04,Winter,2011,Oct,19,0,Tuesday,1,Clear,0.52,0.5,0.68,0.2239,35,310,345,454,345,345
6535,2011-10-04,Winter,2011,Oct,20,0,Tuesday,1,Clear,0.52,0.5,0.68,0.2239,25,236,261,454,261,261
6536,2011-10-04,Winter,2011,Oct,21,0,Tuesday,1,Clear,0.5,0.4848,0.72,0.1343,22,144,166,454,166,166
6537,2011-10-04,Winter,2011,Oct,22,0,Tuesday,1,Clear,0.5,0.4848,0.72,0.1343,8,106,114,454,114,114
6538,2011-10-04,Winter,2011,Oct,23,0,Tuesday,1,Clear,0.48,0.4697,0.77,0.1343,6,60,66,454,66,66
6539,2011-10-05,Winter,2011,Oct,0,0,Wednesday,1,Clear,0.48,0.4697,0.77,0.1343,7,36,43,453,43,43
6540,2011-10-05,Winter,2011,Oct,1,0,Wednesday,1,Clear,0.48,0.4697,0.77,0.1642,4,7,11,453,11,11
6541,2011-10-05,Winter,2011,Oct,2,0,Wednesday,1,Clear,0.46,0.4545,0.82,0.1642,1,2,3,453,3,3
6542,2011-10-05,Winter,2011,Oct,3,0,Wednesday,1,Clear,0.46,0.4545,0.82,0.1045,1,5,6,453,6,6
6543,2011-10-05,Winter,2011,Oct,4,0,Wednesday,1,Clear,0.44,0.4394,0.88,0.0,1,4,5,453,5,5
6544,2011-10-05,Winter,2011,Oct,5,0,Wednesday,1,Clear,0.44,0.4394,0.82,0.1343,3,29,32,453,32,32
6545,2011-10-05,Winter,2011,Oct,6,0,Wednesday,1,Clear,0.44,0.4394,0.82,0.1045,5,112,117,453,117,117
6546,2011-10-05,Winter,2011,Oct,7,0,Wednesday,1,Clear,0.46,0.4545,0.77,0.1045,9,292,301,453,301,301
6547,2011-10-05,Winter,2011,Oct,8,0,Wednesday,1,Clear,0.52,0.5,0.63,0.0,26,441,467,453,467,467
6548,2011-10-05,Winter,2011,Oct,9,0,Wednesday,1,Clear,0.54,0.5152,0.6,0.2985,32,187,219,453,219,219
6549,2011-10-05,Winter,2011,Oct,10,0,Wednesday,1,Clear,0.56,0.5303,0.56,0.3881,30,103,133,453,133,133
6550,2011-10-05,Winter,2011,Oct,11,0,Wednesday,1,Clear,0.6,0.6212,0.46,0.2836,32,138,170,453,170,170
6551,2011-10-05,Winter,2011,Oct,12,0,Wednesday,1,Clear,0.62,0.6212,0.43,0.3284,34,180,214,453,214,214
6552,2011-10-05,Winter,2011,Oct,13,0,Wednesday,1,Clear,0.64,0.6212,0.41,0.2239,30,189,219,453,219,219
6553,2011-10-05,Winter,2011,Oct,14,0,Wednesday,1,Clear,0.64,0.6212,0.41,0.2836,34,156,190,453,190,190
6554,2011-10-05,Winter,2011,Oct,15,0,Wednesday,1,Clear,0.64,0.6212,0.47,0.2836,35,147,182,453,182,182
6555,2011-10-05,Winter,2011,Oct,16,0,Wednesday,1,Clear,0.64,0.6212,0.47,0.3284,37,245,282,453,282,282
6556,2011-10-05,Winter,2011,Oct,17,0,Wednesday,1,Clear,0.64,0.6212,0.47,0.2537,66,525,591,453,591,591
6557,2011-10-05,Winter,2011,Oct,18,0,Wednesday,1,Clear,0.6,0.6212,0.53,0.1642,57,536,593,453,593,593
6558,2011-10-05,Winter,2011,Oct,19,0,Wednesday,1,Clear,0.58,0.5455,0.56,0.1343,40,334,374,453,374,374
6559,2011-10-05,Winter,2011,Oct,20,0,Wednesday,1,Clear,0.52,0.5,0.77,0.1642,18,228,246,453,246,246
6560,2011-10-05,Winter,2011,Oct,21,0,Wednesday,1,Clear,0.5,0.4848,0.82,0.1045,28,173,201,453,201,201
6561,2011-10-05,Winter,2011,Oct,22,0,Wednesday,1,Clear,0.52,0.5,0.72,0.0,20,134,154,453,154,154
6562,2011-10-05,Winter,2011,Oct,23,0,Wednesday,1,Clear,0.5,0.4848,0.77,0.1045,9,64,73,453,73,73
6563,2011-10-06,Winter,2011,Oct,0,0,Thursday,1,Clear,0.5,0.4848,0.72,0.194,6,34,40,452,40,40
6564,2011-10-06,Winter,2011,Oct,1,0,Thursday,1,Clear,0.48,0.4697,0.63,0.194,5,17,22,452,22,22
6565,2011-10-06,Winter,2011,Oct,2,0,Thursday,1,Clear,0.46,0.4545,0.67,0.194,2,8,10,452,10,10
6566,2011-10-06,Winter,2011,Oct,3,0,Thursday,1,Clear,0.44,0.4394,0.67,0.2239,1,4,5,452,5,5
6567,2011-10-06,Winter,2011,Oct,4,0,Thursday,1,Clear,0.44,0.4394,0.62,0.2836,0,5,5,452,5,5
6568,2011-10-06,Winter,2011,Oct,5,0,Thursday,1,Clear,0.42,0.4242,0.62,0.194,0,24,24,452,24,24
6569,2011-10-06,Winter,2011,Oct,6,0,Thursday,1,Clear,0.4,0.4091,0.66,0.194,4,110,114,452,114,114
6570,2011-10-06,Winter,2011,Oct,7,0,Thursday,1,Clear,0.42,0.4242,0.62,0.194,15,287,302,452,302,302
6571,2011-10-06,Winter,2011,Oct,8,0,Thursday,1,Clear,0.44,0.4394,0.62,0.1642,20,437,457,452,457,457
6572,2011-10-06,Winter,2011,Oct,9,0,Thursday,1,Clear,0.46,0.4545,0.63,0.194,20,188,208,452,208,208
6573,2011-10-06,Winter,2011,Oct,10,0,Thursday,1,Clear,0.52,0.5,0.52,0.0,24,105,129,452,129,129
6574,2011-10-06,Winter,2011,Oct,11,0,Thursday,1,Clear,0.54,0.5152,0.49,0.0,29,115,144,452,144,144
6575,2011-10-06,Winter,2011,Oct,12,0,Thursday,1,Clear,0.56,0.5303,0.49,0.0896,46,180,226,452,226,226
6576,2011-10-06,Winter,2011,Oct,13,0,Thursday,1,Clear,0.56,0.5303,0.46,0.0896,33,158,191,452,191,191
6577,2011-10-06,Winter,2011,Oct,14,0,Thursday,1,Clear,0.58,0.5455,0.43,0.0896,56,139,195,452,195,195
6578,2011-10-06,Winter,2011,Oct,15,0,Thursday,1,Clear,0.58,0.5455,0.46,0.1343,62,157,219,452,219,219
6579,2011-10-06,Winter,2011,Oct,16,0,Thursday,1,Clear,0.58,0.5455,0.49,0.194,51,272,323,452,323,323
6580,2011-10-06,Winter,2011,Oct,17,0,Thursday,1,Clear,0.56,0.5303,0.52,0.1343,63,505,568,452,568,568
6581,2011-10-06,Winter,2011,Oct,18,0,Thursday,1,Clear,0.54,0.5152,0.64,0.0896,59,479,538,452,538,538
6582,2011-10-06,Winter,2011,Oct,19,0,Thursday,1,Clear,0.52,0.5,0.59,0.1045,38,305,343,452,343,343
6583,2011-10-06,Winter,2011,Oct,20,0,Thursday,1,Clear,0.5,0.4848,0.77,0.1045,29,231,260,452,260,260
6584,2011-10-06,Winter,2011,Oct,21,0,Thursday,1,Clear,0.46,0.4545,0.88,0.0896,34,161,195,452,195,195
6585,2011-10-06,Winter,2011,Oct,22,0,Thursday,1,Clear,0.46,0.4545,0.82,0.0,24,124,148,452,148,148
6586,2011-10-06,Winter,2011,Oct,23,0,Thursday,1,Clear,0.44,0.4394,0.88,0.0896,18,81,99,452,99,99
6587,2011-10-07,Winter,2011,Oct,0,0,Friday,1,Clear,0.44,0.4394,0.88,0.0,19,48,67,451,67,67
6588,2011-10-07,Winter,2011,Oct,1,0,Friday,1,Clear,0.44,0.4394,0.88,0.0,3,25,28,451,28,28
6589,2011-10-07,Winter,2011,Oct,2,0,Friday,1,Clear,0.42,0.4242,0.88,0.0,0,5,5,451,5,5
6590,2011-10-07,Winter,2011,Oct,3,0,Friday,1,Clear,0.4,0.4091,0.87,0.0,1,9,10,451,10,10
6591,2011-10-07,Winter,2011,Oct,4,0,Friday,1,Clear,0.4,0.4091,0.87,0.1045,0,5,5,451,5,5
6592,2011-10-07,Winter,2011,Oct,5,0,Friday,1,Clear,0.42,0.4242,0.82,0.0,3,24,27,451,27,27
6593,2011-10-07,Winter,2011,Oct,6,0,Friday,1,Clear,0.42,0.4242,0.88,0.0,3,84,87,451,87,87
6594,2011-10-07,Winter,2011,Oct,7,0,Friday,1,Clear,0.42,0.4242,0.94,0.0,5,237,242,451,242,242
6595,2011-10-07,Winter,2011,Oct,8,0,Friday,1,Clear,0.46,0.4545,0.82,0.0,31,386,417,451,417,417
6596,2011-10-07,Winter,2011,Oct,9,0,Friday,1,Clear,0.48,0.4697,0.77,0.0,34,207,241,451,241,241
6597,2011-10-07,Winter,2011,Oct,10,0,Friday,1,Clear,0.52,0.5,0.68,0.0896,48,126,174,451,174,174
6598,2011-10-07,Winter,2011,Oct,11,0,Friday,1,Clear,0.56,0.5303,0.63,0.0,80,150,230,451,230,230
6599,2011-10-07,Winter,2011,Oct,12,0,Friday,1,Clear,0.6,0.6212,0.53,0.0,61,174,235,451,235,235
6600,2011-10-07,Winter,2011,Oct,13,0,Friday,1,Clear,0.6,0.6212,0.46,0.0,95,210,305,451,305,305
6601,2011-10-07,Winter,2011,Oct,14,0,Friday,1,Clear,0.62,0.6212,0.5,0.0,77,179,256,451,256,256
6602,2011-10-07,Winter,2011,Oct,15,0,Friday,1,Clear,0.66,0.6212,0.41,0.0,68,202,270,451,270,270
6603,2011-10-07,Winter,2011,Oct,16,0,Friday,1,Clear,0.64,0.6212,0.44,0.0,73,346,419,451,419,419
6604,2011-10-07,Winter,2011,Oct,17,0,Friday,1,Clear,0.6,0.6212,0.56,0.2537,101,462,563,451,563,563
6605,2011-10-07,Winter,2011,Oct,18,0,Friday,1,Clear,0.56,0.5303,0.6,0.0896,94,371,465,451,465,465
6606,2011-10-07,Winter,2011,Oct,19,0,Friday,1,Clear,0.56,0.5303,0.52,0.0,51,243,294,451,294,294
6607,2011-10-07,Winter,2011,Oct,20,0,Friday,1,Clear,0.54,0.5152,0.49,0.0,30,167,197,451,197,197
6608,2011-10-07,Winter,2011,Oct,21,0,Friday,1,Clear,0.5,0.4848,0.68,0.0,22,144,166,451,166,166
6609,2011-10-07,Winter,2011,Oct,22,0,Friday,1,Clear,0.5,0.4848,0.68,0.0,27,119,146,451,146,146
6610,2011-10-07,Winter,2011,Oct,23,0,Friday,1,Clear,0.5,0.4848,0.63,0.0,23,113,136,451,136,136
6611,2011-10-08,Winter,2011,Oct,0,0,Saturday,0,Clear,0.48,0.4697,0.72,0.0,17,72,89,450,89,89
6612,2011-10-08,Winter,2011,Oct,1,0,Saturday,0,Clear,0.46,0.4545,0.82,0.0,14,51,65,450,65,65
6613,2011-10-08,Winter,2011,Oct,2,0,Saturday,0,Clear,0.46,0.4545,0.82,0.0,4,41,45,450,45,45
6614,2011-10-08,Winter,2011,Oct,3,0,Saturday,0,Clear,0.44,0.4394,0.88,0.0,4,16,20,450,20,20
6615,2011-10-08,Winter,2011,Oct,4,0,Saturday,0,Clear,0.42,0.4242,0.94,0.1343,3,7,10,450,10,10
6616,2011-10-08,Winter,2011,Oct,5,0,Saturday,0,Clear,0.42,0.4242,0.88,0.1045,1,7,8,450,8,8
6617,2011-10-08,Winter,2011,Oct,6,0,Saturday,0,Clear,0.42,0.4242,0.94,0.0,6,16,22,450,22,22
6618,2011-10-08,Winter,2011,Oct,7,0,Saturday,0,Clear,0.42,0.4242,0.94,0.0896,27,46,73,450,73,73
6619,2011-10-08,Winter,2011,Oct,8,0,Saturday,0,Clear,0.46,0.4545,0.82,0.0,14,89,103,450,103,103
6620,2011-10-08,Winter,2011,Oct,9,0,Saturday,0,Clear,0.5,0.4848,0.77,0.0,54,163,217,450,217,217
6621,2011-10-08,Winter,2011,Oct,10,0,Saturday,0,Clear,0.52,0.5,0.77,0.0,120,217,337,450,337,337
6622,2011-10-08,Winter,2011,Oct,11,0,Saturday,0,Clear,0.58,0.5455,0.56,0.0,176,221,397,450,397,397
6623,2011-10-08,Winter,2011,Oct,12,0,Saturday,0,Clear,0.62,0.6212,0.35,0.0,191,255,446,450,446,446
6624,2011-10-08,Winter,2011,Oct,13,0,Saturday,0,Clear,0.62,0.6212,0.46,0.1045,256,229,485,450,485,485
6625,2011-10-08,Winter,2011,Oct,14,0,Saturday,0,Clear,0.62,0.6212,0.5,0.0896,251,214,465,450,465,465
6626,2011-10-08,Winter,2011,Oct,15,0,Saturday,0,Clear,0.66,0.6212,0.39,0.0,262,234,496,450,496,496
6627,2011-10-08,Winter,2011,Oct,16,0,Saturday,0,Clear,0.64,0.6212,0.44,0.0896,221,230,451,450,451,451
6628,2011-10-08,Winter,2011,Oct,17,0,Saturday,0,Clear,0.62,0.6212,0.5,0.1343,174,219,393,450,393,393
6629,2011-10-08,Winter,2011,Oct,18,0,Saturday,0,Clear,0.6,0.6212,0.46,0.1045,135,224,359,450,359,359
6630,2011-10-08,Winter,2011,Oct,19,0,Saturday,0,Clear,0.54,0.5152,0.68,0.1343,76,172,248,450,248,248
6631,2011-10-08,Winter,2011,Oct,20,0,Saturday,0,Clear,0.52,0.5,0.77,0.1045,78,124,202,450,202,202
6632,2011-10-08,Winter,2011,Oct,21,0,Saturday,0,Clear,0.52,0.5,0.77,0.0,54,133,187,450,187,187
6633,2011-10-08,Winter,2011,Oct,22,0,Saturday,0,Clear,0.5,0.4848,0.77,0.0,45,104,149,450,149,149
6634,2011-10-08,Winter,2011,Oct,23,0,Saturday,0,Clear,0.48,0.4697,0.88,0.0,52,90,142,450,142,142
6635,2011-10-09,Winter,2011,Oct,0,0,Sunday,0,Clear,0.46,0.4545,0.88,0.0896,46,83,129,449,129,129
6636,2011-10-09,Winter,2011,Oct,1,0,Sunday,0,Clear,0.46,0.4545,0.88,0.0,15,63,78,449,78,78
6637,2011-10-09,Winter,2011,Oct,2,0,Sunday,0,Clear,0.46,0.4545,0.88,0.0,20,35,55,449,55,55
6638,2011-10-09,Winter,2011,Oct,3,0,Sunday,0,Clear,0.44,0.4394,0.88,0.0,10,20,30,449,30,30
6639,2011-10-09,Winter,2011,Oct,4,0,Sunday,0,Clear,0.44,0.4394,0.88,0.0,7,7,14,449,14,14
6640,2011-10-09,Winter,2011,Oct,5,0,Sunday,0,Clear,0.44,0.4394,0.88,0.0,1,14,15,449,15,15
6641,2011-10-09,Winter,2011,Oct,6,0,Sunday,0,Clear,0.44,0.4394,0.88,0.0,7,14,21,449,21,21
6642,2011-10-09,Winter,2011,Oct,7,0,Sunday,0,Clear,0.44,0.4394,0.86,0.0,18,26,44,449,44,44
6643,2011-10-09,Winter,2011,Oct,8,0,Sunday,0,Clear,0.46,0.4545,0.88,0.0,25,82,107,449,107,107
6644,2011-10-09,Winter,2011,Oct,9,0,Sunday,0,Clear,0.5,0.4848,0.77,0.0,66,119,185,449,185,185
6645,2011-10-09,Winter,2011,Oct,10,0,Sunday,0,Clear,0.56,0.5303,0.68,0.0896,155,210,365,449,365,365
6646,2011-10-09,Winter,2011,Oct,11,0,Sunday,0,Clear,0.62,0.6212,0.53,0.0896,189,234,423,449,423,423
6647,2011-10-09,Winter,2011,Oct,12,0,Sunday,0,Clear,0.64,0.6212,0.44,0.0896,212,243,455,449,455,455
6648,2011-10-09,Winter,2011,Oct,13,0,Sunday,0,Clear,0.66,0.6212,0.44,0.0896,225,193,418,449,418,418
6649,2011-10-09,Winter,2011,Oct,14,0,Sunday,0,Clear,0.68,0.6364,0.47,0.1642,272,228,500,449,500,500
6650,2011-10-09,Winter,2011,Oct,15,0,Sunday,0,Clear,0.68,0.6364,0.51,0.1642,198,209,407,449,407,407
6651,2011-10-09,Winter,2011,Oct,16,0,Sunday,0,Clear,0.66,0.6212,0.5,0.1343,223,247,470,449,470,470
6652,2011-10-09,Winter,2011,Oct,17,0,Sunday,0,Clear,0.62,0.6061,0.61,0.1045,208,230,438,449,438,438
6653,2011-10-09,Winter,2011,Oct,18,0,Sunday,0,Clear,0.64,0.6212,0.5,0.1045,186,228,414,449,414,414
6654,2011-10-09,Winter,2011,Oct,19,0,Sunday,0,Clear,0.56,0.5303,0.73,0.0896,116,186,302,449,302,302
6655,2011-10-09,Winter,2011,Oct,20,0,Sunday,0,Clear,0.56,0.5303,0.73,0.1045,59,134,193,449,193,193
6656,2011-10-09,Winter,2011,Oct,21,0,Sunday,0,Clear,0.54,0.5152,0.83,0.1045,53,120,173,449,173,173
6657,2011-10-09,Winter,2011,Oct,22,0,Sunday,0,Misty,0.52,0.5,0.94,0.0,48,104,152,449,152,152
6658,2011-10-09,Winter,2011,Oct,23,0,Sunday,0,Clear,0.5,0.4848,0.88,0.1045,38,85,123,449,123,123
6659,2011-10-10,Winter,2011,Oct,0,1,Monday,0,Clear,0.5,0.4848,0.94,0.0,11,42,53,448,53,53
6660,2011-10-10,Winter,2011,Oct,1,1,Monday,0,Clear,0.48,0.4697,0.88,0.0,4,30,34,448,34,34
6661,2011-10-10,Winter,2011,Oct,2,1,Monday,0,Clear,0.48,0.4697,0.88,0.0,4,15,19,448,19,19
6662,2011-10-10,Winter,2011,Oct,3,1,Monday,0,Clear,0.46,0.4545,0.88,0.0,2,9,11,448,11,11
6663,2011-10-10,Winter,2011,Oct,4,1,Monday,0,Clear,0.46,0.4545,0.94,0.0,2,4,6,448,6,6
6664,2011-10-10,Winter,2011,Oct,5,1,Monday,0,Clear,0.46,0.4545,0.94,0.0,2,19,21,448,21,21
6665,2011-10-10,Winter,2011,Oct,6,1,Monday,0,Clear,0.44,0.4394,0.94,0.0,5,39,44,448,44,44
6666,2011-10-10,Winter,2011,Oct,7,1,Monday,0,Clear,0.46,0.4545,0.88,0.0,12,102,114,448,114,114
6667,2011-10-10,Winter,2011,Oct,8,1,Monday,0,Clear,0.52,0.5,0.83,0.0,27,227,254,448,254,254
6668,2011-10-10,Winter,2011,Oct,9,1,Monday,0,Clear,0.54,0.5152,0.77,0.0,58,161,219,448,219,219
6669,2011-10-10,Winter,2011,Oct,10,1,Monday,0,Clear,0.56,0.5303,0.73,0.1642,107,158,265,448,265,265
6670,2011-10-10,Winter,2011,Oct,11,1,Monday,0,Clear,0.62,0.6061,0.69,0.0896,139,183,322,448,322,322
6671,2011-10-10,Winter,2011,Oct,12,1,Monday,0,Misty,0.7,0.6515,0.48,0.0896,164,201,365,448,365,365
6672,2011-10-10,Winter,2011,Oct,13,1,Monday,0,Clear,0.72,0.6515,0.37,0.0,146,219,365,448,365,365
6673,2011-10-10,Winter,2011,Oct,14,1,Monday,0,Clear,0.74,0.6515,0.37,0.0,147,223,370,448,370,370
6674,2011-10-10,Winter,2011,Oct,15,1,Monday,0,Misty,0.72,0.6515,0.42,0.1045,130,254,384,448,384,384
6675,2011-10-10,Winter,2011,Oct,16,1,Monday,0,Misty,0.7,0.6364,0.45,0.0896,154,248,402,448,402,402
6676,2011-10-10,Winter,2011,Oct,17,1,Monday,0,Misty,0.66,0.6212,0.54,0.1045,125,334,459,448,459,459
6677,2011-10-10,Winter,2011,Oct,18,1,Monday,0,Misty,0.64,0.6212,0.53,0.0,108,365,473,448,473,473
6678,2011-10-10,Winter,2011,Oct,19,1,Monday,0,Misty,0.58,0.5455,0.78,0.0896,69,267,336,448,336,336
6679,2011-10-10,Winter,2011,Oct,20,1,Monday,0,Clear,0.6,0.5909,0.73,0.0,37,188,225,448,225,225
6680,2011-10-10,Winter,2011,Oct,21,1,Monday,0,Clear,0.56,0.5303,0.88,0.0896,27,148,175,448,175,175
6681,2011-10-10,Winter,2011,Oct,22,1,Monday,0,Clear,0.56,0.5303,0.88,0.0896,22,104,126,448,126,126
6682,2011-10-10,Winter,2011,Oct,23,1,Monday,0,Misty,0.54,0.5152,0.88,0.1045,12,63,75,448,75,75
6683,2011-10-11,Winter,2011,Oct,0,0,Tuesday,1,Misty,0.54,0.5152,0.88,0.0,14,16,30,447,30,30
6684,2011-10-11,Winter,2011,Oct,1,0,Tuesday,1,Misty,0.52,0.5,0.94,0.0896,2,9,11,447,11,11
6685,2011-10-11,Winter,2011,Oct,2,0,Tuesday,1,Misty,0.52,0.5,0.94,0.1343,1,4,5,447,5,5
6686,2011-10-11,Winter,2011,Oct,3,0,Tuesday,1,Misty,0.52,0.5,0.88,0.1045,2,1,3,447,3,3
6687,2011-10-11,Winter,2011,Oct,4,0,Tuesday,1,Misty,0.52,0.5,0.88,0.1343,0,5,5,447,5,5
6688,2011-10-11,Winter,2011,Oct,5,0,Tuesday,1,Misty,0.52,0.5,0.88,0.0,0,20,20,447,20,20
6689,2011-10-11,Winter,2011,Oct,6,0,Tuesday,1,Clear,0.52,0.5,0.83,0.0896,9,114,123,447,123,123
6690,2011-10-11,Winter,2011,Oct,7,0,Tuesday,1,Misty,0.52,0.5,0.88,0.0896,19,333,352,447,352,352
6691,2011-10-11,Winter,2011,Oct,8,0,Tuesday,1,Misty,0.56,0.5303,0.83,0.1045,31,375,406,447,406,406
6692,2011-10-11,Winter,2011,Oct,9,0,Tuesday,1,Misty,0.6,0.5909,0.69,0.0,40,195,235,447,235,235
6693,2011-10-11,Winter,2011,Oct,10,0,Tuesday,1,Misty,0.6,0.5909,0.69,0.1343,38,111,149,447,149,149
6694,2011-10-11,Winter,2011,Oct,11,0,Tuesday,1,Misty,0.6,0.5909,0.73,0.1642,31,92,123,447,123,123
6695,2011-10-11,Winter,2011,Oct,12,0,Tuesday,1,Misty,0.6,0.5909,0.73,0.1642,51,130,181,447,181,181
6696,2011-10-11,Winter,2011,Oct,13,0,Tuesday,1,Misty,0.6,0.5909,0.73,0.194,42,138,180,447,180,180
6697,2011-10-11,Winter,2011,Oct,14,0,Tuesday,1,Light_rainsnow,0.6,0.5909,0.73,0.1045,54,117,171,447,171,171
6698,2011-10-11,Winter,2011,Oct,15,0,Tuesday,1,Misty,0.6,0.5758,0.78,0.1642,36,139,175,447,175,175
6699,2011-10-11,Winter,2011,Oct,16,0,Tuesday,1,Misty,0.6,0.5909,0.73,0.1642,63,257,320,447,320,320
6700,2011-10-11,Winter,2011,Oct,17,0,Tuesday,1,Misty,0.6,0.5758,0.78,0.2537,70,534,604,447,604,604
6701,2011-10-11,Winter,2011,Oct,18,0,Tuesday,1,Misty,0.6,0.5758,0.78,0.2239,46,493,539,447,539,539
6702,2011-10-11,Winter,2011,Oct,19,0,Tuesday,1,Misty,0.58,0.5455,0.83,0.2239,33,285,318,447,318,318
6703,2011-10-11,Winter,2011,Oct,20,0,Tuesday,1,Misty,0.58,0.5455,0.83,0.2239,31,203,234,447,234,234
6704,2011-10-11,Winter,2011,Oct,21,0,Tuesday,1,Misty,0.58,0.5455,0.78,0.194,17,158,175,447,175,175
6705,2011-10-11,Winter,2011,Oct,22,0,Tuesday,1,Misty,0.56,0.5303,0.83,0.194,27,120,147,447,147,147
6706,2011-10-11,Winter,2011,Oct,23,0,Tuesday,1,Misty,0.56,0.5303,0.83,0.2836,10,47,57,447,57,57
6707,2011-10-12,Winter,2011,Oct,0,0,Wednesday,1,Misty,0.56,0.5303,0.83,0.1343,2,23,25,446,25,25
6708,2011-10-12,Winter,2011,Oct,1,0,Wednesday,1,Light_rainsnow,0.56,0.5303,0.83,0.1343,2,8,10,446,10,10
6709,2011-10-12,Winter,2011,Oct,2,0,Wednesday,1,Misty,0.56,0.5303,0.83,0.2836,0,2,2,446,2,2
6710,2011-10-12,Winter,2011,Oct,3,0,Wednesday,1,Light_rainsnow,0.54,0.5152,0.94,0.2985,0,2,2,446,2,2
6711,2011-10-12,Winter,2011,Oct,4,0,Wednesday,1,Light_rainsnow,0.54,0.5152,0.94,0.3881,1,6,7,446,7,7
6712,2011-10-12,Winter,2011,Oct,5,0,Wednesday,1,Misty,0.54,0.5152,0.88,0.3284,0,22,22,446,22,22
6713,2011-10-12,Winter,2011,Oct,6,0,Wednesday,1,Misty,0.54,0.5152,0.88,0.2537,5,107,112,446,112,112
6714,2011-10-12,Winter,2011,Oct,7,0,Wednesday,1,Misty,0.54,0.5152,0.88,0.3881,15,244,259,446,259,259
6715,2011-10-12,Winter,2011,Oct,8,0,Wednesday,1,Misty,0.54,0.5152,0.88,0.3881,27,377,404,446,404,404
6716,2011-10-12,Winter,2011,Oct,9,0,Wednesday,1,Misty,0.54,0.5152,0.88,0.4478,14,183,197,446,197,197
6717,2011-10-12,Winter,2011,Oct,10,0,Wednesday,1,Misty,0.54,0.5152,0.88,0.3881,15,98,113,446,113,113
6718,2011-10-12,Winter,2011,Oct,11,0,Wednesday,1,Light_rainsnow,0.54,0.5152,0.94,0.3284,18,102,120,446,120,120
6719,2011-10-12,Winter,2011,Oct,12,0,Wednesday,1,Light_rainsnow,0.54,0.5152,0.88,0.3284,9,53,62,446,62,62
6720,2011-10-12,Winter,2011,Oct,13,0,Wednesday,1,Light_rainsnow,0.54,0.5152,0.88,0.2239,25,76,101,446,101,101
6721,2011-10-12,Winter,2011,Oct,14,0,Wednesday,1,Light_rainsnow,0.54,0.5152,0.94,0.2836,8,70,78,446,78,78
6722,2011-10-12,Winter,2011,Oct,15,0,Wednesday,1,Light_rainsnow,0.54,0.5152,0.94,0.2537,3,42,45,446,45,45
6723,2011-10-12,Winter,2011,Oct,16,0,Wednesday,1,Misty,0.56,0.5303,0.88,0.2239,5,50,55,446,55,55
6724,2011-10-12,Winter,2011,Oct,17,0,Wednesday,1,Light_rainsnow,0.54,0.5152,0.94,0.2239,16,235,251,446,251,251
6725,2011-10-12,Winter,2011,Oct,18,0,Wednesday,1,Light_rainsnow,0.54,0.5152,0.94,0.1343,11,161,172,446,172,172
6726,2011-10-12,Winter,2011,Oct,19,0,Wednesday,1,Light_rainsnow,0.54,0.5152,0.94,0.1343,7,102,109,446,109,109
6727,2011-10-12,Winter,2011,Oct,20,0,Wednesday,1,Light_rainsnow,0.54,0.5152,0.94,0.1045,9,81,90,446,90,90
6728,2011-10-12,Winter,2011,Oct,21,0,Wednesday,1,Light_rainsnow,0.54,0.5152,1.0,0.1045,9,74,83,446,83,83
6729,2011-10-12,Winter,2011,Oct,22,0,Wednesday,1,Light_rainsnow,0.54,0.5152,0.94,0.0896,3,40,43,446,43,43
6730,2011-10-12,Winter,2011,Oct,23,0,Wednesday,1,Light_rainsnow,0.54,0.5152,0.94,0.0896,13,41,54,446,54,54
6731,2011-10-13,Winter,2011,Oct,0,0,Thursday,1,Misty,0.54,0.5152,0.94,0.1343,1,14,15,445,15,15
6732,2011-10-13,Winter,2011,Oct,1,0,Thursday,1,Misty,0.54,0.5152,0.94,0.0,3,9,12,445,12,12
6733,2011-10-13,Winter,2011,Oct,2,0,Thursday,1,Misty,0.54,0.5152,0.94,0.0,0,4,4,445,4,4
6734,2011-10-13,Winter,2011,Oct,3,0,Thursday,1,Misty,0.54,0.5152,1.0,0.194,2,4,6,445,6,6
6735,2011-10-13,Winter,2011,Oct,4,0,Thursday,1,Misty,0.54,0.5152,1.0,0.1045,2,5,7,445,7,7
6736,2011-10-13,Winter,2011,Oct,5,0,Thursday,1,Misty,0.54,0.5152,1.0,0.1045,1,16,17,445,17,17
6737,2011-10-13,Winter,2011,Oct,6,0,Thursday,1,Light_rainsnow,0.54,0.5152,1.0,0.0896,1,51,52,445,52,52
6738,2011-10-13,Winter,2011,Oct,7,0,Thursday,1,Light_rainsnow,0.54,0.5152,1.0,0.1343,5,76,81,445,81,81
6739,2011-10-13,Winter,2011,Oct,8,0,Thursday,1,Light_rainsnow,0.54,0.5152,1.0,0.0896,10,199,209,445,209,209
6740,2011-10-13,Winter,2011,Oct,9,0,Thursday,1,Light_rainsnow,0.56,0.5303,1.0,0.1045,3,106,109,445,109,109
6741,2011-10-13,Winter,2011,Oct,10,0,Thursday,1,Light_rainsnow,0.56,0.5303,1.0,0.1343,16,53,69,445,69,69
6742,2011-10-13,Winter,2011,Oct,11,0,Thursday,1,Misty,0.62,0.5758,0.83,0.0,8,76,84,445,84,84
6743,2011-10-13,Winter,2011,Oct,12,0,Thursday,1,Misty,0.62,0.5606,0.88,0.0,10,95,105,445,105,105
6744,2011-10-13,Winter,2011,Oct,13,0,Thursday,1,Misty,0.64,0.5758,0.83,0.1642,20,142,162,445,162,162
6745,2011-10-13,Winter,2011,Oct,14,0,Thursday,1,Clear,0.66,0.6061,0.78,0.194,22,111,133,445,133,133
6746,2011-10-13,Winter,2011,Oct,15,0,Thursday,1,Clear,0.66,0.6061,0.78,0.194,27,128,155,445,155,155
6747,2011-10-13,Winter,2011,Oct,16,0,Thursday,1,Clear,0.66,0.6212,0.74,0.2239,36,240,276,445,276,276
6748,2011-10-13,Winter,2011,Oct,17,0,Thursday,1,Light_rainsnow,0.62,0.5758,0.83,0.2537,47,432,479,445,479,479
6749,2011-10-13,Winter,2011,Oct,18,0,Thursday,1,Light_rainsnow,0.62,0.5758,0.83,0.2537,20,248,268,445,268,268
6750,2011-10-13,Winter,2011,Oct,19,0,Thursday,1,Misty,0.62,0.5758,0.83,0.1642,18,187,205,445,205,205
6751,2011-10-13,Winter,2011,Oct,20,0,Thursday,1,Clear,0.62,0.5758,0.83,0.2836,15,166,181,445,181,181
6752,2011-10-13,Winter,2011,Oct,21,0,Thursday,1,Clear,0.62,0.5758,0.83,0.194,8,115,123,445,123,123
6753,2011-10-13,Winter,2011,Oct,22,0,Thursday,1,Clear,0.62,0.5758,0.83,0.194,13,101,114,445,114,114
6754,2011-10-13,Winter,2011,Oct,23,0,Thursday,1,Misty,0.58,0.5455,0.88,0.194,2,45,47,445,47,47
6755,2011-10-14,Winter,2011,Oct,0,0,Friday,1,Clear,0.58,0.5455,0.94,0.0896,10,29,39,444,39,39
6756,2011-10-14,Winter,2011,Oct,1,0,Friday,1,Clear,0.58,0.5455,0.94,0.1343,8,16,24,444,24,24
6757,2011-10-14,Winter,2011,Oct,2,0,Friday,1,Clear,0.56,0.5303,0.94,0.1642,0,6,6,444,6,6
6758,2011-10-14,Winter,2011,Oct,3,0,Friday,1,Clear,0.56,0.5303,0.94,0.1343,1,6,7,444,7,7
6759,2011-10-14,Winter,2011,Oct,4,0,Friday,1,Clear,0.56,0.5303,0.94,0.194,0,8,8,444,8,8
6760,2011-10-14,Winter,2011,Oct,5,0,Friday,1,Misty,0.56,0.5303,0.94,0.1642,0,17,17,444,17,17
6761,2011-10-14,Winter,2011,Oct,6,0,Friday,1,Light_rainsnow,0.56,0.5303,0.88,0.194,4,90,94,444,94,94
6762,2011-10-14,Winter,2011,Oct,7,0,Friday,1,Light_rainsnow,0.56,0.5303,0.88,0.194,10,137,147,444,147,147
6763,2011-10-14,Winter,2011,Oct,8,0,Friday,1,Misty,0.56,0.5303,0.9,0.1642,23,186,209,444,209,209
6764,2011-10-14,Winter,2011,Oct,9,0,Friday,1,Misty,0.56,0.5303,0.94,0.2239,16,164,180,444,180,180
6765,2011-10-14,Winter,2011,Oct,10,0,Friday,1,Light_rainsnow,0.54,0.5152,0.88,0.3582,17,108,125,444,125,125
6766,2011-10-14,Winter,2011,Oct,11,0,Friday,1,Light_rainsnow,0.52,0.5,0.88,0.1642,11,76,87,444,87,87
6767,2011-10-14,Winter,2011,Oct,12,0,Friday,1,Light_rainsnow,0.52,0.5,0.88,0.1642,13,62,75,444,75,75
6768,2011-10-14,Winter,2011,Oct,13,0,Friday,1,Clear,0.56,0.5303,0.73,0.3582,18,114,132,444,132,132
6769,2011-10-14,Winter,2011,Oct,14,0,Friday,1,Clear,0.62,0.6212,0.43,0.3582,37,119,156,444,156,156
6770,2011-10-14,Winter,2011,Oct,15,0,Friday,1,Clear,0.62,0.6212,0.43,0.2836,61,169,230,444,230,230
6771,2011-10-14,Winter,2011,Oct,16,0,Friday,1,Clear,0.6,0.6212,0.43,0.2239,80,264,344,444,344,344
6772,2011-10-14,Winter,2011,Oct,17,0,Friday,1,Clear,0.58,0.5455,0.46,0.4179,55,426,481,444,481,481
6773,2011-10-14,Winter,2011,Oct,18,0,Friday,1,Clear,0.54,0.5152,0.39,0.2836,62,361,423,444,423,423
6774,2011-10-14,Winter,2011,Oct,19,0,Friday,1,Clear,0.54,0.5152,0.39,0.3284,27,221,248,444,248,248
6775,2011-10-14,Winter,2011,Oct,20,0,Friday,1,Clear,0.52,0.5,0.42,0.194,19,177,196,444,196,196
6776,2011-10-14,Winter,2011,Oct,21,0,Friday,1,Clear,0.5,0.4848,0.45,0.194,22,156,178,444,178,178
6777,2011-10-14,Winter,2011,Oct,22,0,Friday,1,Clear,0.46,0.4545,0.59,0.2239,20,123,143,444,143,143
6778,2011-10-14,Winter,2011,Oct,23,0,Friday,1,Clear,0.46,0.4545,0.59,0.1642,15,80,95,444,95,95
6779,2011-10-15,Winter,2011,Oct,0,0,Saturday,0,Clear,0.46,0.4545,0.55,0.1045,18,88,106,443,106,106
6780,2011-10-15,Winter,2011,Oct,1,0,Saturday,0,Clear,0.46,0.4545,0.55,0.2537,9,64,73,443,73,73
6781,2011-10-15,Winter,2011,Oct,2,0,Saturday,0,Clear,0.46,0.4545,0.59,0.194,17,39,56,443,56,56
6782,2011-10-15,Winter,2011,Oct,3,0,Saturday,0,Clear,0.44,0.4394,0.62,0.194,5,18,23,443,23,23
6783,2011-10-15,Winter,2011,Oct,4,0,Saturday,0,Clear,0.42,0.4242,0.67,0.1343,0,6,6,443,6,6
6784,2011-10-15,Winter,2011,Oct,5,0,Saturday,0,Clear,0.42,0.4242,0.71,0.1642,1,6,7,443,7,7
6785,2011-10-15,Winter,2011,Oct,6,0,Saturday,0,Clear,0.4,0.4091,0.71,0.0,5,15,20,443,20,20
6786,2011-10-15,Winter,2011,Oct,7,0,Saturday,0,Clear,0.4,0.4091,0.76,0.1045,17,40,57,443,57,57
6787,2011-10-15,Winter,2011,Oct,8,0,Saturday,0,Clear,0.46,0.4545,0.59,0.2836,24,101,125,443,125,125
6788,2011-10-15,Winter,2011,Oct,9,0,Saturday,0,Clear,0.52,0.5,0.48,0.2985,50,157,207,443,207,207
6789,2011-10-15,Winter,2011,Oct,10,0,Saturday,0,Clear,0.54,0.5152,0.45,0.4478,115,207,322,443,322,322
6790,2011-10-15,Winter,2011,Oct,11,0,Saturday,0,Clear,0.56,0.5303,0.4,0.3881,153,221,374,443,374,374
6791,2011-10-15,Winter,2011,Oct,12,0,Saturday,0,Clear,0.58,0.5455,0.35,0.5522,195,261,456,443,456,456
6792,2011-10-15,Winter,2011,Oct,13,0,Saturday,0,Clear,0.6,0.6212,0.35,0.4627,171,223,394,443,394,394
6793,2011-10-15,Winter,2011,Oct,14,0,Saturday,0,Clear,0.6,0.6212,0.33,0.4627,242,230,472,443,472,472
6794,2011-10-15,Winter,2011,Oct,15,0,Saturday,0,Clear,0.62,0.6212,0.31,0.4925,166,211,377,443,377,377
6795,2011-10-15,Winter,2011,Oct,16,0,Saturday,0,Clear,0.62,0.6212,0.29,0.3881,179,264,443,443,443,443
6796,2011-10-15,Winter,2011,Oct,17,0,Saturday,0,Clear,0.58,0.5455,0.32,0.2836,177,264,441,443,441,441
6797,2011-10-15,Winter,2011,Oct,18,0,Saturday,0,Clear,0.54,0.5152,0.39,0.194,121,251,372,443,372,372
6798,2011-10-15,Winter,2011,Oct,19,0,Saturday,0,Clear,0.5,0.4848,0.51,0.1343,61,177,238,443,238,238
6799,2011-10-15,Winter,2011,Oct,20,0,Saturday,0,Clear,0.5,0.4848,0.48,0.1343,42,137,179,443,179,179
6800,2011-10-15,Winter,2011,Oct,21,0,Saturday,0,Clear,0.5,0.4848,0.42,0.2239,53,115,168,443,168,168
6801,2011-10-15,Winter,2011,Oct,22,0,Saturday,0,Clear,0.5,0.4848,0.36,0.1343,45,121,166,443,166,166
6802,2011-10-15,Winter,2011,Oct,23,0,Saturday,0,Clear,0.48,0.4697,0.41,0.1642,33,102,135,443,135,135
6803,2011-10-16,Winter,2011,Oct,0,0,Sunday,0,Clear,0.46,0.4545,0.44,0.1343,22,85,107,442,107,107
6804,2011-10-16,Winter,2011,Oct,1,0,Sunday,0,Clear,0.44,0.4394,0.47,0.1343,13,64,77,442,77,77
6805,2011-10-16,Winter,2011,Oct,2,0,Sunday,0,Clear,0.42,0.4242,0.54,0.1343,13,52,65,442,65,65
6806,2011-10-16,Winter,2011,Oct,3,0,Sunday,0,Clear,0.42,0.4242,0.54,0.1343,11,31,42,442,42,42
6807,2011-10-16,Winter,2011,Oct,4,0,Sunday,0,Clear,0.42,0.4242,0.54,0.194,5,7,12,442,12,12
6808,2011-10-16,Winter,2011,Oct,5,0,Sunday,0,Clear,0.42,0.4242,0.54,0.1642,1,6,7,442,7,7
6809,2011-10-16,Winter,2011,Oct,6,0,Sunday,0,Clear,0.38,0.3939,0.66,0.1642,3,7,10,442,10,10
6810,2011-10-16,Winter,2011,Oct,7,0,Sunday,0,Clear,0.4,0.4091,0.62,0.1343,9,39,48,442,48,48
6811,2011-10-16,Winter,2011,Oct,8,0,Sunday,0,Clear,0.44,0.4394,0.62,0.194,28,71,99,442,99,99
6812,2011-10-16,Winter,2011,Oct,9,0,Sunday,0,Clear,0.5,0.4848,0.45,0.2239,39,151,190,442,190,190
6813,2011-10-16,Winter,2011,Oct,10,0,Sunday,0,Clear,0.54,0.5152,0.45,0.2537,121,226,347,442,347,347
6814,2011-10-16,Winter,2011,Oct,11,0,Sunday,0,Clear,0.56,0.5303,0.35,0.2836,159,218,377,442,377,377
6815,2011-10-16,Winter,2011,Oct,12,0,Sunday,0,Clear,0.58,0.5455,0.35,0.2537,167,277,444,442,444,444
6816,2011-10-16,Winter,2011,Oct,13,0,Sunday,0,Clear,0.6,0.6212,0.35,0.2985,169,269,438,442,438,438
6817,2011-10-16,Winter,2011,Oct,14,0,Sunday,0,Clear,0.6,0.6212,0.4,0.2985,204,258,462,442,462,462
6818,2011-10-16,Winter,2011,Oct,15,0,Sunday,0,Clear,0.62,0.6212,0.35,0.3881,182,230,412,442,412,412
6819,2011-10-16,Winter,2011,Oct,16,0,Sunday,0,Clear,0.6,0.6212,0.46,0.3881,177,289,466,442,466,466
6820,2011-10-16,Winter,2011,Oct,17,0,Sunday,0,Clear,0.58,0.5455,0.49,0.4627,152,253,405,442,405,405
6821,2011-10-16,Winter,2011,Oct,18,0,Sunday,0,Clear,0.56,0.5303,0.49,0.4478,102,226,328,442,328,328
6822,2011-10-16,Winter,2011,Oct,19,0,Sunday,0,Clear,0.54,0.5152,0.52,0.3881,52,181,233,442,233,233
6823,2011-10-16,Winter,2011,Oct,20,0,Sunday,0,Clear,0.54,0.5152,0.52,0.4627,49,129,178,442,178,178
6824,2011-10-16,Winter,2011,Oct,21,0,Sunday,0,Clear,0.54,0.5152,0.52,0.3881,14,88,102,442,102,102
6825,2011-10-16,Winter,2011,Oct,22,0,Sunday,0,Clear,0.56,0.5303,0.49,0.4179,42,88,130,442,130,130
6826,2011-10-16,Winter,2011,Oct,23,0,Sunday,0,Clear,0.56,0.5303,0.52,0.4179,14,48,62,442,62,62
6827,2011-10-17,Winter,2011,Oct,0,0,Monday,1,Clear,0.54,0.5152,0.56,0.3284,12,25,37,441,37,37
6828,2011-10-17,Winter,2011,Oct,1,0,Monday,1,Clear,0.56,0.5303,0.54,0.3881,2,15,17,441,17,17
6829,2011-10-17,Winter,2011,Oct,2,0,Monday,1,Clear,0.56,0.5303,0.54,0.3881,4,3,7,441,7,7
6830,2011-10-17,Winter,2011,Oct,3,0,Monday,1,Clear,0.56,0.5303,0.49,0.194,0,2,2,441,2,2
6831,2011-10-17,Winter,2011,Oct,4,0,Monday,1,Clear,0.52,0.5,0.59,0.1642,2,3,5,441,5,5
6832,2011-10-17,Winter,2011,Oct,5,0,Monday,1,Clear,0.5,0.4848,0.63,0.2985,1,28,29,441,29,29
6833,2011-10-17,Winter,2011,Oct,6,0,Monday,1,Clear,0.5,0.4848,0.55,0.2537,7,107,114,441,114,114
6834,2011-10-17,Winter,2011,Oct,7,0,Monday,1,Misty,0.5,0.4848,0.55,0.1642,10,299,309,441,309,309
6835,2011-10-17,Winter,2011,Oct,8,0,Monday,1,Misty,0.5,0.4848,0.51,0.2537,33,381,414,441,414,414
6836,2011-10-17,Winter,2011,Oct,9,0,Monday,1,Misty,0.5,0.4848,0.45,0.2836,26,180,206,441,206,206
6837,2011-10-17,Winter,2011,Oct,10,0,Monday,1,Clear,0.52,0.5,0.45,0.1642,43,92,135,441,135,135
6838,2011-10-17,Winter,2011,Oct,11,0,Monday,1,Clear,0.56,0.5303,0.43,0.0,35,131,166,441,166,166
6839,2011-10-17,Winter,2011,Oct,12,0,Monday,1,Clear,0.56,0.5303,0.4,0.0896,39,166,205,441,205,205
6840,2011-10-17,Winter,2011,Oct,13,0,Monday,1,Clear,0.56,0.5303,0.46,0.0896,49,156,205,441,205,205
6841,2011-10-17,Winter,2011,Oct,14,0,Monday,1,Clear,0.58,0.5455,0.49,0.194,44,122,166,441,166,166
6842,2011-10-17,Winter,2011,Oct,15,0,Monday,1,Clear,0.56,0.5303,0.6,0.2537,66,142,208,441,208,208
6843,2011-10-17,Winter,2011,Oct,16,0,Monday,1,Clear,0.58,0.5455,0.56,0.2537,64,238,302,441,302,302
6844,2011-10-17,Winter,2011,Oct,17,0,Monday,1,Clear,0.56,0.5303,0.64,0.1343,80,540,620,441,620,620
6845,2011-10-17,Winter,2011,Oct,18,0,Monday,1,Clear,0.56,0.5303,0.6,0.0,49,469,518,441,518,518
6846,2011-10-17,Winter,2011,Oct,19,0,Monday,1,Clear,0.54,0.5152,0.68,0.1045,45,288,333,441,333,333
6847,2011-10-17,Winter,2011,Oct,20,0,Monday,1,Clear,0.52,0.5,0.77,0.1045,40,189,229,441,229,229
6848,2011-10-17,Winter,2011,Oct,21,0,Monday,1,Clear,0.5,0.4848,0.77,0.1045,36,141,177,441,177,177
6849,2011-10-17,Winter,2011,Oct,22,0,Monday,1,Clear,0.5,0.4848,0.77,0.0,16,88,104,441,104,104
6850,2011-10-17,Winter,2011,Oct,23,0,Monday,1,Misty,0.48,0.4697,0.88,0.0,10,52,62,441,62,62
6851,2011-10-18,Winter,2011,Oct,0,0,Tuesday,1,Clear,0.48,0.4697,0.82,0.0,8,23,31,440,31,31
6852,2011-10-18,Winter,2011,Oct,1,0,Tuesday,1,Misty,0.46,0.4545,0.88,0.0,4,7,11,440,11,11
6853,2011-10-18,Winter,2011,Oct,2,0,Tuesday,1,Clear,0.44,0.4394,0.94,0.0896,1,4,5,440,5,5
6854,2011-10-18,Winter,2011,Oct,3,0,Tuesday,1,Clear,0.44,0.4394,0.94,0.0896,0,1,1,440,1,1
6855,2011-10-18,Winter,2011,Oct,4,0,Tuesday,1,Misty,0.44,0.4394,0.94,0.1045,0,4,4,440,4,4
6856,2011-10-18,Winter,2011,Oct,5,0,Tuesday,1,Misty,0.46,0.4545,0.88,0.0,2,19,21,440,21,21
6857,2011-10-18,Winter,2011,Oct,6,0,Tuesday,1,Clear,0.46,0.4545,0.82,0.0896,4,105,109,440,109,109
6858,2011-10-18,Winter,2011,Oct,7,0,Tuesday,1,Clear,0.46,0.4545,0.88,0.0896,15,326,341,440,341,341
6859,2011-10-18,Winter,2011,Oct,8,0,Tuesday,1,Clear,0.5,0.4848,0.77,0.0896,25,474,499,440,499,499
6860,2011-10-18,Winter,2011,Oct,9,0,Tuesday,1,Misty,0.52,0.5,0.77,0.0896,29,198,227,440,227,227
6861,2011-10-18,Winter,2011,Oct,10,0,Tuesday,1,Misty,0.56,0.5303,0.68,0.0,27,75,102,440,102,102
6862,2011-10-18,Winter,2011,Oct,11,0,Tuesday,1,Misty,0.6,0.6212,0.49,0.1045,35,112,147,440,147,147
6863,2011-10-18,Winter,2011,Oct,12,0,Tuesday,1,Misty,0.62,0.6212,0.43,0.0896,42,159,201,440,201,201
6864,2011-10-18,Winter,2011,Oct,13,0,Tuesday,1,Misty,0.64,0.6212,0.38,0.194,48,171,219,440,219,219
6865,2011-10-18,Winter,2011,Oct,14,0,Tuesday,1,Misty,0.62,0.6212,0.41,0.1642,32,137,169,440,169,169
6866,2011-10-18,Winter,2011,Oct,15,0,Tuesday,1,Clear,0.62,0.6212,0.5,0.194,66,139,205,440,205,205
6867,2011-10-18,Winter,2011,Oct,16,0,Tuesday,1,Clear,0.62,0.6212,0.57,0.2537,58,246,304,440,304,304
6868,2011-10-18,Winter,2011,Oct,17,0,Tuesday,1,Clear,0.6,0.6061,0.6,0.1343,72,553,625,440,625,625
6869,2011-10-18,Winter,2011,Oct,18,0,Tuesday,1,Clear,0.56,0.5303,0.68,0.1045,58,512,570,440,570,570
6870,2011-10-18,Winter,2011,Oct,19,0,Tuesday,1,Clear,0.56,0.5303,0.6,0.1045,31,286,317,440,317,317
6871,2011-10-18,Winter,2011,Oct,20,0,Tuesday,1,Clear,0.54,0.5152,0.64,0.1642,23,204,227,440,227,227
6872,2011-10-18,Winter,2011,Oct,21,0,Tuesday,1,Misty,0.54,0.5152,0.68,0.1343,28,178,206,440,206,206
6873,2011-10-18,Winter,2011,Oct,22,0,Tuesday,1,Misty,0.52,0.5,0.77,0.1642,22,115,137,440,137,137
6874,2011-10-18,Winter,2011,Oct,23,0,Tuesday,1,Misty,0.52,0.5,0.77,0.194,7,63,70,440,70,70
6875,2011-10-19,Winter,2011,Oct,0,0,Wednesday,1,Misty,0.52,0.5,0.77,0.194,11,23,34,439,34,34
6876,2011-10-19,Winter,2011,Oct,1,0,Wednesday,1,Misty,0.52,0.5,0.77,0.194,7,9,16,439,16,16
6877,2011-10-19,Winter,2011,Oct,2,0,Wednesday,1,Misty,0.52,0.5,0.77,0.194,1,6,7,439,7,7
6878,2011-10-19,Winter,2011,Oct,4,0,Wednesday,1,Light_rainsnow,0.5,0.4848,0.94,0.194,0,3,3,439,3,3
6879,2011-10-19,Winter,2011,Oct,5,0,Wednesday,1,Light_rainsnow,0.5,0.4848,1.0,0.1045,0,3,3,439,3,3
6880,2011-10-19,Winter,2011,Oct,6,0,Wednesday,1,Light_rainsnow,0.52,0.5,0.83,0.2537,3,28,31,439,31,31
6881,2011-10-19,Winter,2011,Oct,7,0,Wednesday,1,Light_rainsnow,0.52,0.5,0.77,0.2537,1,67,68,439,68,68
6882,2011-10-19,Winter,2011,Oct,8,0,Wednesday,1,Light_rainsnow,0.54,0.5152,0.7,0.4925,10,200,210,439,210,210
6883,2011-10-19,Winter,2011,Oct,9,0,Wednesday,1,Light_rainsnow,0.52,0.5,0.88,0.4925,17,185,202,439,202,202
6884,2011-10-19,Winter,2011,Oct,10,0,Wednesday,1,Light_rainsnow,0.52,0.5,0.88,0.4925,14,109,123,439,123,123
6885,2011-10-19,Winter,2011,Oct,11,0,Wednesday,1,Light_rainsnow,0.52,0.5,0.94,0.2537,33,116,149,439,149,149
6886,2011-10-19,Winter,2011,Oct,12,0,Wednesday,1,Light_rainsnow,0.52,0.5,0.94,0.3284,13,117,130,439,130,130
6887,2011-10-19,Winter,2011,Oct,13,0,Wednesday,1,Misty,0.54,0.5152,0.94,0.2836,20,86,106,439,106,106
6888,2011-10-19,Winter,2011,Oct,14,0,Wednesday,1,Light_rainsnow,0.54,0.5152,0.94,0.1642,17,80,97,439,97,97
6889,2011-10-19,Winter,2011,Oct,15,0,Wednesday,1,Light_rainsnow,0.54,0.5152,1.0,0.1343,21,99,120,439,120,120
6890,2011-10-19,Winter,2011,Oct,16,0,Wednesday,1,Light_rainsnow,0.56,0.5303,0.94,0.1642,21,180,201,439,201,201
6891,2011-10-19,Winter,2011,Oct,17,0,Wednesday,1,Light_rainsnow,0.56,0.5303,0.94,0.1642,11,170,181,439,181,181
6892,2011-10-19,Winter,2011,Oct,18,0,Wednesday,1,Light_rainsnow,0.56,0.5303,1.0,0.1642,8,132,140,439,140,140
6893,2011-10-19,Winter,2011,Oct,19,0,Wednesday,1,Misty,0.6,0.5455,0.88,0.1343,8,189,197,439,197,197
6894,2011-10-19,Winter,2011,Oct,20,0,Wednesday,1,Light_rainsnow,0.6,0.5152,0.94,0.0896,5,140,145,439,145,145
6895,2011-10-19,Winter,2011,Oct,21,0,Wednesday,1,Misty,0.58,0.5455,0.94,0.1343,6,79,85,439,85,85
6896,2011-10-19,Winter,2011,Oct,22,0,Wednesday,1,Misty,0.58,0.5455,0.94,0.3582,13,94,107,439,107,107
6897,2011-10-19,Winter,2011,Oct,23,0,Wednesday,1,Misty,0.58,0.5455,0.94,0.3582,14,55,69,439,69,69
6898,2011-10-20,Winter,2011,Oct,0,0,Thursday,1,Clear,0.56,0.5303,0.94,0.2985,4,22,26,438,26,26
6899,2011-10-20,Winter,2011,Oct,1,0,Thursday,1,Clear,0.56,0.5303,0.88,0.3582,4,11,15,438,15,15
6900,2011-10-20,Winter,2011,Oct,2,0,Thursday,1,Clear,0.56,0.5303,0.88,0.4478,0,4,4,438,4,4
6901,2011-10-20,Winter,2011,Oct,3,0,Thursday,1,Clear,0.5,0.4848,0.82,0.4627,0,1,1,438,1,1
6902,2011-10-20,Winter,2011,Oct,4,0,Thursday,1,Clear,0.5,0.4848,0.82,0.4627,2,6,8,438,8,8
6903,2011-10-20,Winter,2011,Oct,5,0,Thursday,1,Clear,0.48,0.4697,0.82,0.3582,2,24,26,438,26,26
6904,2011-10-20,Winter,2011,Oct,6,0,Thursday,1,Clear,0.44,0.4394,0.82,0.4179,5,87,92,438,92,92
6905,2011-10-20,Winter,2011,Oct,7,0,Thursday,1,Clear,0.42,0.4242,0.77,0.4478,15,303,318,438,318,318
6906,2011-10-20,Winter,2011,Oct,8,0,Thursday,1,Clear,0.44,0.4394,0.67,0.5224,17,409,426,438,426,426
6907,2011-10-20,Winter,2011,Oct,9,0,Thursday,1,Clear,0.44,0.4394,0.67,0.5821,26,197,223,438,223,223
6908,2011-10-20,Winter,2011,Oct,10,0,Thursday,1,Clear,0.46,0.4545,0.59,0.4478,25,105,130,438,130,130
6909,2011-10-20,Winter,2011,Oct,11,0,Thursday,1,Clear,0.48,0.4697,0.55,0.5224,30,99,129,438,129,129
6910,2011-10-20,Winter,2011,Oct,12,0,Thursday,1,Clear,0.48,0.4697,0.48,0.5224,28,171,199,438,199,199
6911,2011-10-20,Winter,2011,Oct,13,0,Thursday,1,Clear,0.5,0.4848,0.45,0.5821,28,136,164,438,164,164
6912,2011-10-20,Winter,2011,Oct,14,0,Thursday,1,Misty,0.48,0.4697,0.48,0.5522,38,117,155,438,155,155
6913,2011-10-20,Winter,2011,Oct,15,0,Thursday,1,Misty,0.48,0.4697,0.51,0.4478,22,138,160,438,160,160
6914,2011-10-20,Winter,2011,Oct,16,0,Thursday,1,Misty,0.48,0.4697,0.51,0.4478,31,203,234,438,234,234
6915,2011-10-20,Winter,2011,Oct,17,0,Thursday,1,Misty,0.48,0.4697,0.48,0.3881,56,438,494,438,494,494
6916,2011-10-20,Winter,2011,Oct,18,0,Thursday,1,Misty,0.46,0.4545,0.51,0.2985,39,430,469,438,469,469
6917,2011-10-20,Winter,2011,Oct,19,0,Thursday,1,Clear,0.46,0.4545,0.51,0.3582,20,278,298,438,298,298
6918,2011-10-20,Winter,2011,Oct,20,0,Thursday,1,Misty,0.46,0.4545,0.51,0.3284,34,207,241,438,241,241
6919,2011-10-20,Winter,2011,Oct,21,0,Thursday,1,Clear,0.44,0.4394,0.51,0.2985,16,149,165,438,165,165
6920,2011-10-20,Winter,2011,Oct,22,0,Thursday,1,Clear,0.44,0.4394,0.51,0.3284,22,106,128,438,128,128
6921,2011-10-20,Winter,2011,Oct,23,0,Thursday,1,Clear,0.42,0.4242,0.58,0.2537,7,83,90,438,90,90
6922,2011-10-21,Winter,2011,Oct,0,0,Friday,1,Clear,0.4,0.4091,0.62,0.2537,8,42,50,437,50,50
6923,2011-10-21,Winter,2011,Oct,1,0,Friday,1,Clear,0.4,0.4091,0.62,0.2239,7,19,26,437,26,26
6924,2011-10-21,Winter,2011,Oct,2,0,Friday,1,Clear,0.38,0.3939,0.66,0.1642,6,12,18,437,18,18
6925,2011-10-21,Winter,2011,Oct,3,0,Friday,1,Clear,0.36,0.3485,0.71,0.1343,0,7,7,437,7,7
6926,2011-10-21,Winter,2011,Oct,4,0,Friday,1,Clear,0.36,0.3485,0.71,0.1642,0,6,6,437,6,6
6927,2011-10-21,Winter,2011,Oct,5,0,Friday,1,Clear,0.34,0.3333,0.76,0.194,0,31,31,437,31,31
6928,2011-10-21,Winter,2011,Oct,6,0,Friday,1,Clear,0.36,0.3485,0.71,0.1642,7,78,85,437,85,85
6929,2011-10-21,Winter,2011,Oct,7,0,Friday,1,Clear,0.36,0.3485,0.71,0.1642,5,228,233,437,233,233
6930,2011-10-21,Winter,2011,Oct,8,0,Friday,1,Clear,0.4,0.4091,0.62,0.194,16,386,402,437,402,402
6931,2011-10-21,Winter,2011,Oct,9,0,Friday,1,Misty,0.42,0.4242,0.58,0.1343,33,189,222,437,222,222
6932,2011-10-21,Winter,2011,Oct,10,0,Friday,1,Clear,0.46,0.4545,0.51,0.1642,32,106,138,437,138,138
6933,2011-10-21,Winter,2011,Oct,11,0,Friday,1,Clear,0.5,0.4848,0.45,0.2239,39,135,174,437,174,174
6934,2011-10-21,Winter,2011,Oct,12,0,Friday,1,Clear,0.5,0.4848,0.45,0.2985,47,193,240,437,240,240
6935,2011-10-21,Winter,2011,Oct,13,0,Friday,1,Clear,0.48,0.4697,0.48,0.3284,43,163,206,437,206,206
6936,2011-10-21,Winter,2011,Oct,14,0,Friday,1,Clear,0.52,0.5,0.42,0.2985,67,131,198,437,198,198
6937,2011-10-21,Winter,2011,Oct,15,0,Friday,1,Clear,0.5,0.4848,0.45,0.2836,57,178,235,437,235,235
6938,2011-10-21,Winter,2011,Oct,16,0,Friday,1,Clear,0.5,0.4848,0.45,0.2537,60,242,302,437,302,302
6939,2011-10-21,Winter,2011,Oct,17,0,Friday,1,Misty,0.46,0.4545,0.51,0.2537,79,445,524,437,524,524
6940,2011-10-21,Winter,2011,Oct,18,0,Friday,1,Misty,0.44,0.4394,0.54,0.2537,43,354,397,437,397,397
6941,2011-10-21,Winter,2011,Oct,19,0,Friday,1,Misty,0.44,0.4394,0.54,0.3881,25,228,253,437,253,253
6942,2011-10-21,Winter,2011,Oct,20,0,Friday,1,Misty,0.44,0.4394,0.54,0.2239,29,155,184,437,184,184
6943,2011-10-21,Winter,2011,Oct,21,0,Friday,1,Clear,0.42,0.4242,0.58,0.1642,31,112,143,437,143,143
6944,2011-10-21,Winter,2011,Oct,22,0,Friday,1,Clear,0.42,0.4242,0.54,0.1642,24,89,113,437,113,113
6945,2011-10-21,Winter,2011,Oct,23,0,Friday,1,Clear,0.4,0.4091,0.62,0.2239,18,99,117,437,117,117
6946,2011-10-22,Winter,2011,Oct,0,0,Saturday,0,Clear,0.4,0.4091,0.62,0.194,16,80,96,436,96,96
6947,2011-10-22,Winter,2011,Oct,1,0,Saturday,0,Clear,0.4,0.4091,0.62,0.194,20,50,70,436,70,70
6948,2011-10-22,Winter,2011,Oct,2,0,Saturday,0,Clear,0.4,0.4091,0.62,0.2537,6,25,31,436,31,31
6949,2011-10-22,Winter,2011,Oct,3,0,Saturday,0,Clear,0.4,0.4091,0.62,0.1343,1,19,20,436,20,20
6950,2011-10-22,Winter,2011,Oct,4,0,Saturday,0,Clear,0.38,0.3939,0.66,0.0896,4,4,8,436,8,8
6951,2011-10-22,Winter,2011,Oct,5,0,Saturday,0,Clear,0.38,0.3939,0.66,0.0,1,7,8,436,8,8
6952,2011-10-22,Winter,2011,Oct,6,0,Saturday,0,Clear,0.36,0.3788,0.71,0.0,1,17,18,436,18,18
6953,2011-10-22,Winter,2011,Oct,7,0,Saturday,0,Clear,0.36,0.3636,0.76,0.1045,8,49,57,436,57,57
6954,2011-10-22,Winter,2011,Oct,8,0,Saturday,0,Clear,0.4,0.4091,0.71,0.0,26,88,114,436,114,114
6955,2011-10-22,Winter,2011,Oct,9,0,Saturday,0,Clear,0.42,0.4242,0.67,0.0896,47,122,169,436,169,169
6956,2011-10-22,Winter,2011,Oct,10,0,Saturday,0,Misty,0.44,0.4394,0.62,0.1045,87,149,236,436,236,236
6957,2011-10-22,Winter,2011,Oct,11,0,Saturday,0,Misty,0.44,0.4394,0.62,0.1045,110,172,282,436,282,282
6958,2011-10-22,Winter,2011,Oct,12,0,Saturday,0,Clear,0.46,0.4545,0.55,0.0896,132,211,343,436,343,343
6959,2011-10-22,Winter,2011,Oct,13,0,Saturday,0,Clear,0.5,0.4848,0.45,0.0,136,186,322,436,322,322
6960,2011-10-22,Winter,2011,Oct,14,0,Saturday,0,Misty,0.48,0.4697,0.48,0.2239,133,177,310,436,310,310
6961,2011-10-22,Winter,2011,Oct,15,0,Saturday,0,Clear,0.48,0.4697,0.51,0.2239,159,223,382,436,382,382
6962,2011-10-22,Winter,2011,Oct,16,0,Saturday,0,Clear,0.5,0.4848,0.45,0.194,169,190,359,436,359,359
6963,2011-10-22,Winter,2011,Oct,17,0,Saturday,0,Clear,0.46,0.4545,0.55,0.1343,143,217,360,436,360,360
6964,2011-10-22,Winter,2011,Oct,18,0,Saturday,0,Clear,0.44,0.4394,0.54,0.0896,111,224,335,436,335,335
6965,2011-10-22,Winter,2011,Oct,19,0,Saturday,0,Clear,0.44,0.4394,0.67,0.0,47,173,220,436,220,220
6966,2011-10-22,Winter,2011,Oct,20,0,Saturday,0,Clear,0.42,0.4242,0.67,0.0,48,111,159,436,159,159
6967,2011-10-22,Winter,2011,Oct,21,0,Saturday,0,Clear,0.4,0.4091,0.76,0.0,37,120,157,436,157,157
6968,2011-10-22,Winter,2011,Oct,22,0,Saturday,0,Clear,0.4,0.4091,0.76,0.0,30,114,144,436,144,144
6969,2011-10-22,Winter,2011,Oct,23,0,Saturday,0,Clear,0.38,0.3939,0.82,0.0,27,81,108,436,108,108
6970,2011-10-23,Winter,2011,Oct,0,0,Sunday,0,Clear,0.36,0.3788,0.87,0.0,24,64,88,435,88,88
6971,2011-10-23,Winter,2011,Oct,1,0,Sunday,0,Clear,0.36,0.3788,0.87,0.0,11,60,71,435,71,71
6972,2011-10-23,Winter,2011,Oct,2,0,Sunday,0,Clear,0.34,0.3485,0.87,0.0896,10,40,50,435,50,50
6973,2011-10-23,Winter,2011,Oct,3,0,Sunday,0,Clear,0.34,0.3636,0.87,0.0,15,31,46,435,46,46
6974,2011-10-23,Winter,2011,Oct,4,0,Sunday,0,Clear,0.34,0.3636,0.87,0.0,5,1,6,435,6,6
6975,2011-10-23,Winter,2011,Oct,5,0,Sunday,0,Clear,0.32,0.3485,0.87,0.0,1,2,3,435,3,3
6976,2011-10-23,Winter,2011,Oct,6,0,Sunday,0,Clear,0.32,0.3333,0.87,0.1045,0,12,12,435,12,12
6977,2011-10-23,Winter,2011,Oct,7,0,Sunday,0,Clear,0.34,0.3485,0.87,0.0896,3,18,21,435,21,21
6978,2011-10-23,Winter,2011,Oct,8,0,Sunday,0,Clear,0.36,0.3485,0.87,0.1343,32,56,88,435,88,88
6979,2011-10-23,Winter,2011,Oct,9,0,Sunday,0,Clear,0.4,0.4091,0.76,0.0,48,95,143,435,143,143
6980,2011-10-23,Winter,2011,Oct,10,0,Sunday,0,Clear,0.42,0.4242,0.71,0.0896,104,185,289,435,289,289
6981,2011-10-23,Winter,2011,Oct,11,0,Sunday,0,Clear,0.46,0.4545,0.72,0.1642,131,202,333,435,333,333
6982,2011-10-23,Winter,2011,Oct,12,0,Sunday,0,Clear,0.5,0.4848,0.59,0.2537,164,249,413,435,413,413
6983,2011-10-23,Winter,2011,Oct,13,0,Sunday,0,Clear,0.52,0.5,0.55,0.194,160,255,415,435,415,415
6984,2011-10-23,Winter,2011,Oct,14,0,Sunday,0,Clear,0.52,0.5,0.55,0.2239,192,216,408,435,408,408
6985,2011-10-23,Winter,2011,Oct,15,0,Sunday,0,Clear,0.52,0.5,0.52,0.1642,171,216,387,435,387,387
6986,2011-10-23,Winter,2011,Oct,16,0,Sunday,0,Clear,0.52,0.5,0.55,0.194,188,217,405,435,405,405
6987,2011-10-23,Winter,2011,Oct,17,0,Sunday,0,Clear,0.5,0.4848,0.63,0.1343,120,220,340,435,340,340
6988,2011-10-23,Winter,2011,Oct,18,0,Sunday,0,Clear,0.5,0.4848,0.63,0.1045,88,196,284,435,284,284
6989,2011-10-23,Winter,2011,Oct,19,0,Sunday,0,Clear,0.46,0.4545,0.77,0.0,53,140,193,435,193,193
6990,2011-10-23,Winter,2011,Oct,20,0,Sunday,0,Clear,0.44,0.4394,0.72,0.0896,32,112,144,435,144,144
6991,2011-10-23,Winter,2011,Oct,21,0,Sunday,0,Clear,0.44,0.4394,0.72,0.0896,24,75,99,435,99,99
6992,2011-10-23,Winter,2011,Oct,22,0,Sunday,0,Clear,0.42,0.4242,0.77,0.1045,25,69,94,435,94,94
6993,2011-10-23,Winter,2011,Oct,23,0,Sunday,0,Clear,0.42,0.4242,0.77,0.1642,18,31,49,435,49,49
6994,2011-10-24,Winter,2011,Oct,0,0,Monday,1,Clear,0.42,0.4242,0.77,0.0,6,26,32,434,32,32
6995,2011-10-24,Winter,2011,Oct,1,0,Monday,1,Clear,0.4,0.4091,0.82,0.1343,7,8,15,434,15,15
6996,2011-10-24,Winter,2011,Oct,2,0,Monday,1,Clear,0.4,0.4091,0.87,0.1045,1,6,7,434,7,7
6997,2011-10-24,Winter,2011,Oct,3,0,Monday,1,Clear,0.4,0.4091,0.82,0.0896,1,3,4,434,4,4
6998,2011-10-24,Winter,2011,Oct,4,0,Monday,1,Clear,0.4,0.4091,0.82,0.0,1,5,6,434,6,6
6999,2011-10-24,Winter,2011,Oct,5,0,Monday,1,Clear,0.38,0.3939,0.87,0.0,2,19,21,434,21,21
7000,2011-10-24,Winter,2011,Oct,6,0,Monday,1,Clear,0.4,0.4091,0.87,0.1045,3,83,86,434,86,86
7001,2011-10-24,Winter,2011,Oct,7,0,Monday,1,Misty,0.38,0.3939,0.94,0.1045,11,274,285,434,285,285
7002,2011-10-24,Winter,2011,Oct,8,0,Monday,1,Misty,0.42,0.4242,0.88,0.1642,20,378,398,434,398,398
7003,2011-10-24,Winter,2011,Oct,9,0,Monday,1,Misty,0.44,0.4394,0.82,0.1642,29,166,195,434,195,195
7004,2011-10-24,Winter,2011,Oct,10,0,Monday,1,Misty,0.46,0.4545,0.82,0.2537,47,82,129,434,129,129
7005,2011-10-24,Winter,2011,Oct,11,0,Monday,1,Misty,0.5,0.4848,0.72,0.1642,59,109,168,434,168,168
7006,2011-10-24,Winter,2011,Oct,12,0,Monday,1,Misty,0.52,0.5,0.68,0.1045,64,156,220,434,220,220
7007,2011-10-24,Winter,2011,Oct,13,0,Monday,1,Misty,0.54,0.5152,0.64,0.2239,60,138,198,434,198,198
7008,2011-10-24,Winter,2011,Oct,14,0,Monday,1,Misty,0.54,0.5152,0.64,0.194,63,143,206,434,206,206
7009,2011-10-24,Winter,2011,Oct,15,0,Monday,1,Clear,0.56,0.5303,0.6,0.1642,52,125,177,434,177,177
7010,2011-10-24,Winter,2011,Oct,16,0,Monday,1,Clear,0.54,0.5152,0.64,0.194,68,242,310,434,310,310
7011,2011-10-24,Winter,2011,Oct,17,0,Monday,1,Clear,0.52,0.5,0.68,0.1343,87,527,614,434,614,614
7012,2011-10-24,Winter,2011,Oct,18,0,Monday,1,Clear,0.54,0.5152,0.6,0.0896,58,428,486,434,486,486
7013,2011-10-24,Winter,2011,Oct,19,0,Monday,1,Light_rainsnow,0.48,0.4697,0.82,0.0,25,212,237,434,237,237
7014,2011-10-24,Winter,2011,Oct,20,0,Monday,1,Clear,0.48,0.4697,0.82,0.1045,11,118,129,434,129,129
7015,2011-10-24,Winter,2011,Oct,21,0,Monday,1,Clear,0.46,0.4545,0.87,0.1045,12,114,126,434,126,126
7016,2011-10-24,Winter,2011,Oct,22,0,Monday,1,Clear,0.48,0.4697,0.75,0.1642,3,76,79,434,79,79
7017,2011-10-24,Winter,2011,Oct,23,0,Monday,1,Clear,0.46,0.4545,0.77,0.0896,9,50,59,434,59,59
7018,2011-10-25,Winter,2011,Oct,0,0,Tuesday,1,Clear,0.44,0.4394,0.77,0.1343,4,26,30,433,30,30
7019,2011-10-25,Winter,2011,Oct,1,0,Tuesday,1,Clear,0.44,0.4394,0.77,0.1343,5,6,11,433,11,11
7020,2011-10-25,Winter,2011,Oct,2,0,Tuesday,1,Clear,0.42,0.4242,0.82,0.1343,2,3,5,433,5,5
7021,2011-10-25,Winter,2011,Oct,3,0,Tuesday,1,Clear,0.4,0.4091,0.87,0.0,1,3,4,433,4,4
7022,2011-10-25,Winter,2011,Oct,4,0,Tuesday,1,Clear,0.38,0.3939,0.87,0.1343,0,5,5,433,5,5
7023,2011-10-25,Winter,2011,Oct,5,0,Tuesday,1,Clear,0.38,0.3939,0.87,0.1343,0,24,24,433,24,24
7024,2011-10-25,Winter,2011,Oct,6,0,Tuesday,1,Clear,0.38,0.3939,0.82,0.1045,3,95,98,433,98,98
7025,2011-10-25,Winter,2011,Oct,7,0,Tuesday,1,Clear,0.4,0.4091,0.76,0.194,15,299,314,433,314,314
7026,2011-10-25,Winter,2011,Oct,8,0,Tuesday,1,Clear,0.44,0.4394,0.72,0.0,25,383,408,433,408,408
7027,2011-10-25,Winter,2011,Oct,9,0,Tuesday,1,Clear,0.48,0.4697,0.55,0.2239,29,194,223,433,223,223
7028,2011-10-25,Winter,2011,Oct,10,0,Tuesday,1,Clear,0.5,0.4848,0.51,0.2537,26,102,128,433,128,128
7029,2011-10-25,Winter,2011,Oct,11,0,Tuesday,1,Clear,0.52,0.5,0.48,0.2836,46,120,166,433,166,166
7030,2011-10-25,Winter,2011,Oct,12,0,Tuesday,1,Clear,0.54,0.5152,0.39,0.3582,35,165,200,433,200,200
7031,2011-10-25,Winter,2011,Oct,13,0,Tuesday,1,Clear,0.56,0.5303,0.37,0.3881,37,161,198,433,198,198
7032,2011-10-25,Winter,2011,Oct,14,0,Tuesday,1,Clear,0.56,0.5303,0.4,0.2537,66,134,200,433,200,200
7033,2011-10-25,Winter,2011,Oct,15,0,Tuesday,1,Clear,0.56,0.5303,0.37,0.1045,63,171,234,433,234,234
7034,2011-10-25,Winter,2011,Oct,16,0,Tuesday,1,Clear,0.56,0.5303,0.37,0.194,52,233,285,433,285,285
7035,2011-10-25,Winter,2011,Oct,17,0,Tuesday,1,Clear,0.56,0.5303,0.37,0.1045,68,517,585,433,585,585
7036,2011-10-25,Winter,2011,Oct,18,0,Tuesday,1,Clear,0.52,0.5,0.42,0.1045,65,453,518,433,518,518
7037,2011-10-25,Winter,2011,Oct,19,0,Tuesday,1,Clear,0.48,0.4697,0.67,0.194,44,294,338,433,338,338
7038,2011-10-25,Winter,2011,Oct,20,0,Tuesday,1,Clear,0.46,0.4545,0.67,0.1045,40,208,248,433,248,248
7039,2011-10-25,Winter,2011,Oct,21,0,Tuesday,1,Clear,0.44,0.4394,0.72,0.1343,32,169,201,433,201,201
7040,2011-10-25,Winter,2011,Oct,22,0,Tuesday,1,Clear,0.46,0.4545,0.67,0.194,22,148,170,433,170,170
7041,2011-10-25,Winter,2011,Oct,23,0,Tuesday,1,Clear,0.44,0.4394,0.72,0.1343,15,79,94,433,94,94
7042,2011-10-26,Winter,2011,Oct,0,0,Wednesday,1,Clear,0.44,0.4394,0.72,0.194,4,28,32,432,32,32
7043,2011-10-26,Winter,2011,Oct,1,0,Wednesday,1,Clear,0.44,0.4394,0.67,0.2537,3,9,12,432,12,12
7044,2011-10-26,Winter,2011,Oct,2,0,Wednesday,1,Clear,0.44,0.4394,0.67,0.1642,2,1,3,432,3,3
7045,2011-10-26,Winter,2011,Oct,3,0,Wednesday,1,Clear,0.44,0.4394,0.67,0.2239,0,3,3,432,3,3
7046,2011-10-26,Winter,2011,Oct,4,0,Wednesday,1,Clear,0.42,0.4242,0.71,0.2537,0,5,5,432,5,5
7047,2011-10-26,Winter,2011,Oct,5,0,Wednesday,1,Clear,0.42,0.4242,0.71,0.2239,0,21,21,432,21,21
7048,2011-10-26,Winter,2011,Oct,6,0,Wednesday,1,Clear,0.42,0.4242,0.71,0.2239,0,92,92,432,92,92
7049,2011-10-26,Winter,2011,Oct,7,0,Wednesday,1,Clear,0.42,0.4242,0.71,0.1642,15,284,299,432,299,299
7050,2011-10-26,Winter,2011,Oct,8,0,Wednesday,1,Misty,0.44,0.4394,0.67,0.194,26,438,464,432,464,464
7051,2011-10-26,Winter,2011,Oct,9,0,Wednesday,1,Misty,0.48,0.4697,0.63,0.2239,14,226,240,432,240,240
7052,2011-10-26,Winter,2011,Oct,10,0,Wednesday,1,Misty,0.52,0.5,0.62,0.2537,26,105,131,432,131,131
7053,2011-10-26,Winter,2011,Oct,11,0,Wednesday,1,Clear,0.52,0.5,0.59,0.3284,23,132,155,432,155,155
7054,2011-10-26,Winter,2011,Oct,12,0,Wednesday,1,Light_rainsnow,0.58,0.5455,0.53,0.2239,39,155,194,432,194,194
7055,2011-10-26,Winter,2011,Oct,13,0,Wednesday,1,Light_rainsnow,0.56,0.5303,0.6,0.1045,20,62,82,432,82,82
7056,2011-10-26,Winter,2011,Oct,14,0,Wednesday,1,Misty,0.52,0.5,0.77,0.0,14,52,66,432,66,66
7057,2011-10-26,Winter,2011,Oct,15,0,Wednesday,1,Misty,0.52,0.5,0.77,0.0,11,59,70,432,70,70
7058,2011-10-26,Winter,2011,Oct,16,0,Wednesday,1,Misty,0.52,0.5,0.77,0.0896,17,196,213,432,213,213
7059,2011-10-26,Winter,2011,Oct,17,0,Wednesday,1,Misty,0.52,0.5,0.77,0.1045,40,414,454,432,454,454
7060,2011-10-26,Winter,2011,Oct,18,0,Wednesday,1,Clear,0.52,0.5,0.77,0.1642,55,398,453,432,453,453
7061,2011-10-26,Winter,2011,Oct,19,0,Wednesday,1,Clear,0.5,0.4848,0.82,0.0,25,306,331,432,331,331
7062,2011-10-26,Winter,2011,Oct,20,0,Wednesday,1,Clear,0.5,0.4848,0.88,0.0,27,180,207,432,207,207
7063,2011-10-26,Winter,2011,Oct,21,0,Wednesday,1,Misty,0.52,0.5,0.77,0.0,17,140,157,432,157,157
7064,2011-10-26,Winter,2011,Oct,22,0,Wednesday,1,Misty,0.48,0.4697,0.88,0.0896,23,112,135,432,135,135
7065,2011-10-26,Winter,2011,Oct,23,0,Wednesday,1,Misty,0.48,0.4697,0.88,0.0896,3,72,75,432,75,75
7066,2011-10-27,Winter,2011,Oct,0,0,Thursday,1,Clear,0.46,0.4545,0.94,0.0,3,23,26,431,26,26
7067,2011-10-27,Winter,2011,Oct,1,0,Thursday,1,Clear,0.46,0.4545,0.94,0.0,2,9,11,431,11,11
7068,2011-10-27,Winter,2011,Oct,2,0,Thursday,1,Light_rainsnow,0.46,0.4545,0.94,0.0,3,5,8,431,8,8
7069,2011-10-27,Winter,2011,Oct,3,0,Thursday,1,Light_rainsnow,0.46,0.4545,0.94,0.0,1,3,4,431,4,4
7070,2011-10-27,Winter,2011,Oct,4,0,Thursday,1,Light_rainsnow,0.48,0.4697,0.88,0.0,1,3,4,431,4,4
7071,2011-10-27,Winter,2011,Oct,5,0,Thursday,1,Light_rainsnow,0.48,0.4697,0.88,0.0896,1,14,15,431,15,15
7072,2011-10-27,Winter,2011,Oct,6,0,Thursday,1,Light_rainsnow,0.5,0.4848,0.82,0.0,4,42,46,431,46,46
7073,2011-10-27,Winter,2011,Oct,7,0,Thursday,1,Misty,0.46,0.4545,0.94,0.0896,9,128,137,431,137,137
7074,2011-10-27,Winter,2011,Oct,8,0,Thursday,1,Light_rainsnow,0.48,0.4697,0.88,0.194,12,304,316,431,316,316
7075,2011-10-27,Winter,2011,Oct,9,0,Thursday,1,Misty,0.5,0.4848,0.82,0.1642,16,155,171,431,171,171
7076,2011-10-27,Winter,2011,Oct,10,0,Thursday,1,Light_rainsnow,0.5,0.4848,0.88,0.194,10,52,62,431,62,62
7077,2011-10-27,Winter,2011,Oct,11,0,Thursday,1,Light_rainsnow,0.5,0.4848,0.88,0.1343,8,44,52,431,52,52
7078,2011-10-27,Winter,2011,Oct,12,0,Thursday,1,Light_rainsnow,0.5,0.4848,0.88,0.1343,8,45,53,431,53,53
7079,2011-10-27,Winter,2011,Oct,13,0,Thursday,1,Misty,0.5,0.4848,0.88,0.1642,10,64,74,431,74,74
7080,2011-10-27,Winter,2011,Oct,14,0,Thursday,1,Misty,0.52,0.5,0.83,0.0,16,76,92,431,92,92
7081,2011-10-27,Winter,2011,Oct,15,0,Thursday,1,Misty,0.52,0.5,0.83,0.1045,12,95,107,431,107,107
7082,2011-10-27,Winter,2011,Oct,16,0,Thursday,1,Misty,0.56,0.5303,0.73,0.1642,14,193,207,431,207,207
7083,2011-10-27,Winter,2011,Oct,17,0,Thursday,1,Misty,0.5,0.4848,0.72,0.4627,31,291,322,431,322,322
7084,2011-10-27,Winter,2011,Oct,18,0,Thursday,1,Misty,0.48,0.4697,0.67,0.4627,14,226,240,431,240,240
7085,2011-10-27,Winter,2011,Oct,19,0,Thursday,1,Misty,0.44,0.4394,0.67,0.4627,19,200,219,431,219,219
7086,2011-10-27,Winter,2011,Oct,20,0,Thursday,1,Clear,0.42,0.4242,0.67,0.4925,11,171,182,431,182,182
7087,2011-10-27,Winter,2011,Oct,21,0,Thursday,1,Clear,0.4,0.4091,0.62,0.5224,13,119,132,431,132,132
7088,2011-10-27,Winter,2011,Oct,22,0,Thursday,1,Clear,0.36,0.3182,0.66,0.4925,14,97,111,431,111,111
7089,2011-10-27,Winter,2011,Oct,23,0,Thursday,1,Clear,0.34,0.303,0.61,0.4179,8,60,68,431,68,68
7090,2011-10-28,Winter,2011,Oct,0,0,Friday,1,Clear,0.34,0.3182,0.66,0.2537,4,40,44,430,44,44
7091,2011-10-28,Winter,2011,Oct,1,0,Friday,1,Clear,0.32,0.303,0.66,0.2537,7,9,16,430,16,16
7092,2011-10-28,Winter,2011,Oct,2,0,Friday,1,Clear,0.32,0.303,0.66,0.2836,1,3,4,430,4,4
7093,2011-10-28,Winter,2011,Oct,3,0,Friday,1,Clear,0.3,0.2879,0.7,0.2836,4,4,8,430,8,8
7094,2011-10-28,Winter,2011,Oct,4,0,Friday,1,Clear,0.3,0.2879,0.65,0.2836,5,5,10,430,10,10
7095,2011-10-28,Winter,2011,Oct,5,0,Friday,1,Misty,0.3,0.2879,0.61,0.2537,0,25,25,430,25,25
7096,2011-10-28,Winter,2011,Oct,6,0,Friday,1,Clear,0.28,0.2727,0.65,0.2537,1,74,75,430,75,75
7097,2011-10-28,Winter,2011,Oct,7,0,Friday,1,Clear,0.28,0.2727,0.65,0.2537,6,199,205,430,205,205
7098,2011-10-28,Winter,2011,Oct,8,0,Friday,1,Clear,0.3,0.2879,0.61,0.2836,13,361,374,430,374,374
7099,2011-10-28,Winter,2011,Oct,9,0,Friday,1,Clear,0.32,0.303,0.57,0.2239,19,210,229,430,229,229
7100,2011-10-28,Winter,2011,Oct,10,0,Friday,1,Clear,0.34,0.3182,0.57,0.2239,28,102,130,430,130,130
7101,2011-10-28,Winter,2011,Oct,11,0,Friday,1,Clear,0.36,0.3485,0.5,0.2239,40,128,168,430,168,168
7102,2011-10-28,Winter,2011,Oct,12,0,Friday,1,Misty,0.38,0.3939,0.4,0.1642,46,167,213,430,213,213
7103,2011-10-28,Winter,2011,Oct,13,0,Friday,1,Misty,0.38,0.3939,0.42,0.2239,43,185,228,430,228,228
7104,2011-10-28,Winter,2011,Oct,14,0,Friday,1,Misty,0.36,0.3485,0.46,0.194,33,152,185,430,185,185
7105,2011-10-28,Winter,2011,Oct,15,0,Friday,1,Misty,0.36,0.3333,0.43,0.2537,44,171,215,430,215,215
7106,2011-10-28,Winter,2011,Oct,16,0,Friday,1,Misty,0.36,0.3485,0.46,0.1642,46,262,308,430,308,308
7107,2011-10-28,Winter,2011,Oct,17,0,Friday,1,Misty,0.36,0.3485,0.5,0.1343,35,411,446,430,446,446
7108,2011-10-28,Winter,2011,Oct,18,0,Friday,1,Misty,0.36,0.3485,0.53,0.1642,36,332,368,430,368,368
7109,2011-10-28,Winter,2011,Oct,19,0,Friday,1,Misty,0.36,0.3485,0.5,0.1343,16,188,204,430,204,204
7110,2011-10-28,Winter,2011,Oct,20,0,Friday,1,Light_rainsnow,0.34,0.3182,0.61,0.2239,12,131,143,430,143,143
7111,2011-10-28,Winter,2011,Oct,21,0,Friday,1,Light_rainsnow,0.32,0.3182,0.7,0.1642,5,69,74,430,74,74
7112,2011-10-28,Winter,2011,Oct,22,0,Friday,1,Light_rainsnow,0.3,0.2879,0.75,0.2836,4,32,36,430,36,36
7113,2011-10-28,Winter,2011,Oct,23,0,Friday,1,Light_rainsnow,0.3,0.2727,0.81,0.3284,8,31,39,430,39,39
7114,2011-10-29,Winter,2011,Oct,0,0,Saturday,0,Light_rainsnow,0.28,0.2576,0.87,0.2985,0,19,19,429,19,19
7115,2011-10-29,Winter,2011,Oct,1,0,Saturday,0,Light_rainsnow,0.3,0.2727,0.87,0.2985,0,18,18,429,18,18
7116,2011-10-29,Winter,2011,Oct,2,0,Saturday,0,Light_rainsnow,0.3,0.2727,0.87,0.2985,1,16,17,429,17,17
7117,2011-10-29,Winter,2011,Oct,3,0,Saturday,0,Light_rainsnow,0.3,0.2727,0.81,0.4179,0,8,8,429,8,8
7118,2011-10-29,Winter,2011,Oct,4,0,Saturday,0,Light_rainsnow,0.3,0.2727,0.81,0.4179,0,1,1,429,1,1
7119,2011-10-29,Winter,2011,Oct,5,0,Saturday,0,Light_rainsnow,0.26,0.2273,0.93,0.3582,0,1,1,429,1,1
7120,2011-10-29,Winter,2011,Oct,6,0,Saturday,0,Light_rainsnow,0.26,0.2273,0.87,0.3582,4,1,5,429,5,5
7121,2011-10-29,Winter,2011,Oct,7,0,Saturday,0,Light_rainsnow,0.26,0.2273,0.87,0.3582,1,6,7,429,7,7
7122,2011-10-29,Winter,2011,Oct,8,0,Saturday,0,Light_rainsnow,0.28,0.2576,0.87,0.3582,4,16,20,429,20,20
7123,2011-10-29,Winter,2011,Oct,9,0,Saturday,0,Light_rainsnow,0.28,0.2576,0.87,0.3582,1,19,20,429,20,20
7124,2011-10-29,Winter,2011,Oct,10,0,Saturday,0,Light_rainsnow,0.26,0.2273,0.93,0.3284,0,12,12,429,12,12
7125,2011-10-29,Winter,2011,Oct,11,0,Saturday,0,Light_rainsnow,0.26,0.2273,0.93,0.3881,1,26,27,429,27,27
7126,2011-10-29,Winter,2011,Oct,12,0,Saturday,0,Light_rainsnow,0.24,0.197,0.87,0.4925,6,44,50,429,50,50
7127,2011-10-29,Winter,2011,Oct,13,0,Saturday,0,Light_rainsnow,0.24,0.197,0.87,0.5224,0,30,30,429,30,30
7128,2011-10-29,Winter,2011,Oct,14,0,Saturday,0,Light_rainsnow,0.24,0.197,0.87,0.4478,0,29,29,429,29,29
7129,2011-10-29,Winter,2011,Oct,15,0,Saturday,0,Light_rainsnow,0.22,0.2121,0.93,0.2537,3,38,41,429,41,41
7130,2011-10-29,Winter,2011,Oct,16,0,Saturday,0,Light_rainsnow,0.22,0.197,0.93,0.3284,3,19,22,429,22,22
7131,2011-10-29,Winter,2011,Oct,17,0,Saturday,0,Light_rainsnow,0.22,0.197,0.93,0.3284,3,28,31,429,31,31
7132,2011-10-29,Winter,2011,Oct,18,0,Saturday,0,Light_rainsnow,0.22,0.197,0.93,0.3284,6,37,43,429,43,43
7133,2011-10-29,Winter,2011,Oct,19,0,Saturday,0,Clear,0.24,0.2121,0.87,0.3582,3,36,39,429,39,39
7134,2011-10-29,Winter,2011,Oct,20,0,Saturday,0,Clear,0.24,0.2121,0.87,0.3582,7,40,47,429,47,47
7135,2011-10-29,Winter,2011,Oct,21,0,Saturday,0,Clear,0.24,0.2121,0.87,0.3582,1,49,50,429,50,50
7136,2011-10-29,Winter,2011,Oct,22,0,Saturday,0,Clear,0.22,0.2121,0.87,0.2239,10,44,54,429,54,54
7137,2011-10-29,Winter,2011,Oct,23,0,Saturday,0,Clear,0.22,0.2273,0.87,0.194,3,33,36,429,36,36
7138,2011-10-30,Winter,2011,Oct,0,0,Sunday,0,Clear,0.22,0.2121,0.87,0.2239,7,47,54,428,54,54
7139,2011-10-30,Winter,2011,Oct,1,0,Sunday,0,Clear,0.22,0.2121,0.87,0.2537,9,34,43,428,43,43
7140,2011-10-30,Winter,2011,Oct,2,0,Sunday,0,Clear,0.22,0.2121,0.87,0.2836,7,43,50,428,50,50
7141,2011-10-30,Winter,2011,Oct,3,0,Sunday,0,Clear,0.24,0.2121,0.75,0.3582,7,26,33,428,33,33
7142,2011-10-30,Winter,2011,Oct,4,0,Sunday,0,Clear,0.22,0.197,0.8,0.3284,1,10,11,428,11,11
7143,2011-10-30,Winter,2011,Oct,5,0,Sunday,0,Clear,0.24,0.2121,0.75,0.2985,0,4,4,428,4,4
7144,2011-10-30,Winter,2011,Oct,6,0,Sunday,0,Clear,0.24,0.2273,0.75,0.2537,2,8,10,428,10,10
7145,2011-10-30,Winter,2011,Oct,7,0,Sunday,0,Clear,0.24,0.2879,0.75,0.0,7,15,22,428,22,22
7146,2011-10-30,Winter,2011,Oct,8,0,Sunday,0,Clear,0.26,0.2576,0.7,0.2239,20,60,80,428,80,80
7147,2011-10-30,Winter,2011,Oct,9,0,Sunday,0,Clear,0.3,0.2879,0.65,0.2537,55,92,147,428,147,147
7148,2011-10-30,Winter,2011,Oct,10,0,Sunday,0,Clear,0.32,0.3333,0.61,0.0896,53,125,178,428,178,178
7149,2011-10-30,Winter,2011,Oct,11,0,Sunday,0,Clear,0.36,0.3485,0.53,0.2239,58,182,240,428,240,240
7150,2011-10-30,Winter,2011,Oct,12,0,Sunday,0,Clear,0.38,0.3939,0.5,0.194,85,229,314,428,314,314
7151,2011-10-30,Winter,2011,Oct,13,0,Sunday,0,Clear,0.4,0.4091,0.43,0.2239,113,232,345,428,345,345
7152,2011-10-30,Winter,2011,Oct,14,0,Sunday,0,Clear,0.42,0.4242,0.38,0.194,91,209,300,428,300,300
7153,2011-10-30,Winter,2011,Oct,15,0,Sunday,0,Clear,0.42,0.4242,0.35,0.1642,88,202,290,428,290,290
7154,2011-10-30,Winter,2011,Oct,16,0,Sunday,0,Clear,0.42,0.4242,0.32,0.1343,107,213,320,428,320,320
7155,2011-10-30,Winter,2011,Oct,17,0,Sunday,0,Clear,0.4,0.4091,0.35,0.1045,54,191,245,428,245,245
7156,2011-10-30,Winter,2011,Oct,18,0,Sunday,0,Clear,0.36,0.3485,0.4,0.1343,51,162,213,428,213,213
7157,2011-10-30,Winter,2011,Oct,19,0,Sunday,0,Clear,0.56,0.5303,0.49,0.2985,28,125,153,428,153,153
7158,2011-10-30,Winter,2011,Oct,20,0,Sunday,0,Clear,0.34,0.3636,0.57,0.0,18,74,92,428,92,92
7159,2011-10-30,Winter,2011,Oct,21,0,Sunday,0,Clear,0.32,0.3485,0.66,0.0,4,75,79,428,79,79
7160,2011-10-30,Winter,2011,Oct,22,0,Sunday,0,Clear,0.3,0.3333,0.75,0.0,13,58,71,428,71,71
7161,2011-10-30,Winter,2011,Oct,23,0,Sunday,0,Clear,0.26,0.303,0.87,0.0,7,30,37,428,37,37
7162,2011-10-31,Winter,2011,Oct,0,0,Monday,1,Clear,0.26,0.303,0.87,0.0,3,20,23,427,23,23
7163,2011-10-31,Winter,2011,Oct,1,0,Monday,1,Clear,0.26,0.303,0.81,0.0,5,8,13,427,13,13
7164,2011-10-31,Winter,2011,Oct,2,0,Monday,1,Clear,0.24,0.2879,0.87,0.0,0,3,3,427,3,3
7165,2011-10-31,Winter,2011,Oct,3,0,Monday,1,Clear,0.24,0.2576,0.87,0.1045,0,3,3,427,3,3
7166,2011-10-31,Winter,2011,Oct,4,0,Monday,1,Clear,0.24,0.2879,0.87,0.0,1,5,6,427,6,6
7167,2011-10-31,Winter,2011,Oct,5,0,Monday,1,Clear,0.22,0.2727,0.93,0.0,0,18,18,427,18,18
7168,2011-10-31,Winter,2011,Oct,6,0,Monday,1,Clear,0.24,0.2879,0.87,0.0,4,82,86,427,86,86
7169,2011-10-31,Winter,2011,Oct,7,0,Monday,1,Clear,0.24,0.2879,0.93,0.0,11,216,227,427,227,227
7170,2011-10-31,Winter,2011,Oct,8,0,Monday,1,Misty,0.28,0.3182,0.87,0.0,17,355,372,427,372,372
7171,2011-10-31,Winter,2011,Oct,9,0,Monday,1,Misty,0.32,0.3182,0.76,0.1642,14,197,211,427,211,211
7172,2011-10-31,Winter,2011,Oct,10,0,Monday,1,Misty,0.36,0.3485,0.57,0.1642,18,87,105,427,105,105
7173,2011-10-31,Winter,2011,Oct,11,0,Monday,1,Clear,0.4,0.4091,0.5,0.1343,31,97,128,427,128,128
7174,2011-10-31,Winter,2011,Oct,12,0,Monday,1,Clear,0.42,0.4242,0.44,0.2239,30,140,170,427,170,170
7175,2011-10-31,Winter,2011,Oct,13,0,Monday,1,Misty,0.44,0.4394,0.44,0.2239,24,128,152,427,152,152
7176,2011-10-31,Winter,2011,Oct,14,0,Monday,1,Misty,0.44,0.4394,0.47,0.2239,22,119,141,427,141,141
7177,2011-10-31,Winter,2011,Oct,15,0,Monday,1,Clear,0.44,0.4394,0.47,0.1642,27,141,168,427,168,168
7178,2011-10-31,Winter,2011,Oct,16,0,Monday,1,Clear,0.42,0.4242,0.54,0.1642,30,242,272,427,272,272
7179,2011-10-31,Winter,2011,Oct,17,0,Monday,1,Clear,0.42,0.4242,0.54,0.1343,44,442,486,427,486,486
7180,2011-10-31,Winter,2011,Oct,18,0,Monday,1,Clear,0.4,0.4091,0.66,0.0896,30,392,422,427,422,422
7181,2011-10-31,Winter,2011,Oct,19,0,Monday,1,Clear,0.4,0.4091,0.66,0.0896,12,226,238,427,238,238
7182,2011-10-31,Winter,2011,Oct,20,0,Monday,1,Clear,0.4,0.4091,0.66,0.0896,18,154,172,427,172,172
7183,2011-10-31,Winter,2011,Oct,21,0,Monday,1,Misty,0.36,0.3485,0.76,0.194,7,109,116,427,116,116
7184,2011-10-31,Winter,2011,Oct,22,0,Monday,1,Misty,0.36,0.3485,0.76,0.194,8,77,85,427,85,85
7185,2011-10-31,Winter,2011,Oct,23,0,Monday,1,Misty,0.36,0.3485,0.76,0.194,6,46,52,427,52,52
7186,2011-11-01,Winter,2011,Nov,0,0,Tuesday,1,Misty,0.36,0.3485,0.87,0.1642,3,18,21,426,21,21
7187,2011-11-01,Winter,2011,Nov,1,0,Tuesday,1,Clear,0.36,0.3485,0.81,0.1343,3,8,11,426,11,11
7188,2011-11-01,Winter,2011,Nov,2,0,Tuesday,1,Misty,0.36,0.3485,0.81,0.1642,1,3,4,426,4,4
7189,2011-11-01,Winter,2011,Nov,3,0,Tuesday,1,Misty,0.36,0.3485,0.81,0.1343,1,5,6,426,6,6
7190,2011-11-01,Winter,2011,Nov,4,0,Tuesday,1,Clear,0.34,0.3182,0.81,0.2239,1,7,8,426,8,8
7191,2011-11-01,Winter,2011,Nov,5,0,Tuesday,1,Clear,0.32,0.3182,0.81,0.194,0,18,18,426,18,18
7192,2011-11-01,Winter,2011,Nov,6,0,Tuesday,1,Clear,0.32,0.3182,0.81,0.194,3,90,93,426,93,93
7193,2011-11-01,Winter,2011,Nov,7,0,Tuesday,1,Clear,0.34,0.3333,0.76,0.194,8,246,254,426,254,254
7194,2011-11-01,Winter,2011,Nov,8,0,Tuesday,1,Clear,0.36,0.3333,0.71,0.2537,17,402,419,426,419,419
7195,2011-11-01,Winter,2011,Nov,9,0,Tuesday,1,Clear,0.4,0.4091,0.66,0.1642,16,206,222,426,222,222
7196,2011-11-01,Winter,2011,Nov,10,0,Tuesday,1,Clear,0.44,0.4394,0.62,0.1343,21,114,135,426,135,135
7197,2011-11-01,Winter,2011,Nov,11,0,Tuesday,1,Clear,0.46,0.4545,0.63,0.1045,16,101,117,426,117,117
7198,2011-11-01,Winter,2011,Nov,12,0,Tuesday,1,Clear,0.5,0.4848,0.48,0.0896,23,153,176,426,176,176
7199,2011-11-01,Winter,2011,Nov,13,0,Tuesday,1,Clear,0.48,0.4697,0.55,0.194,20,147,167,426,167,167
7200,2011-11-01,Winter,2011,Nov,14,0,Tuesday,1,Clear,0.5,0.4848,0.48,0.2537,32,118,150,426,150,150
7201,2011-11-01,Winter,2011,Nov,15,0,Tuesday,1,Clear,0.5,0.4848,0.45,0.1343,38,148,186,426,186,186
7202,2011-11-01,Winter,2011,Nov,16,0,Tuesday,1,Clear,0.48,0.4697,0.44,0.1642,46,252,298,426,298,298
7203,2011-11-01,Winter,2011,Nov,17,0,Tuesday,1,Clear,0.44,0.4394,0.54,0.1642,36,470,506,426,506,506
7204,2011-11-01,Winter,2011,Nov,18,0,Tuesday,1,Clear,0.42,0.4242,0.58,0.1045,39,421,460,426,460,460
7205,2011-11-01,Winter,2011,Nov,19,0,Tuesday,1,Clear,0.42,0.4242,0.58,0.0896,39,274,313,426,313,313
7206,2011-11-01,Winter,2011,Nov,20,0,Tuesday,1,Clear,0.4,0.4091,0.71,0.0,18,191,209,426,209,209
7207,2011-11-01,Winter,2011,Nov,21,0,Tuesday,1,Clear,0.36,0.3788,0.81,0.0,13,114,127,426,127,127
7208,2011-11-01,Winter,2011,Nov,22,0,Tuesday,1,Clear,0.36,0.3788,0.81,0.0,5,91,96,426,96,96
7209,2011-11-01,Winter,2011,Nov,23,0,Tuesday,1,Clear,0.34,0.3636,0.87,0.0,11,61,72,426,72,72
7210,2011-11-02,Winter,2011,Nov,0,0,Wednesday,1,Clear,0.32,0.3485,0.87,0.0,0,19,19,425,19,19
7211,2011-11-02,Winter,2011,Nov,1,0,Wednesday,1,Clear,0.3,0.3333,0.87,0.0,2,8,10,425,10,10
7212,2011-11-02,Winter,2011,Nov,2,0,Wednesday,1,Clear,0.3,0.3333,0.87,0.0,0,2,2,425,2,2
7213,2011-11-02,Winter,2011,Nov,3,0,Wednesday,1,Clear,0.3,0.3333,0.75,0.0,0,2,2,425,2,2
7214,2011-11-02,Winter,2011,Nov,4,0,Wednesday,1,Clear,0.3,0.3333,0.87,0.0,0,4,4,425,4,4
7215,2011-11-02,Winter,2011,Nov,5,0,Wednesday,1,Clear,0.3,0.3333,0.81,0.0,0,27,27,425,27,27
7216,2011-11-02,Winter,2011,Nov,6,0,Wednesday,1,Clear,0.3,0.3333,0.81,0.0,1,91,92,425,92,92
7217,2011-11-02,Winter,2011,Nov,7,0,Wednesday,1,Clear,0.3,0.3333,0.81,0.0,11,240,251,425,251,251
7218,2011-11-02,Winter,2011,Nov,8,0,Wednesday,1,Clear,0.32,0.3485,0.87,0.0,20,452,472,425,472,472
7219,2011-11-02,Winter,2011,Nov,9,0,Wednesday,1,Clear,0.34,0.3636,0.87,0.0,15,213,228,425,228,228
7220,2011-11-02,Winter,2011,Nov,10,0,Wednesday,1,Clear,0.4,0.4091,0.71,0.0896,25,108,133,425,133,133
7221,2011-11-02,Winter,2011,Nov,11,0,Wednesday,1,Clear,0.42,0.4242,0.71,0.1343,27,117,144,425,144,144
7222,2011-11-02,Winter,2011,Nov,12,0,Wednesday,1,Clear,0.46,0.4545,0.55,0.1642,32,157,189,425,189,189
7223,2011-11-02,Winter,2011,Nov,13,0,Wednesday,1,Clear,0.48,0.4697,0.48,0.1642,22,139,161,425,161,161
7224,2011-11-02,Winter,2011,Nov,14,0,Wednesday,1,Clear,0.5,0.4848,0.45,0.1642,40,132,172,425,172,172
7225,2011-11-02,Winter,2011,Nov,15,0,Wednesday,1,Clear,0.48,0.4697,0.51,0.1642,26,161,187,425,187,187
7226,2011-11-02,Winter,2011,Nov,16,0,Wednesday,1,Clear,0.48,0.4697,0.51,0.1045,35,231,266,425,266,266
7227,2011-11-02,Winter,2011,Nov,17,0,Wednesday,1,Clear,0.44,0.4394,0.62,0.194,30,523,553,425,553,553
7228,2011-11-02,Winter,2011,Nov,18,0,Wednesday,1,Clear,0.42,0.4242,0.71,0.1642,31,448,479,425,479,479
7229,2011-11-02,Winter,2011,Nov,19,0,Wednesday,1,Clear,0.4,0.4091,0.76,0.1343,25,257,282,425,282,282
7230,2011-11-02,Winter,2011,Nov,20,0,Wednesday,1,Clear,0.4,0.4091,0.66,0.1343,5,177,182,425,182,182
7231,2011-11-02,Winter,2011,Nov,21,0,Wednesday,1,Clear,0.38,0.3939,0.71,0.1343,13,155,168,425,168,168
7232,2011-11-02,Winter,2011,Nov,22,0,Wednesday,1,Clear,0.36,0.3485,0.71,0.1343,7,99,106,425,106,106
7233,2011-11-02,Winter,2011,Nov,23,0,Wednesday,1,Clear,0.36,0.3636,0.76,0.0896,3,54,57,425,57,57
7234,2011-11-03,Winter,2011,Nov,0,0,Thursday,1,Clear,0.36,0.3636,0.76,0.0896,3,28,31,424,31,31
7235,2011-11-03,Winter,2011,Nov,1,0,Thursday,1,Clear,0.34,0.3333,0.81,0.1343,3,12,15,424,15,15
7236,2011-11-03,Winter,2011,Nov,2,0,Thursday,1,Clear,0.34,0.3333,0.76,0.1343,2,5,7,424,7,7
7237,2011-11-03,Winter,2011,Nov,3,0,Thursday,1,Clear,0.34,0.3333,0.81,0.1343,1,4,5,424,5,5
7238,2011-11-03,Winter,2011,Nov,4,0,Thursday,1,Clear,0.32,0.3333,0.81,0.0896,1,3,4,424,4,4
7239,2011-11-03,Winter,2011,Nov,5,0,Thursday,1,Clear,0.32,0.3333,0.81,0.1343,1,27,28,424,28,28
7240,2011-11-03,Winter,2011,Nov,6,0,Thursday,1,Clear,0.34,0.3333,0.76,0.194,3,96,99,424,99,99
7241,2011-11-03,Winter,2011,Nov,7,0,Thursday,1,Misty,0.32,0.3333,0.81,0.0896,12,280,292,424,292,292
7242,2011-11-03,Winter,2011,Nov,8,0,Thursday,1,Misty,0.34,0.3485,0.81,0.0896,8,394,402,424,402,402
7243,2011-11-03,Winter,2011,Nov,9,0,Thursday,1,Misty,0.36,0.3485,0.81,0.194,9,155,164,424,164,164
7244,2011-11-03,Winter,2011,Nov,10,0,Thursday,1,Misty,0.4,0.4091,0.76,0.194,12,98,110,424,110,110
7245,2011-11-03,Winter,2011,Nov,11,0,Thursday,1,Clear,0.44,0.4394,0.67,0.194,12,108,120,424,120,120
7246,2011-11-03,Winter,2011,Nov,12,0,Thursday,1,Clear,0.5,0.4848,0.51,0.194,17,162,179,424,179,179
7247,2011-11-03,Winter,2011,Nov,13,0,Thursday,1,Misty,0.52,0.5,0.48,0.2537,19,150,169,424,169,169
7248,2011-11-03,Winter,2011,Nov,14,0,Thursday,1,Clear,0.52,0.5,0.52,0.1642,32,120,152,424,152,152
7249,2011-11-03,Winter,2011,Nov,15,0,Thursday,1,Clear,0.52,0.5,0.52,0.1642,24,138,162,424,162,162
7250,2011-11-03,Winter,2011,Nov,16,0,Thursday,1,Clear,0.52,0.5,0.48,0.194,33,234,267,424,267,267
7251,2011-11-03,Winter,2011,Nov,17,0,Thursday,1,Clear,0.48,0.4697,0.55,0.0896,33,465,498,424,498,498
7252,2011-11-03,Winter,2011,Nov,18,0,Thursday,1,Clear,0.46,0.4545,0.63,0.1343,24,409,433,424,433,433
7253,2011-11-03,Winter,2011,Nov,19,0,Thursday,1,Clear,0.44,0.4394,0.67,0.0896,18,234,252,424,252,252
7254,2011-11-03,Winter,2011,Nov,20,0,Thursday,1,Clear,0.42,0.4242,0.71,0.1045,11,198,209,424,209,209
7255,2011-11-03,Winter,2011,Nov,21,0,Thursday,1,Clear,0.4,0.4091,0.76,0.1343,4,140,144,424,144,144
7256,2011-11-03,Winter,2011,Nov,22,0,Thursday,1,Clear,0.4,0.4091,0.82,0.0,21,116,137,424,137,137
7257,2011-11-03,Winter,2011,Nov,23,0,Thursday,1,Clear,0.4,0.4091,0.82,0.0896,15,80,95,424,95,95
7258,2011-11-04,Winter,2011,Nov,0,0,Friday,1,Misty,0.4,0.4091,0.82,0.0,11,32,43,423,43,43
7259,2011-11-04,Winter,2011,Nov,1,0,Friday,1,Misty,0.4,0.4091,0.82,0.0,1,16,17,423,17,17
7260,2011-11-04,Winter,2011,Nov,2,0,Friday,1,Misty,0.4,0.4091,0.76,0.0,2,8,10,423,10,10
7261,2011-11-04,Winter,2011,Nov,3,0,Friday,1,Misty,0.38,0.3939,0.87,0.1642,1,7,8,423,8,8
7262,2011-11-04,Winter,2011,Nov,4,0,Friday,1,Misty,0.38,0.3939,0.87,0.0896,1,6,7,423,7,7
7263,2011-11-04,Winter,2011,Nov,5,0,Friday,1,Misty,0.38,0.3939,0.87,0.0,0,23,23,423,23,23
7264,2011-11-04,Winter,2011,Nov,6,0,Friday,1,Misty,0.38,0.3939,0.87,0.0896,2,64,66,423,66,66
7265,2011-11-04,Winter,2011,Nov,7,0,Friday,1,Misty,0.4,0.4091,0.86,0.2239,10,235,245,423,245,245
7266,2011-11-04,Winter,2011,Nov,8,0,Friday,1,Misty,0.4,0.4091,0.87,0.3582,8,387,395,423,395,395
7267,2011-11-04,Winter,2011,Nov,9,0,Friday,1,Misty,0.42,0.4242,0.71,0.4627,15,239,254,423,254,254
7268,2011-11-04,Winter,2011,Nov,10,0,Friday,1,Misty,0.42,0.4242,0.71,0.3284,19,115,134,423,134,134
7269,2011-11-04,Winter,2011,Nov,11,0,Friday,1,Misty,0.44,0.4394,0.67,0.4478,34,128,162,423,162,162
7270,2011-11-04,Winter,2011,Nov,12,0,Friday,1,Misty,0.48,0.4697,0.55,0.4925,44,153,197,423,197,197
7271,2011-11-04,Winter,2011,Nov,13,0,Friday,1,Clear,0.44,0.4394,0.51,0.4179,33,161,194,423,194,194
7272,2011-11-04,Winter,2011,Nov,14,0,Friday,1,Clear,0.44,0.4394,0.47,0.2985,54,147,201,423,201,201
7273,2011-11-04,Winter,2011,Nov,15,0,Friday,1,Clear,0.46,0.4545,0.44,0.3881,45,192,237,423,237,237
7274,2011-11-04,Winter,2011,Nov,16,0,Friday,1,Clear,0.46,0.4545,0.36,0.3881,53,237,290,423,290,290
7275,2011-11-04,Winter,2011,Nov,17,0,Friday,1,Clear,0.42,0.4242,0.38,0.3582,42,438,480,423,480,480
7276,2011-11-04,Winter,2011,Nov,18,0,Friday,1,Clear,0.42,0.4242,0.32,0.4627,35,339,374,423,374,374
7277,2011-11-04,Winter,2011,Nov,19,0,Friday,1,Clear,0.4,0.4091,0.37,0.3582,14,182,196,423,196,196
7278,2011-11-04,Winter,2011,Nov,20,0,Friday,1,Clear,0.36,0.3333,0.43,0.2836,15,171,186,423,186,186
7279,2011-11-04,Winter,2011,Nov,21,0,Friday,1,Clear,0.34,0.3182,0.46,0.2537,8,115,123,423,123,123
7280,2011-11-04,Winter,2011,Nov,22,0,Friday,1,Clear,0.34,0.303,0.46,0.3284,6,109,115,423,115,115
7281,2011-11-04,Winter,2011,Nov,23,0,Friday,1,Clear,0.32,0.303,0.49,0.3284,17,72,89,423,89,89
7282,2011-11-05,Winter,2011,Nov,0,0,Saturday,0,Clear,0.32,0.2879,0.45,0.3582,4,48,52,422,52,52
7283,2011-11-05,Winter,2011,Nov,1,0,Saturday,0,Clear,0.32,0.303,0.45,0.2985,5,57,62,422,62,62
7284,2011-11-05,Winter,2011,Nov,2,0,Saturday,0,Clear,0.3,0.2727,0.52,0.3284,7,24,31,422,31,31
7285,2011-11-05,Winter,2011,Nov,3,0,Saturday,0,Clear,0.3,0.2727,0.52,0.2985,0,8,8,422,8,8
7286,2011-11-05,Winter,2011,Nov,4,0,Saturday,0,Clear,0.28,0.2576,0.56,0.3284,3,5,8,422,8,8
7287,2011-11-05,Winter,2011,Nov,5,0,Saturday,0,Clear,0.26,0.2273,0.6,0.3284,0,2,2,422,2,2
7288,2011-11-05,Winter,2011,Nov,6,0,Saturday,0,Clear,0.26,0.2424,0.6,0.2537,3,20,23,422,23,23
7289,2011-11-05,Winter,2011,Nov,7,0,Saturday,0,Clear,0.26,0.2424,0.6,0.2836,3,31,34,422,34,34
7290,2011-11-05,Winter,2011,Nov,8,0,Saturday,0,Clear,0.28,0.2576,0.56,0.3284,4,80,84,422,84,84
7291,2011-11-05,Winter,2011,Nov,9,0,Saturday,0,Clear,0.3,0.2727,0.56,0.2985,30,111,141,422,141,141
7292,2011-11-05,Winter,2011,Nov,10,0,Saturday,0,Clear,0.32,0.303,0.53,0.2537,56,171,227,422,227,227
7293,2011-11-05,Winter,2011,Nov,11,0,Saturday,0,Clear,0.36,0.3636,0.46,0.1045,69,169,238,422,238,238
7294,2011-11-05,Winter,2011,Nov,12,0,Saturday,0,Clear,0.36,0.3485,0.46,0.1642,137,235,372,422,372,372
7295,2011-11-05,Winter,2011,Nov,13,0,Saturday,0,Clear,0.4,0.4091,0.37,0.1045,148,207,355,422,355,355
7296,2011-11-05,Winter,2011,Nov,14,0,Saturday,0,Clear,0.42,0.4242,0.35,0.1343,159,227,386,422,386,386
7297,2011-11-05,Winter,2011,Nov,15,0,Saturday,0,Clear,0.4,0.4091,0.37,0.194,141,202,343,422,343,343
7298,2011-11-05,Winter,2011,Nov,16,0,Saturday,0,Clear,0.4,0.4091,0.4,0.2239,128,207,335,422,335,335
7299,2011-11-05,Winter,2011,Nov,17,0,Saturday,0,Clear,0.38,0.3939,0.4,0.1642,100,234,334,422,334,334
7300,2011-11-05,Winter,2011,Nov,18,0,Saturday,0,Clear,0.36,0.3636,0.5,0.0896,52,185,237,422,237,237
7301,2011-11-05,Winter,2011,Nov,19,0,Saturday,0,Clear,0.34,0.3636,0.53,0.0,45,159,204,422,204,204
7302,2011-11-05,Winter,2011,Nov,20,0,Saturday,0,Clear,0.32,0.3485,0.66,0.0,29,136,165,422,165,165
7303,2011-11-05,Winter,2011,Nov,21,0,Saturday,0,Clear,0.32,0.3485,0.66,0.0,19,99,118,422,118,118
7304,2011-11-05,Winter,2011,Nov,22,0,Saturday,0,Clear,0.3,0.3333,0.65,0.0,10,72,82,422,82,82
7305,2011-11-05,Winter,2011,Nov,23,0,Saturday,0,Clear,0.28,0.3182,0.7,0.0,4,81,85,422,85,85
7306,2011-11-06,Winter,2011,Nov,0,0,Sunday,0,Clear,0.28,0.3182,0.75,0.0,10,65,75,421,75,75
7307,2011-11-06,Winter,2011,Nov,1,0,Sunday,0,Clear,0.26,0.303,0.81,0.0,11,104,115,421,115,115
7308,2011-11-06,Winter,2011,Nov,2,0,Sunday,0,Clear,0.26,0.303,0.81,0.0,6,23,29,421,29,29
7309,2011-11-06,Winter,2011,Nov,3,0,Sunday,0,Clear,0.24,0.2879,0.87,0.0,5,4,9,421,9,9
7310,2011-11-06,Winter,2011,Nov,4,0,Sunday,0,Clear,0.24,0.2879,0.87,0.0,0,6,6,421,6,6
7311,2011-11-06,Winter,2011,Nov,5,0,Sunday,0,Clear,0.24,0.2424,0.87,0.1343,0,5,5,421,5,5
7312,2011-11-06,Winter,2011,Nov,6,0,Sunday,0,Clear,0.26,0.2879,0.81,0.0896,5,11,16,421,16,16
7313,2011-11-06,Winter,2011,Nov,7,0,Sunday,0,Clear,0.26,0.2727,0.87,0.1045,4,24,28,421,28,28
7314,2011-11-06,Winter,2011,Nov,8,0,Sunday,0,Misty,0.28,0.303,0.87,0.0896,19,71,90,421,90,90
7315,2011-11-06,Winter,2011,Nov,9,0,Sunday,0,Misty,0.3,0.3182,0.75,0.0896,36,134,170,421,170,170
7316,2011-11-06,Winter,2011,Nov,10,0,Sunday,0,Clear,0.36,0.3636,0.66,0.0896,76,186,262,421,262,262
7317,2011-11-06,Winter,2011,Nov,11,0,Sunday,0,Clear,0.42,0.4242,0.58,0.0896,104,216,320,421,320,320
7318,2011-11-06,Winter,2011,Nov,12,0,Sunday,0,Clear,0.44,0.4394,0.54,0.0,120,226,346,421,346,346
7319,2011-11-06,Winter,2011,Nov,13,0,Sunday,0,Clear,0.46,0.4545,0.51,0.1642,105,209,314,421,314,314
7320,2011-11-06,Winter,2011,Nov,14,0,Sunday,0,Clear,0.46,0.4545,0.55,0.194,101,219,320,421,320,320
7321,2011-11-06,Winter,2011,Nov,15,0,Sunday,0,Clear,0.48,0.4697,0.51,0.194,96,210,306,421,306,306
7322,2011-11-06,Winter,2011,Nov,16,0,Sunday,0,Clear,0.46,0.4545,0.55,0.2239,84,263,347,421,347,347
7323,2011-11-06,Winter,2011,Nov,17,0,Sunday,0,Clear,0.44,0.4394,0.62,0.1642,71,185,256,421,256,256
7324,2011-11-06,Winter,2011,Nov,18,0,Sunday,0,Clear,0.42,0.4242,0.71,0.1045,39,146,185,421,185,185
7325,2011-11-06,Winter,2011,Nov,19,0,Sunday,0,Clear,0.38,0.3939,0.76,0.194,21,130,151,421,151,151
7326,2011-11-06,Winter,2011,Nov,20,0,Sunday,0,Clear,0.36,0.3636,0.81,0.1045,16,100,116,421,116,116
7327,2011-11-06,Winter,2011,Nov,21,0,Sunday,0,Clear,0.36,0.3636,0.81,0.0896,11,77,88,421,88,88
7328,2011-11-06,Winter,2011,Nov,22,0,Sunday,0,Clear,0.36,0.3788,0.87,0.0,5,40,45,421,45,45
7329,2011-11-06,Winter,2011,Nov,23,0,Sunday,0,Clear,0.34,0.3485,0.87,0.0896,7,43,50,421,50,50
7330,2011-11-07,Winter,2011,Nov,0,0,Monday,1,Clear,0.34,0.3636,0.87,0.0,1,14,15,420,15,15
7331,2011-11-07,Winter,2011,Nov,1,0,Monday,1,Clear,0.34,0.3636,0.87,0.0,2,6,8,420,8,8
7332,2011-11-07,Winter,2011,Nov,2,0,Monday,1,Clear,0.32,0.3485,0.93,0.0,0,2,2,420,2,2
7333,2011-11-07,Winter,2011,Nov,3,0,Monday,1,Clear,0.32,0.3485,0.93,0.0,0,3,3,420,3,3
7334,2011-11-07,Winter,2011,Nov,4,0,Monday,1,Clear,0.32,0.3485,0.93,0.0,2,4,6,420,6,6
7335,2011-11-07,Winter,2011,Nov,5,0,Monday,1,Clear,0.3,0.3333,0.93,0.0,1,25,26,420,26,26
7336,2011-11-07,Winter,2011,Nov,6,0,Monday,1,Misty,0.28,0.3182,0.93,0.0,2,97,99,420,99,99
7337,2011-11-07,Winter,2011,Nov,7,0,Monday,1,Misty,0.28,0.3182,0.93,0.0,6,305,311,420,311,311
7338,2011-11-07,Winter,2011,Nov,8,0,Monday,1,Misty,0.3,0.3182,1.0,0.0896,13,397,410,420,410,410
7339,2011-11-07,Winter,2011,Nov,9,0,Monday,1,Misty,0.34,0.3333,1.0,0.1343,18,156,174,420,174,174
7340,2011-11-07,Winter,2011,Nov,10,0,Monday,1,Clear,0.36,0.3485,0.93,0.1343,28,95,123,420,123,123
7341,2011-11-07,Winter,2011,Nov,11,0,Monday,1,Clear,0.42,0.4242,0.77,0.1045,28,100,128,420,128,128
7342,2011-11-07,Winter,2011,Nov,12,0,Monday,1,Clear,0.46,0.4545,0.67,0.0,21,158,179,420,179,179
7343,2011-11-07,Winter,2011,Nov,13,0,Monday,1,Clear,0.54,0.5152,0.49,0.0896,32,157,189,420,189,189
7344,2011-11-07,Winter,2011,Nov,14,0,Monday,1,Clear,0.56,0.5303,0.37,0.1642,30,115,145,420,145,145
7345,2011-11-07,Winter,2011,Nov,15,0,Monday,1,Clear,0.56,0.5303,0.37,0.1045,38,132,170,420,170,170
7346,2011-11-07,Winter,2011,Nov,16,0,Monday,1,Clear,0.52,0.5,0.45,0.0,40,255,295,420,295,295
7347,2011-11-07,Winter,2011,Nov,17,0,Monday,1,Clear,0.5,0.4848,0.45,0.1642,39,489,528,420,528,528
7348,2011-11-07,Winter,2011,Nov,18,0,Monday,1,Clear,0.46,0.4545,0.59,0.1045,18,407,425,420,425,425
7349,2011-11-07,Winter,2011,Nov,19,0,Monday,1,Clear,0.46,0.4545,0.59,0.0,20,280,300,420,300,300
7350,2011-11-07,Winter,2011,Nov,20,0,Monday,1,Clear,0.4,0.4091,0.71,0.0,17,187,204,420,204,204
7351,2011-11-07,Winter,2011,Nov,21,0,Monday,1,Clear,0.38,0.3939,0.82,0.1045,10,129,139,420,139,139
7352,2011-11-07,Winter,2011,Nov,22,0,Monday,1,Clear,0.36,0.3636,0.81,0.0896,6,102,108,420,108,108
7353,2011-11-07,Winter,2011,Nov,23,0,Monday,1,Clear,0.36,0.3636,0.87,0.0896,1,47,48,420,48,48
7354,2011-11-08,Winter,2011,Nov,0,0,Tuesday,1,Clear,0.34,0.3485,0.87,0.0896,0,18,18,419,18,18
7355,2011-11-08,Winter,2011,Nov,1,0,Tuesday,1,Clear,0.32,0.3333,0.93,0.1045,3,8,11,419,11,11
7356,2011-11-08,Winter,2011,Nov,2,0,Tuesday,1,Clear,0.32,0.3485,0.87,0.0,0,1,1,419,1,1
7357,2011-11-08,Winter,2011,Nov,3,0,Tuesday,1,Clear,0.32,0.3485,0.87,0.0,0,3,3,419,3,3
7358,2011-11-08,Winter,2011,Nov,4,0,Tuesday,1,Clear,0.3,0.3333,0.87,0.0,0,4,4,419,4,4
7359,2011-11-08,Winter,2011,Nov,5,0,Tuesday,1,Clear,0.3,0.3182,0.87,0.0896,1,17,18,419,18,18
7360,2011-11-08,Winter,2011,Nov,6,0,Tuesday,1,Clear,0.3,0.3333,0.87,0.0,3,96,99,419,99,99
7361,2011-11-08,Winter,2011,Nov,7,0,Tuesday,1,Clear,0.3,0.3182,0.87,0.1045,7,316,323,419,323,323
7362,2011-11-08,Winter,2011,Nov,8,0,Tuesday,1,Clear,0.32,0.3333,0.93,0.1045,11,455,466,419,466,466
7363,2011-11-08,Winter,2011,Nov,9,0,Tuesday,1,Clear,0.36,0.3788,0.87,0.0,14,177,191,419,191,191
7364,2011-11-08,Winter,2011,Nov,10,0,Tuesday,1,Clear,0.42,0.4242,0.71,0.0896,25,104,129,419,129,129
7365,2011-11-08,Winter,2011,Nov,11,0,Tuesday,1,Clear,0.46,0.4545,0.63,0.1343,21,126,147,419,147,147
7366,2011-11-08,Winter,2011,Nov,12,0,Tuesday,1,Clear,0.52,0.5,0.52,0.1343,28,175,203,419,203,203
7367,2011-11-08,Winter,2011,Nov,13,0,Tuesday,1,Clear,0.54,0.5152,0.49,0.1642,31,165,196,419,196,196
7368,2011-11-08,Winter,2011,Nov,14,0,Tuesday,1,Clear,0.56,0.5303,0.46,0.1045,32,129,161,419,161,161
7369,2011-11-08,Winter,2011,Nov,15,0,Tuesday,1,Clear,0.58,0.5455,0.46,0.1045,33,155,188,419,188,188
7370,2011-11-08,Winter,2011,Nov,16,0,Tuesday,1,Clear,0.56,0.5303,0.46,0.1343,39,250,289,419,289,289
7371,2011-11-08,Winter,2011,Nov,17,0,Tuesday,1,Clear,0.52,0.5,0.43,0.1642,40,459,499,419,499,499
7372,2011-11-08,Winter,2011,Nov,18,0,Tuesday,1,Clear,0.48,0.4697,0.55,0.1343,30,432,462,419,462,462
7373,2011-11-08,Winter,2011,Nov,19,0,Tuesday,1,Clear,0.46,0.4545,0.59,0.0,14,264,278,419,278,278
7374,2011-11-08,Winter,2011,Nov,20,0,Tuesday,1,Clear,0.4,0.4091,0.76,0.0,12,169,181,419,181,181
7375,2011-11-08,Winter,2011,Nov,21,0,Tuesday,1,Clear,0.4,0.4091,0.76,0.0,16,166,182,419,182,182
7376,2011-11-08,Winter,2011,Nov,22,0,Tuesday,1,Clear,0.36,0.3788,0.87,0.0,13,95,108,419,108,108
7377,2011-11-08,Winter,2011,Nov,23,0,Tuesday,1,Clear,0.36,0.3788,0.81,0.0,3,45,48,419,48,48
7378,2011-11-09,Winter,2011,Nov,0,0,Wednesday,1,Clear,0.36,0.3788,0.87,0.0,0,13,13,418,13,13
7379,2011-11-09,Winter,2011,Nov,1,0,Wednesday,1,Clear,0.34,0.3636,0.87,0.0,0,10,10,418,10,10
7380,2011-11-09,Winter,2011,Nov,2,0,Wednesday,1,Clear,0.32,0.3485,0.93,0.0,0,5,5,418,5,5
7381,2011-11-09,Winter,2011,Nov,3,0,Wednesday,1,Clear,0.32,0.3485,0.93,0.0,0,4,4,418,4,4
7382,2011-11-09,Winter,2011,Nov,4,0,Wednesday,1,Clear,0.32,0.3485,0.87,0.0,0,4,4,418,4,4
7383,2011-11-09,Winter,2011,Nov,5,0,Wednesday,1,Clear,0.3,0.3333,0.87,0.0,0,28,28,418,28,28
7384,2011-11-09,Winter,2011,Nov,6,0,Wednesday,1,Clear,0.3,0.3333,0.87,0.0,0,98,98,418,98,98
7385,2011-11-09,Winter,2011,Nov,7,0,Wednesday,1,Clear,0.3,0.3333,0.87,0.0,0,300,300,418,300,300
7386,2011-11-09,Winter,2011,Nov,8,0,Wednesday,1,Clear,0.32,0.3485,0.93,0.0,19,437,456,418,456,456
7387,2011-11-09,Winter,2011,Nov,9,0,Wednesday,1,Clear,0.34,0.3636,0.93,0.0,22,197,219,418,219,219
7388,2011-11-09,Winter,2011,Nov,10,0,Wednesday,1,Clear,0.4,0.4091,0.76,0.1045,16,89,105,418,105,105
7389,2011-11-09,Winter,2011,Nov,11,0,Wednesday,1,Clear,0.46,0.4545,0.67,0.1642,21,131,152,418,152,152
7390,2011-11-09,Winter,2011,Nov,12,0,Wednesday,1,Clear,0.5,0.4848,0.51,0.1642,24,156,180,418,180,180
7391,2011-11-09,Winter,2011,Nov,13,0,Wednesday,1,Clear,0.5,0.4848,0.51,0.1642,31,136,167,418,167,167
7392,2011-11-09,Winter,2011,Nov,14,0,Wednesday,1,Clear,0.52,0.5,0.48,0.1642,26,153,179,418,179,179
7393,2011-11-09,Winter,2011,Nov,15,0,Wednesday,1,Clear,0.52,0.5,0.45,0.2239,21,130,151,418,151,151
7394,2011-11-09,Winter,2011,Nov,16,0,Wednesday,1,Clear,0.52,0.5,0.48,0.194,24,257,281,418,281,281
7395,2011-11-09,Winter,2011,Nov,17,0,Wednesday,1,Clear,0.46,0.4545,0.63,0.1045,27,458,485,418,485,485
7396,2011-11-09,Winter,2011,Nov,18,0,Wednesday,1,Clear,0.44,0.4394,0.67,0.1045,21,387,408,418,408,408
7397,2011-11-09,Winter,2011,Nov,19,0,Wednesday,1,Clear,0.44,0.4394,0.72,0.1045,12,292,304,418,304,304
7398,2011-11-09,Winter,2011,Nov,20,0,Wednesday,1,Clear,0.44,0.4394,0.77,0.0,18,201,219,418,219,219
7399,2011-11-09,Winter,2011,Nov,21,0,Wednesday,1,Clear,0.4,0.4091,0.87,0.0,9,152,161,418,161,161
7400,2011-11-09,Winter,2011,Nov,22,0,Wednesday,1,Clear,0.4,0.4091,0.87,0.0,9,105,114,418,114,114
7401,2011-11-09,Winter,2011,Nov,23,0,Wednesday,1,Clear,0.38,0.3939,0.87,0.0,5,61,66,418,66,66
7402,2011-11-10,Winter,2011,Nov,0,0,Thursday,1,Clear,0.4,0.4091,0.87,0.0,0,24,24,417,24,24
7403,2011-11-10,Winter,2011,Nov,1,0,Thursday,1,Misty,0.4,0.4091,0.87,0.0,1,10,11,417,11,11
7404,2011-11-10,Winter,2011,Nov,2,0,Thursday,1,Misty,0.38,0.3939,0.94,0.0,0,5,5,417,5,5
7405,2011-11-10,Winter,2011,Nov,3,0,Thursday,1,Clear,0.38,0.3939,0.94,0.0896,0,11,11,417,11,11
7406,2011-11-10,Winter,2011,Nov,4,0,Thursday,1,Clear,0.38,0.3939,0.94,0.0896,1,2,3,417,3,3
7407,2011-11-10,Winter,2011,Nov,5,0,Thursday,1,Misty,0.36,0.3485,1.0,0.1343,1,22,23,417,23,23
7408,2011-11-10,Winter,2011,Nov,6,0,Thursday,1,Misty,0.36,0.3485,1.0,0.1343,4,110,114,417,114,114
7409,2011-11-10,Winter,2011,Nov,7,0,Thursday,1,Misty,0.38,0.3939,0.94,0.1642,6,266,272,417,272,272
7410,2011-11-10,Winter,2011,Nov,8,0,Thursday,1,Misty,0.4,0.4091,0.94,0.0896,18,418,436,417,436,436
7411,2011-11-10,Winter,2011,Nov,9,0,Thursday,1,Misty,0.42,0.4242,0.94,0.1045,23,188,211,417,211,211
7412,2011-11-10,Winter,2011,Nov,10,0,Thursday,1,Misty,0.44,0.4394,0.88,0.2239,17,100,117,417,117,117
7413,2011-11-10,Winter,2011,Nov,11,0,Thursday,1,Misty,0.46,0.4545,0.67,0.3881,9,99,108,417,108,108
7414,2011-11-10,Winter,2011,Nov,12,0,Thursday,1,Misty,0.42,0.4242,0.67,0.3582,18,149,167,417,167,167
7415,2011-11-10,Winter,2011,Nov,13,0,Thursday,1,Light_rainsnow,0.36,0.3333,0.81,0.3582,9,87,96,417,96,96
7416,2011-11-10,Winter,2011,Nov,14,0,Thursday,1,Light_rainsnow,0.36,0.3333,0.87,0.2836,6,58,64,417,64,64
7417,2011-11-10,Winter,2011,Nov,15,0,Thursday,1,Light_rainsnow,0.36,0.3333,0.81,0.2985,5,57,62,417,62,62
7418,2011-11-10,Winter,2011,Nov,16,0,Thursday,1,Light_rainsnow,0.36,0.3485,0.81,0.2239,6,67,73,417,73,73
7419,2011-11-10,Winter,2011,Nov,17,0,Thursday,1,Light_rainsnow,0.36,0.3485,0.81,0.2239,9,168,177,417,177,177
7420,2011-11-10,Winter,2011,Nov,18,0,Thursday,1,Misty,0.36,0.3485,0.81,0.1642,10,263,273,417,273,273
7421,2011-11-10,Winter,2011,Nov,19,0,Thursday,1,Misty,0.36,0.3485,0.71,0.2239,19,192,211,417,211,211
7422,2011-11-10,Winter,2011,Nov,20,0,Thursday,1,Misty,0.36,0.3333,0.62,0.2836,8,160,168,417,168,168
7423,2011-11-10,Winter,2011,Nov,21,0,Thursday,1,Clear,0.36,0.3333,0.57,0.2537,6,130,136,417,136,136
7424,2011-11-10,Winter,2011,Nov,22,0,Thursday,1,Clear,0.36,0.3333,0.53,0.2836,5,84,89,417,89,89
7425,2011-11-10,Winter,2011,Nov,23,0,Thursday,1,Misty,0.34,0.3333,0.57,0.1642,9,73,82,417,82,82
7426,2011-11-11,Winter,2011,Nov,0,1,Friday,0,Clear,0.34,0.3182,0.53,0.2537,10,56,66,416,66,66
7427,2011-11-11,Winter,2011,Nov,1,1,Friday,0,Clear,0.32,0.303,0.57,0.3284,3,16,19,416,19,19
7428,2011-11-11,Winter,2011,Nov,2,1,Friday,0,Clear,0.32,0.2879,0.57,0.2836,1,10,11,416,11,11
7429,2011-11-11,Winter,2011,Nov,3,1,Friday,0,Clear,0.3,0.2879,0.61,0.194,0,6,6,416,6,6
7430,2011-11-11,Winter,2011,Nov,4,1,Friday,0,Clear,0.3,0.2879,0.61,0.194,0,8,8,416,8,8
7431,2011-11-11,Winter,2011,Nov,5,1,Friday,0,Clear,0.3,0.2879,0.49,0.2537,0,13,13,416,13,13
7432,2011-11-11,Winter,2011,Nov,6,1,Friday,0,Clear,0.28,0.2576,0.45,0.3284,0,46,46,416,46,46
7433,2011-11-11,Winter,2011,Nov,7,1,Friday,0,Clear,0.28,0.2727,0.45,0.2537,5,116,121,416,121,121
7434,2011-11-11,Winter,2011,Nov,8,1,Friday,0,Clear,0.3,0.2727,0.42,0.3582,9,249,258,416,258,258
7435,2011-11-11,Winter,2011,Nov,9,1,Friday,0,Clear,0.32,0.2879,0.45,0.4478,15,186,201,416,201,201
7436,2011-11-11,Winter,2011,Nov,10,1,Friday,0,Clear,0.32,0.2727,0.42,0.5522,38,162,200,416,200,200
7437,2011-11-11,Winter,2011,Nov,11,1,Friday,0,Clear,0.34,0.2879,0.42,0.4925,20,150,170,416,170,170
7438,2011-11-11,Winter,2011,Nov,12,1,Friday,0,Clear,0.34,0.2879,0.42,0.4627,41,198,239,416,239,239
7439,2011-11-11,Winter,2011,Nov,13,1,Friday,0,Clear,0.38,0.3939,0.37,0.5522,57,179,236,416,236,236
7440,2011-11-11,Winter,2011,Nov,14,1,Friday,0,Clear,0.38,0.3939,0.37,0.4627,64,183,247,416,247,247
7441,2011-11-11,Winter,2011,Nov,15,1,Friday,0,Clear,0.36,0.3333,0.37,0.4179,29,187,216,416,216,216
7442,2011-11-11,Winter,2011,Nov,16,1,Friday,0,Clear,0.36,0.3333,0.34,0.3284,49,189,238,416,238,238
7443,2011-11-11,Winter,2011,Nov,17,1,Friday,0,Clear,0.34,0.303,0.39,0.3284,24,286,310,416,310,310
7444,2011-11-11,Winter,2011,Nov,18,1,Friday,0,Clear,0.34,0.3182,0.39,0.2537,23,185,208,416,208,208
7445,2011-11-11,Winter,2011,Nov,19,1,Friday,0,Clear,0.32,0.3182,0.39,0.1642,17,182,199,416,199,199
7446,2011-11-11,Winter,2011,Nov,20,1,Friday,0,Clear,0.32,0.3182,0.39,0.194,12,97,109,416,109,109
7447,2011-11-11,Winter,2011,Nov,21,1,Friday,0,Clear,0.3,0.303,0.45,0.1642,4,79,83,416,83,83
7448,2011-11-11,Winter,2011,Nov,22,1,Friday,0,Clear,0.32,0.3182,0.39,0.194,13,78,91,416,91,91
7449,2011-11-11,Winter,2011,Nov,23,1,Friday,0,Clear,0.3,0.3182,0.45,0.0896,6,67,73,416,73,73
7450,2011-11-12,Winter,2011,Nov,0,0,Saturday,0,Clear,0.24,0.2424,0.6,0.1343,12,52,64,415,64,64
7451,2011-11-12,Winter,2011,Nov,1,0,Saturday,0,Clear,0.24,0.2424,0.6,0.1343,9,45,54,415,54,54
7452,2011-11-12,Winter,2011,Nov,2,0,Saturday,0,Clear,0.24,0.2576,0.65,0.0896,7,39,46,415,46,46
7453,2011-11-12,Winter,2011,Nov,3,0,Saturday,0,Clear,0.24,0.2424,0.7,0.1343,4,13,17,415,17,17
7454,2011-11-12,Winter,2011,Nov,4,0,Saturday,0,Clear,0.2,0.2121,0.8,0.1343,0,7,7,415,7,7
7455,2011-11-12,Winter,2011,Nov,5,0,Saturday,0,Clear,0.22,0.2576,0.75,0.0896,1,3,4,415,4,4
7456,2011-11-12,Winter,2011,Nov,6,0,Saturday,0,Clear,0.22,0.2273,0.75,0.1642,0,7,7,415,7,7
7457,2011-11-12,Winter,2011,Nov,7,0,Saturday,0,Clear,0.22,0.2273,0.75,0.194,3,24,27,415,27,27
7458,2011-11-12,Winter,2011,Nov,8,0,Saturday,0,Clear,0.26,0.2576,0.7,0.194,14,87,101,415,101,101
7459,2011-11-12,Winter,2011,Nov,9,0,Saturday,0,Clear,0.3,0.303,0.61,0.1642,18,142,160,415,160,160
7460,2011-11-12,Winter,2011,Nov,10,0,Saturday,0,Clear,0.34,0.3182,0.61,0.2836,62,170,232,415,232,232
7461,2011-11-12,Winter,2011,Nov,11,0,Saturday,0,Clear,0.38,0.3939,0.54,0.2836,102,213,315,415,315,315
7462,2011-11-12,Winter,2011,Nov,12,0,Saturday,0,Clear,0.44,0.4394,0.44,0.2836,142,224,366,415,366,366
7463,2011-11-12,Winter,2011,Nov,13,0,Saturday,0,Clear,0.48,0.4697,0.36,0.2836,128,225,353,415,353,353
7464,2011-11-12,Winter,2011,Nov,14,0,Saturday,0,Clear,0.5,0.4848,0.36,0.2985,191,244,435,415,435,435
7465,2011-11-12,Winter,2011,Nov,15,0,Saturday,0,Clear,0.52,0.5,0.29,0.2836,165,221,386,415,386,386
7466,2011-11-12,Winter,2011,Nov,16,0,Saturday,0,Clear,0.52,0.5,0.32,0.2537,137,224,361,415,361,361
7467,2011-11-12,Winter,2011,Nov,17,0,Saturday,0,Clear,0.5,0.4848,0.34,0.2537,92,193,285,415,285,285
7468,2011-11-12,Winter,2011,Nov,18,0,Saturday,0,Clear,0.42,0.4242,0.58,0.194,53,150,203,415,203,203
7469,2011-11-12,Winter,2011,Nov,19,0,Saturday,0,Clear,0.42,0.4242,0.5,0.2537,32,139,171,415,171,171
7470,2011-11-12,Winter,2011,Nov,20,0,Saturday,0,Clear,0.42,0.4242,0.5,0.2836,31,101,132,415,132,132
7471,2011-11-12,Winter,2011,Nov,21,0,Saturday,0,Clear,0.42,0.4242,0.47,0.2836,19,103,122,415,122,122
7472,2011-11-12,Winter,2011,Nov,22,0,Saturday,0,Clear,0.42,0.4242,0.47,0.2537,30,88,118,415,118,118
7473,2011-11-12,Winter,2011,Nov,23,0,Saturday,0,Clear,0.4,0.4091,0.58,0.1642,23,78,101,415,101,101
7474,2011-11-13,Winter,2011,Nov,0,0,Sunday,0,Misty,0.4,0.4091,0.58,0.194,12,61,73,414,73,73
7475,2011-11-13,Winter,2011,Nov,1,0,Sunday,0,Misty,0.36,0.3485,0.66,0.194,13,58,71,414,71,71
7476,2011-11-13,Winter,2011,Nov,2,0,Sunday,0,Clear,0.36,0.3636,0.57,0.1045,9,48,57,414,57,57
7477,2011-11-13,Winter,2011,Nov,3,0,Sunday,0,Misty,0.36,0.3485,0.62,0.1343,8,20,28,414,28,28
7478,2011-11-13,Winter,2011,Nov,4,0,Sunday,0,Misty,0.36,0.3485,0.62,0.1343,1,5,6,414,6,6
7479,2011-11-13,Winter,2011,Nov,5,0,Sunday,0,Clear,0.34,0.3333,0.61,0.1642,2,3,5,414,5,5
7480,2011-11-13,Winter,2011,Nov,6,0,Sunday,0,Clear,0.34,0.3333,0.66,0.1343,5,18,23,414,23,23
7481,2011-11-13,Winter,2011,Nov,7,0,Sunday,0,Clear,0.34,0.3182,0.66,0.2239,13,30,43,414,43,43
7482,2011-11-13,Winter,2011,Nov,8,0,Sunday,0,Clear,0.34,0.3485,0.66,0.0896,24,55,79,414,79,79
7483,2011-11-13,Winter,2011,Nov,9,0,Sunday,0,Clear,0.4,0.4091,0.54,0.2836,38,97,135,414,135,135
7484,2011-11-13,Winter,2011,Nov,10,0,Sunday,0,Clear,0.44,0.4394,0.44,0.3284,63,178,241,414,241,241
7485,2011-11-13,Winter,2011,Nov,11,0,Sunday,0,Clear,0.46,0.4545,0.4,0.4179,108,187,295,414,295,295
7486,2011-11-13,Winter,2011,Nov,12,0,Sunday,0,Misty,0.52,0.5,0.29,0.4179,112,242,354,414,354,354
7487,2011-11-13,Winter,2011,Nov,13,0,Sunday,0,Misty,0.52,0.5,0.29,0.4179,105,234,339,414,339,339
7488,2011-11-13,Winter,2011,Nov,14,0,Sunday,0,Misty,0.54,0.5152,0.28,0.4925,108,263,371,414,371,371
7489,2011-11-13,Winter,2011,Nov,15,0,Sunday,0,Misty,0.5,0.4848,0.42,0.3284,89,221,310,414,310,310
7490,2011-11-13,Winter,2011,Nov,16,0,Sunday,0,Misty,0.54,0.5152,0.28,0.3881,93,226,319,414,319,319
7491,2011-11-13,Winter,2011,Nov,17,0,Sunday,0,Clear,0.52,0.5,0.27,0.3284,44,187,231,414,231,231
7492,2011-11-13,Winter,2011,Nov,18,0,Sunday,0,Clear,0.52,0.5,0.27,0.3284,35,155,190,414,190,190
7493,2011-11-13,Winter,2011,Nov,19,0,Sunday,0,Clear,0.5,0.4848,0.29,0.3582,36,121,157,414,157,157
7494,2011-11-13,Winter,2011,Nov,20,0,Sunday,0,Clear,0.5,0.4848,0.31,0.3582,24,115,139,414,139,139
7495,2011-11-13,Winter,2011,Nov,21,0,Sunday,0,Clear,0.48,0.4697,0.36,0.2537,19,76,95,414,95,95
7496,2011-11-13,Winter,2011,Nov,22,0,Sunday,0,Clear,0.48,0.4697,0.41,0.3881,25,64,89,414,89,89
7497,2011-11-13,Winter,2011,Nov,23,0,Sunday,0,Clear,0.46,0.4545,0.51,0.2985,18,49,67,414,67,67
7498,2011-11-14,Winter,2011,Nov,0,0,Monday,1,Clear,0.46,0.4545,0.59,0.2836,8,22,30,413,30,30
7499,2011-11-14,Winter,2011,Nov,1,0,Monday,1,Clear,0.46,0.4545,0.63,0.2985,5,6,11,413,11,11
7500,2011-11-14,Winter,2011,Nov,2,0,Monday,1,Clear,0.46,0.4545,0.63,0.3582,7,10,17,413,17,17
7501,2011-11-14,Winter,2011,Nov,3,0,Monday,1,Clear,0.44,0.4394,0.67,0.2836,4,3,7,413,7,7
7502,2011-11-14,Winter,2011,Nov,4,0,Monday,1,Clear,0.44,0.4394,0.67,0.2239,0,5,5,413,5,5
7503,2011-11-14,Winter,2011,Nov,5,0,Monday,1,Misty,0.44,0.4394,0.67,0.2537,0,19,19,413,19,19
7504,2011-11-14,Winter,2011,Nov,6,0,Monday,1,Misty,0.44,0.4394,0.72,0.2239,10,104,114,413,114,114
7505,2011-11-14,Winter,2011,Nov,7,0,Monday,1,Clear,0.44,0.4394,0.72,0.2537,11,311,322,413,322,322
7506,2011-11-14,Winter,2011,Nov,8,0,Monday,1,Misty,0.46,0.4545,0.67,0.194,27,425,452,413,452,452
7507,2011-11-14,Winter,2011,Nov,9,0,Monday,1,Misty,0.48,0.4697,0.67,0.3284,29,204,233,413,233,233
7508,2011-11-14,Winter,2011,Nov,10,0,Monday,1,Misty,0.5,0.4848,0.63,0.2836,26,85,111,413,111,111
7509,2011-11-14,Winter,2011,Nov,11,0,Monday,1,Misty,0.54,0.5152,0.6,0.2836,22,106,128,413,128,128
7510,2011-11-14,Winter,2011,Nov,12,0,Monday,1,Clear,0.56,0.5303,0.56,0.2985,36,166,202,413,202,202
7511,2011-11-14,Winter,2011,Nov,13,0,Monday,1,Clear,0.6,0.6212,0.49,0.3881,50,153,203,413,203,203
7512,2011-11-14,Winter,2011,Nov,14,0,Monday,1,Clear,0.62,0.6212,0.46,0.4478,47,138,185,413,185,185
7513,2011-11-14,Winter,2011,Nov,15,0,Monday,1,Clear,0.64,0.6212,0.44,0.3284,53,142,195,413,195,195
7514,2011-11-14,Winter,2011,Nov,16,0,Monday,1,Clear,0.62,0.6212,0.46,0.4179,51,264,315,413,315,315
7515,2011-11-14,Winter,2011,Nov,17,0,Monday,1,Clear,0.62,0.6212,0.46,0.2537,55,464,519,413,519,519
7516,2011-11-14,Winter,2011,Nov,18,0,Monday,1,Clear,0.56,0.5303,0.56,0.2836,29,460,489,413,489,489
7517,2011-11-14,Winter,2011,Nov,19,0,Monday,1,Clear,0.6,0.6212,0.53,0.2985,28,274,302,413,302,302
7518,2011-11-14,Winter,2011,Nov,20,0,Monday,1,Clear,0.6,0.6212,0.53,0.3582,30,210,240,413,240,240
7519,2011-11-14,Winter,2011,Nov,21,0,Monday,1,Clear,0.6,0.6212,0.53,0.3582,37,176,213,413,213,213
7520,2011-11-14,Winter,2011,Nov,22,0,Monday,1,Clear,0.58,0.5455,0.56,0.3582,17,96,113,413,113,113
7521,2011-11-14,Winter,2011,Nov,23,0,Monday,1,Clear,0.56,0.5303,0.64,0.2985,13,48,61,413,61,61
7522,2011-11-15,Winter,2011,Nov,0,0,Tuesday,1,Clear,0.56,0.5303,0.64,0.3582,7,15,22,412,22,22
7523,2011-11-15,Winter,2011,Nov,1,0,Tuesday,1,Clear,0.56,0.5303,0.6,0.2985,5,5,10,412,10,10
7524,2011-11-15,Winter,2011,Nov,2,0,Tuesday,1,Clear,0.56,0.5303,0.64,0.2537,7,8,15,412,15,15
7525,2011-11-15,Winter,2011,Nov,3,0,Tuesday,1,Misty,0.54,0.5152,0.68,0.3284,0,4,4,412,4,4
7526,2011-11-15,Winter,2011,Nov,4,0,Tuesday,1,Clear,0.56,0.5303,0.64,0.2985,1,6,7,412,7,7
7527,2011-11-15,Winter,2011,Nov,5,0,Tuesday,1,Clear,0.54,0.5152,0.68,0.2836,2,26,28,412,28,28
7528,2011-11-15,Winter,2011,Nov,6,0,Tuesday,1,Misty,0.56,0.5303,0.64,0.0896,4,104,108,412,108,108
7529,2011-11-15,Winter,2011,Nov,7,0,Tuesday,1,Misty,0.54,0.5152,0.68,0.1642,21,298,319,412,319,319
7530,2011-11-15,Winter,2011,Nov,8,0,Tuesday,1,Misty,0.54,0.5152,0.68,0.1045,27,453,480,412,480,480
7531,2011-11-15,Winter,2011,Nov,9,0,Tuesday,1,Misty,0.56,0.5303,0.64,0.0896,26,174,200,412,200,200
7532,2011-11-15,Winter,2011,Nov,10,0,Tuesday,1,Misty,0.56,0.5303,0.64,0.2836,23,115,138,412,138,138
7533,2011-11-15,Winter,2011,Nov,11,0,Tuesday,1,Misty,0.56,0.5303,0.64,0.194,18,116,134,412,134,134
7534,2011-11-15,Winter,2011,Nov,12,0,Tuesday,1,Misty,0.54,0.5152,0.68,0.0,28,148,176,412,176,176
7535,2011-11-15,Winter,2011,Nov,13,0,Tuesday,1,Light_rainsnow,0.54,0.5152,0.6,0.2239,21,132,153,412,153,153
7536,2011-11-15,Winter,2011,Nov,14,0,Tuesday,1,Misty,0.54,0.5152,0.6,0.2836,27,120,147,412,147,147
7537,2011-11-15,Winter,2011,Nov,15,0,Tuesday,1,Misty,0.54,0.5152,0.6,0.1343,36,155,191,412,191,191
7538,2011-11-15,Winter,2011,Nov,16,0,Tuesday,1,Misty,0.52,0.5,0.68,0.1343,31,240,271,412,271,271
7539,2011-11-15,Winter,2011,Nov,17,0,Tuesday,1,Misty,0.5,0.4848,0.72,0.194,29,422,451,412,451,451
7540,2011-11-15,Winter,2011,Nov,18,0,Tuesday,1,Misty,0.5,0.4848,0.72,0.2836,27,414,441,412,441,441
7541,2011-11-15,Winter,2011,Nov,19,0,Tuesday,1,Misty,0.5,0.4848,0.72,0.3582,27,259,286,412,286,286
7542,2011-11-15,Winter,2011,Nov,20,0,Tuesday,1,Misty,0.48,0.4697,0.82,0.1343,26,212,238,412,238,238
7543,2011-11-15,Winter,2011,Nov,21,0,Tuesday,1,Misty,0.5,0.4848,0.77,0.0896,23,145,168,412,168,168
7544,2011-11-15,Winter,2011,Nov,22,0,Tuesday,1,Misty,0.46,0.4545,0.88,0.1045,19,109,128,412,128,128
7545,2011-11-15,Winter,2011,Nov,23,0,Tuesday,1,Misty,0.46,0.4545,0.94,0.1045,14,66,80,412,80,80
7546,2011-11-16,Winter,2011,Nov,0,0,Wednesday,1,Misty,0.46,0.4545,0.94,0.0,5,26,31,411,31,31
7547,2011-11-16,Winter,2011,Nov,1,0,Wednesday,1,Light_rainsnow,0.46,0.4545,0.94,0.0896,0,5,5,411,5,5
7548,2011-11-16,Winter,2011,Nov,2,0,Wednesday,1,Misty,0.46,0.4545,0.94,0.1045,4,6,10,411,10,10
7549,2011-11-16,Winter,2011,Nov,3,0,Wednesday,1,Misty,0.46,0.4545,0.94,0.1045,2,3,5,411,5,5
7550,2011-11-16,Winter,2011,Nov,4,0,Wednesday,1,Misty,0.44,0.4394,1.0,0.2239,1,3,4,411,4,4
7551,2011-11-16,Winter,2011,Nov,5,0,Wednesday,1,Light_rainsnow,0.46,0.4545,0.94,0.1045,0,13,13,411,13,13
7552,2011-11-16,Winter,2011,Nov,6,0,Wednesday,1,Misty,0.46,0.4545,0.94,0.0896,4,52,56,411,56,56
7553,2011-11-16,Winter,2011,Nov,7,0,Wednesday,1,Light_rainsnow,0.46,0.4545,0.94,0.0,7,130,137,411,137,137
7554,2011-11-16,Winter,2011,Nov,8,0,Wednesday,1,Light_rainsnow,0.46,0.4545,0.94,0.0,9,223,232,411,232,232
7555,2011-11-16,Winter,2011,Nov,9,0,Wednesday,1,Light_rainsnow,0.46,0.4545,0.94,0.0,5,77,82,411,82,82
7556,2011-11-16,Winter,2011,Nov,10,0,Wednesday,1,Light_rainsnow,0.46,0.4545,0.94,0.0,4,32,36,411,36,36
7557,2011-11-16,Winter,2011,Nov,11,0,Wednesday,1,Light_rainsnow,0.46,0.4545,0.94,0.0896,7,53,60,411,60,60
7558,2011-11-16,Winter,2011,Nov,12,0,Wednesday,1,Light_rainsnow,0.46,0.4545,1.0,0.0,5,49,54,411,54,54
7559,2011-11-16,Winter,2011,Nov,13,0,Wednesday,1,Light_rainsnow,0.46,0.4545,0.94,0.1343,6,52,58,411,58,58
7560,2011-11-16,Winter,2011,Nov,14,0,Wednesday,1,Misty,0.46,0.4545,1.0,0.1343,12,49,61,411,61,61
7561,2011-11-16,Winter,2011,Nov,15,0,Wednesday,1,Light_rainsnow,0.48,0.4697,0.94,0.1045,16,50,66,411,66,66
7562,2011-11-16,Winter,2011,Nov,16,0,Wednesday,1,Light_rainsnow,0.48,0.4697,0.94,0.1045,13,110,123,411,123,123
7563,2011-11-16,Winter,2011,Nov,17,0,Wednesday,1,Misty,0.48,0.4697,0.88,0.194,17,216,233,411,233,233
7564,2011-11-16,Winter,2011,Nov,18,0,Wednesday,1,Light_rainsnow,0.46,0.4545,0.88,0.3881,13,176,189,411,189,189
7565,2011-11-16,Winter,2011,Nov,19,0,Wednesday,1,Light_rainsnow,0.46,0.4545,0.88,0.3881,3,108,111,411,111,111
7566,2011-11-16,Winter,2011,Nov,20,0,Wednesday,1,Light_rainsnow,0.44,0.4394,0.88,0.3881,5,94,99,411,99,99
7567,2011-11-16,Winter,2011,Nov,21,0,Wednesday,1,Light_rainsnow,0.44,0.4394,0.88,0.2836,3,72,75,411,75,75
7568,2011-11-16,Winter,2011,Nov,22,0,Wednesday,1,Light_rainsnow,0.42,0.4242,0.88,0.2239,1,45,46,411,46,46
7569,2011-11-16,Winter,2011,Nov,23,0,Wednesday,1,Light_rainsnow,0.42,0.4242,0.88,0.1343,3,28,31,411,31,31
7570,2011-11-17,Winter,2011,Nov,0,0,Thursday,1,Misty,0.42,0.4242,0.88,0.2537,2,22,24,410,24,24
7571,2011-11-17,Winter,2011,Nov,1,0,Thursday,1,Misty,0.42,0.4242,0.82,0.1642,0,5,5,410,5,5
7572,2011-11-17,Winter,2011,Nov,2,0,Thursday,1,Misty,0.42,0.4242,0.82,0.2239,0,5,5,410,5,5
7573,2011-11-17,Winter,2011,Nov,3,0,Thursday,1,Misty,0.42,0.4242,0.77,0.3284,0,3,3,410,3,3
7574,2011-11-17,Winter,2011,Nov,4,0,Thursday,1,Misty,0.4,0.4091,0.62,0.4179,1,3,4,410,4,4
7575,2011-11-17,Winter,2011,Nov,5,0,Thursday,1,Light_rainsnow,0.34,0.303,0.71,0.3284,1,21,22,410,22,22
7576,2011-11-17,Winter,2011,Nov,6,0,Thursday,1,Light_rainsnow,0.36,0.3485,0.57,0.2239,3,72,75,410,75,75
7577,2011-11-17,Winter,2011,Nov,7,0,Thursday,1,Light_rainsnow,0.34,0.3182,0.61,0.2836,4,164,168,410,168,168
7578,2011-11-17,Winter,2011,Nov,8,0,Thursday,1,Light_rainsnow,0.34,0.303,0.61,0.2985,12,343,355,410,355,355
7579,2011-11-17,Winter,2011,Nov,9,0,Thursday,1,Misty,0.34,0.303,0.61,0.3284,14,184,198,410,198,198
7580,2011-11-17,Winter,2011,Nov,10,0,Thursday,1,Misty,0.34,0.303,0.61,0.3284,7,74,81,410,81,81
7581,2011-11-17,Winter,2011,Nov,11,0,Thursday,1,Light_rainsnow,0.32,0.303,0.66,0.3284,4,93,97,410,97,97
7582,2011-11-17,Winter,2011,Nov,12,0,Thursday,1,Misty,0.34,0.303,0.53,0.2985,6,115,121,410,121,121
7583,2011-11-17,Winter,2011,Nov,13,0,Thursday,1,Misty,0.34,0.303,0.49,0.4478,15,109,124,410,124,124
7584,2011-11-17,Winter,2011,Nov,14,0,Thursday,1,Misty,0.34,0.303,0.49,0.3881,5,105,110,410,110,110
7585,2011-11-17,Winter,2011,Nov,15,0,Thursday,1,Misty,0.34,0.303,0.49,0.4478,10,106,116,410,116,116
7586,2011-11-17,Winter,2011,Nov,16,0,Thursday,1,Clear,0.32,0.2879,0.39,0.4179,8,187,195,410,195,195
7587,2011-11-17,Winter,2011,Nov,17,0,Thursday,1,Clear,0.32,0.2879,0.42,0.3881,20,379,399,410,399,399
7588,2011-11-17,Winter,2011,Nov,18,0,Thursday,1,Clear,0.32,0.3182,0.39,0.194,9,298,307,410,307,307
7589,2011-11-17,Winter,2011,Nov,19,0,Thursday,1,Clear,0.3,0.2879,0.45,0.2239,7,210,217,410,217,217
7590,2011-11-17,Winter,2011,Nov,20,0,Thursday,1,Clear,0.3,0.2879,0.42,0.2836,7,162,169,410,169,169
7591,2011-11-17,Winter,2011,Nov,21,0,Thursday,1,Clear,0.3,0.2879,0.42,0.2537,3,113,116,410,116,116
7592,2011-11-17,Winter,2011,Nov,22,0,Thursday,1,Clear,0.26,0.2424,0.52,0.2537,1,83,84,410,84,84
7593,2011-11-17,Winter,2011,Nov,23,0,Thursday,1,Clear,0.26,0.2576,0.52,0.2239,0,58,58,410,58,58
7594,2011-11-18,Winter,2011,Nov,0,0,Friday,1,Clear,0.26,0.2576,0.48,0.1642,2,28,30,409,30,30
7595,2011-11-18,Winter,2011,Nov,1,0,Friday,1,Clear,0.26,0.2273,0.44,0.3284,0,10,10,409,10,10
7596,2011-11-18,Winter,2011,Nov,2,0,Friday,1,Clear,0.24,0.2273,0.44,0.2239,2,8,10,409,10,10
7597,2011-11-18,Winter,2011,Nov,3,0,Friday,1,Clear,0.24,0.2121,0.41,0.2836,0,2,2,409,2,2
7598,2011-11-18,Winter,2011,Nov,4,0,Friday,1,Clear,0.22,0.2273,0.44,0.1642,0,5,5,409,5,5
7599,2011-11-18,Winter,2011,Nov,5,0,Friday,1,Clear,0.22,0.2273,0.44,0.1343,0,22,22,409,22,22
7600,2011-11-18,Winter,2011,Nov,6,0,Friday,1,Clear,0.22,0.2576,0.44,0.0896,1,70,71,409,71,71
7601,2011-11-18,Winter,2011,Nov,7,0,Friday,1,Clear,0.22,0.2273,0.44,0.1642,5,211,216,409,216,216
7602,2011-11-18,Winter,2011,Nov,8,0,Friday,1,Clear,0.22,0.2273,0.44,0.194,6,369,375,409,375,375
7603,2011-11-18,Winter,2011,Nov,9,0,Friday,1,Clear,0.26,0.2576,0.41,0.194,6,207,213,409,213,213
7604,2011-11-18,Winter,2011,Nov,10,0,Friday,1,Clear,0.26,0.2424,0.41,0.2836,10,105,115,409,115,115
7605,2011-11-18,Winter,2011,Nov,11,0,Friday,1,Clear,0.3,0.303,0.36,0.1343,18,122,140,409,140,140
7606,2011-11-18,Winter,2011,Nov,12,0,Friday,1,Clear,0.32,0.3333,0.33,0.0,22,143,165,409,165,165
7607,2011-11-18,Winter,2011,Nov,13,0,Friday,1,Clear,0.34,0.3182,0.31,0.2239,31,146,177,409,177,177
7608,2011-11-18,Winter,2011,Nov,14,0,Friday,1,Clear,0.34,0.3333,0.31,0.1343,31,123,154,409,154,154
7609,2011-11-18,Winter,2011,Nov,15,0,Friday,1,Clear,0.34,0.3333,0.29,0.1343,27,151,178,409,178,178
7610,2011-11-18,Winter,2011,Nov,16,0,Friday,1,Clear,0.34,0.3333,0.29,0.1343,19,190,209,409,209,209
7611,2011-11-18,Winter,2011,Nov,17,0,Friday,1,Clear,0.32,0.3333,0.31,0.1343,17,361,378,409,378,378
7612,2011-11-18,Winter,2011,Nov,18,0,Friday,1,Clear,0.3,0.303,0.36,0.1642,16,312,328,409,328,328
7613,2011-11-18,Winter,2011,Nov,19,0,Friday,1,Clear,0.28,0.2727,0.41,0.1642,7,183,190,409,190,190
7614,2011-11-18,Winter,2011,Nov,20,0,Friday,1,Clear,0.28,0.2727,0.48,0.194,8,129,137,409,137,137
7615,2011-11-18,Winter,2011,Nov,21,0,Friday,1,Clear,0.28,0.2727,0.48,0.1642,3,108,111,409,111,111
7616,2011-11-18,Winter,2011,Nov,22,0,Friday,1,Clear,0.26,0.2727,0.52,0.1045,9,88,97,409,97,97
7617,2011-11-18,Winter,2011,Nov,23,0,Friday,1,Clear,0.26,0.2727,0.6,0.1343,5,54,59,409,59,59
7618,2011-11-19,Winter,2011,Nov,0,0,Saturday,0,Clear,0.26,0.2576,0.56,0.194,4,49,53,408,53,53
7619,2011-11-19,Winter,2011,Nov,1,0,Saturday,0,Clear,0.26,0.2273,0.52,0.2985,1,34,35,408,35,35
7620,2011-11-19,Winter,2011,Nov,2,0,Saturday,0,Clear,0.24,0.2424,0.56,0.1642,12,34,46,408,46,46
7621,2011-11-19,Winter,2011,Nov,3,0,Saturday,0,Clear,0.26,0.2424,0.48,0.2537,4,11,15,408,15,15
7622,2011-11-19,Winter,2011,Nov,4,0,Saturday,0,Clear,0.26,0.2273,0.48,0.3284,4,4,8,408,8,8
7623,2011-11-19,Winter,2011,Nov,5,0,Saturday,0,Clear,0.24,0.2273,0.56,0.2537,0,2,2,408,2,2
7624,2011-11-19,Winter,2011,Nov,6,0,Saturday,0,Clear,0.24,0.2121,0.6,0.3284,2,10,12,408,12,12
7625,2011-11-19,Winter,2011,Nov,7,0,Saturday,0,Clear,0.24,0.2273,0.6,0.2537,3,38,41,408,41,41
7626,2011-11-19,Winter,2011,Nov,8,0,Saturday,0,Clear,0.26,0.2424,0.56,0.2537,12,80,92,408,92,92
7627,2011-11-19,Winter,2011,Nov,9,0,Saturday,0,Clear,0.28,0.2576,0.52,0.2985,12,130,142,408,142,142
7628,2011-11-19,Winter,2011,Nov,10,0,Saturday,0,Clear,0.32,0.303,0.45,0.2537,35,165,200,408,200,200
7629,2011-11-19,Winter,2011,Nov,11,0,Saturday,0,Clear,0.36,0.3788,0.4,0.0,50,183,233,408,233,233
7630,2011-11-19,Winter,2011,Nov,12,0,Saturday,0,Clear,0.4,0.4091,0.35,0.2836,93,218,311,408,311,311
7631,2011-11-19,Winter,2011,Nov,13,0,Saturday,0,Clear,0.42,0.4242,0.3,0.2836,118,245,363,408,363,363
7632,2011-11-19,Winter,2011,Nov,14,0,Saturday,0,Clear,0.42,0.4242,0.32,0.2985,121,228,349,408,349,349
7633,2011-11-19,Winter,2011,Nov,15,0,Saturday,0,Clear,0.42,0.4242,0.41,0.194,120,262,382,408,382,382
7634,2011-11-19,Winter,2011,Nov,16,0,Saturday,0,Clear,0.42,0.4242,0.38,0.2985,99,188,287,408,287,287
7635,2011-11-19,Winter,2011,Nov,17,0,Saturday,0,Clear,0.4,0.4091,0.4,0.194,61,171,232,408,232,232
7636,2011-11-19,Winter,2011,Nov,18,0,Saturday,0,Clear,0.38,0.3939,0.46,0.1343,36,172,208,408,208,208
7637,2011-11-19,Winter,2011,Nov,19,0,Saturday,0,Misty,0.34,0.3333,0.71,0.1343,33,149,182,408,182,182
7638,2011-11-19,Winter,2011,Nov,20,0,Saturday,0,Misty,0.36,0.3636,0.57,0.1045,48,115,163,408,163,163
7639,2011-11-19,Winter,2011,Nov,21,0,Saturday,0,Misty,0.36,0.3485,0.62,0.194,29,79,108,408,108,108
7640,2011-11-19,Winter,2011,Nov,22,0,Saturday,0,Misty,0.38,0.3939,0.62,0.1642,26,80,106,408,106,106
7641,2011-11-19,Winter,2011,Nov,23,0,Saturday,0,Clear,0.38,0.3939,0.62,0.2239,20,73,93,408,93,93
7642,2011-11-20,Winter,2011,Nov,0,0,Sunday,0,Clear,0.38,0.3939,0.66,0.1642,14,79,93,407,93,93
7643,2011-11-20,Winter,2011,Nov,1,0,Sunday,0,Clear,0.4,0.4091,0.62,0.2537,11,73,84,407,84,84
7644,2011-11-20,Winter,2011,Nov,2,0,Sunday,0,Clear,0.4,0.4091,0.62,0.2836,12,44,56,407,56,56
7645,2011-11-20,Winter,2011,Nov,3,0,Sunday,0,Misty,0.4,0.4091,0.66,0.2836,6,31,37,407,37,37
7646,2011-11-20,Winter,2011,Nov,4,0,Sunday,0,Misty,0.4,0.4091,0.71,0.2836,2,10,12,407,12,12
7647,2011-11-20,Winter,2011,Nov,5,0,Sunday,0,Misty,0.42,0.4242,0.67,0.2836,0,4,4,407,4,4
7648,2011-11-20,Winter,2011,Nov,6,0,Sunday,0,Misty,0.42,0.4242,0.67,0.2537,3,6,9,407,9,9
7649,2011-11-20,Winter,2011,Nov,7,0,Sunday,0,Clear,0.42,0.4242,0.67,0.2239,4,19,23,407,23,23
7650,2011-11-20,Winter,2011,Nov,8,0,Sunday,0,Misty,0.42,0.4242,0.71,0.2836,13,52,65,407,65,65
7651,2011-11-20,Winter,2011,Nov,9,0,Sunday,0,Clear,0.44,0.4394,0.72,0.1642,29,109,138,407,138,138
7652,2011-11-20,Winter,2011,Nov,10,0,Sunday,0,Misty,0.44,0.4394,0.72,0.1045,46,183,229,407,229,229
7653,2011-11-20,Winter,2011,Nov,11,0,Sunday,0,Misty,0.5,0.4848,0.63,0.1045,74,212,286,407,286,286
7654,2011-11-20,Winter,2011,Nov,12,0,Sunday,0,Misty,0.5,0.4848,0.63,0.1343,70,234,304,407,304,304
7655,2011-11-20,Winter,2011,Nov,13,0,Sunday,0,Misty,0.54,0.5152,0.6,0.194,84,285,369,407,369,369
7656,2011-11-20,Winter,2011,Nov,14,0,Sunday,0,Clear,0.52,0.5,0.63,0.2537,113,250,363,407,363,363
7657,2011-11-20,Winter,2011,Nov,15,0,Sunday,0,Misty,0.52,0.5,0.68,0.194,109,242,351,407,351,351
7658,2011-11-20,Winter,2011,Nov,16,0,Sunday,0,Misty,0.52,0.5,0.63,0.1343,81,225,306,407,306,306
7659,2011-11-20,Winter,2011,Nov,17,0,Sunday,0,Misty,0.52,0.5,0.63,0.194,35,168,203,407,203,203
7660,2011-11-20,Winter,2011,Nov,18,0,Sunday,0,Misty,0.54,0.5152,0.64,0.194,22,123,145,407,145,145
7661,2011-11-20,Winter,2011,Nov,19,0,Sunday,0,Misty,0.5,0.4848,0.72,0.1045,17,140,157,407,157,157
7662,2011-11-20,Winter,2011,Nov,20,0,Sunday,0,Misty,0.52,0.5,0.68,0.1045,23,90,113,407,113,113
7663,2011-11-20,Winter,2011,Nov,21,0,Sunday,0,Misty,0.48,0.4697,0.77,0.0896,11,94,105,407,105,105
7664,2011-11-20,Winter,2011,Nov,22,0,Sunday,0,Light_rainsnow,0.46,0.4545,0.88,0.0896,5,35,40,407,40,40
7665,2011-11-20,Winter,2011,Nov,23,0,Sunday,0,Light_rainsnow,0.46,0.4545,0.88,0.0896,3,25,28,407,28,28
7666,2011-11-21,Winter,2011,Nov,0,0,Monday,1,Misty,0.46,0.4545,0.94,0.0,4,13,17,406,17,17
7667,2011-11-21,Winter,2011,Nov,1,0,Monday,1,Light_rainsnow,0.46,0.4545,0.94,0.194,4,8,12,406,12,12
7668,2011-11-21,Winter,2011,Nov,2,0,Monday,1,Light_rainsnow,0.44,0.4394,1.0,0.194,1,2,3,406,3,3
7669,2011-11-21,Winter,2011,Nov,3,0,Monday,1,Light_rainsnow,0.44,0.4394,1.0,0.1343,0,4,4,406,4,4
7670,2011-11-21,Winter,2011,Nov,4,0,Monday,1,Light_rainsnow,0.44,0.4394,1.0,0.1343,0,5,5,406,5,5
7671,2011-11-21,Winter,2011,Nov,5,0,Monday,1,Misty,0.44,0.4394,1.0,0.0,0,20,20,406,20,20
7672,2011-11-21,Winter,2011,Nov,6,0,Monday,1,Misty,0.42,0.4242,1.0,0.0,0,76,76,406,76,76
7673,2011-11-21,Winter,2011,Nov,7,0,Monday,1,Misty,0.46,0.4545,0.94,0.1642,17,229,246,406,246,246
7674,2011-11-21,Winter,2011,Nov,8,0,Monday,1,Misty,0.46,0.4545,0.94,0.0,13,378,391,406,391,391
7675,2011-11-21,Winter,2011,Nov,9,0,Monday,1,Misty,0.48,0.4697,0.94,0.1045,15,222,237,406,237,237
7676,2011-11-21,Winter,2011,Nov,10,0,Monday,1,Misty,0.52,0.5,0.83,0.0,25,110,135,406,135,135
7677,2011-11-21,Winter,2011,Nov,11,0,Monday,1,Misty,0.52,0.5,0.83,0.1045,16,112,128,406,128,128
7678,2011-11-21,Winter,2011,Nov,12,0,Monday,1,Misty,0.5,0.4848,0.77,0.1343,24,138,162,406,162,162
7679,2011-11-21,Winter,2011,Nov,13,0,Monday,1,Misty,0.5,0.4848,0.77,0.1343,13,121,134,406,134,134
7680,2011-11-21,Winter,2011,Nov,14,0,Monday,1,Misty,0.48,0.4697,0.82,0.194,14,121,135,406,135,135
7681,2011-11-21,Winter,2011,Nov,15,0,Monday,1,Light_rainsnow,0.44,0.4394,0.94,0.2239,15,93,108,406,108,108
7682,2011-11-21,Winter,2011,Nov,16,0,Monday,1,Light_rainsnow,0.44,0.4394,0.94,0.2239,13,95,108,406,108,108
7683,2011-11-21,Winter,2011,Nov,17,0,Monday,1,Light_rainsnow,0.42,0.4242,0.94,0.2985,10,200,210,406,210,210
7684,2011-11-21,Winter,2011,Nov,18,0,Monday,1,Light_rainsnow,0.42,0.4242,0.88,0.194,8,184,192,406,192,192
7685,2011-11-21,Winter,2011,Nov,19,0,Monday,1,Light_rainsnow,0.4,0.4091,0.94,0.194,2,135,137,406,137,137
7686,2011-11-21,Winter,2011,Nov,20,0,Monday,1,Light_rainsnow,0.4,0.4091,0.87,0.2239,5,75,80,406,80,80
7687,2011-11-21,Winter,2011,Nov,21,0,Monday,1,Light_rainsnow,0.4,0.4091,0.87,0.1642,11,103,114,406,114,114
7688,2011-11-21,Winter,2011,Nov,22,0,Monday,1,Light_rainsnow,0.4,0.4091,0.87,0.1343,6,72,78,406,78,78
7689,2011-11-21,Winter,2011,Nov,23,0,Monday,1,Light_rainsnow,0.4,0.4091,0.87,0.1642,4,29,33,406,33,33
7690,2011-11-22,Winter,2011,Nov,0,0,Tuesday,1,Light_rainsnow,0.38,0.3939,0.94,0.1045,0,14,14,405,14,14
7691,2011-11-22,Winter,2011,Nov,1,0,Tuesday,1,Light_rainsnow,0.4,0.4091,0.94,0.1343,1,5,6,405,6,6
7692,2011-11-22,Winter,2011,Nov,2,0,Tuesday,1,Light_rainsnow,0.38,0.3939,1.0,0.1045,2,4,6,405,6,6
7693,2011-11-22,Winter,2011,Nov,3,0,Tuesday,1,Light_rainsnow,0.38,0.3939,1.0,0.1045,1,2,3,405,3,3
7694,2011-11-22,Winter,2011,Nov,4,0,Tuesday,1,Light_rainsnow,0.38,0.3939,0.94,0.1642,0,7,7,405,7,7
7695,2011-11-22,Winter,2011,Nov,5,0,Tuesday,1,Light_rainsnow,0.38,0.3939,0.94,0.1642,1,17,18,405,18,18
7696,2011-11-22,Winter,2011,Nov,6,0,Tuesday,1,Misty,0.38,0.3939,0.94,0.1045,1,63,64,405,64,64
7697,2011-11-22,Winter,2011,Nov,7,0,Tuesday,1,Light_rainsnow,0.38,0.3939,0.94,0.2239,2,119,121,405,121,121
7698,2011-11-22,Winter,2011,Nov,8,0,Tuesday,1,Light_rainsnow,0.38,0.3939,0.94,0.2239,5,185,190,405,190,190
7699,2011-11-22,Winter,2011,Nov,9,0,Tuesday,1,Light_rainsnow,0.4,0.4091,0.94,0.0,2,147,149,405,149,149
7700,2011-11-22,Winter,2011,Nov,10,0,Tuesday,1,Light_rainsnow,0.4,0.4091,0.94,0.0,6,46,52,405,52,52
7701,2011-11-22,Winter,2011,Nov,11,0,Tuesday,1,Light_rainsnow,0.4,0.4091,0.94,0.1343,4,28,32,405,32,32
7702,2011-11-22,Winter,2011,Nov,12,0,Tuesday,1,Light_rainsnow,0.4,0.4091,1.0,0.0896,3,18,21,405,21,21
7703,2011-11-22,Winter,2011,Nov,13,0,Tuesday,1,Light_rainsnow,0.42,0.4242,1.0,0.0896,4,22,26,405,26,26
7704,2011-11-22,Winter,2011,Nov,14,0,Tuesday,1,Light_rainsnow,0.42,0.4242,1.0,0.0896,4,31,35,405,35,35
7705,2011-11-22,Winter,2011,Nov,15,0,Tuesday,1,Light_rainsnow,0.44,0.4394,0.94,0.0,2,32,34,405,34,34
7706,2011-11-22,Winter,2011,Nov,16,0,Tuesday,1,Light_rainsnow,0.44,0.4394,0.94,0.0,3,59,62,405,62,62
7707,2011-11-22,Winter,2011,Nov,17,0,Tuesday,1,Light_rainsnow,0.44,0.4394,1.0,0.0896,4,161,165,405,165,165
7708,2011-11-22,Winter,2011,Nov,18,0,Tuesday,1,Light_rainsnow,0.44,0.4394,1.0,0.0,0,148,148,405,148,148
7709,2011-11-22,Winter,2011,Nov,19,0,Tuesday,1,Light_rainsnow,0.46,0.4545,0.94,0.1045,5,106,111,405,111,111
7710,2011-11-22,Winter,2011,Nov,20,0,Tuesday,1,Misty,0.46,0.4545,1.0,0.2239,6,121,127,405,127,127
7711,2011-11-22,Winter,2011,Nov,21,0,Tuesday,1,Misty,0.46,0.4545,1.0,0.2537,4,86,90,405,90,90
7712,2011-11-22,Winter,2011,Nov,22,0,Tuesday,1,Misty,0.5,0.4848,0.94,0.194,6,81,87,405,87,87
7713,2011-11-22,Winter,2011,Nov,23,0,Tuesday,1,Misty,0.48,0.4697,0.94,0.2537,3,36,39,405,39,39
7714,2011-11-23,Winter,2011,Nov,0,0,Wednesday,1,Misty,0.48,0.4697,0.94,0.2537,2,14,16,404,16,16
7715,2011-11-23,Winter,2011,Nov,1,0,Wednesday,1,Misty,0.48,0.4697,0.94,0.2985,0,8,8,404,8,8
7716,2011-11-23,Winter,2011,Nov,2,0,Wednesday,1,Light_rainsnow,0.5,0.4848,0.94,0.3582,1,5,6,404,6,6
7717,2011-11-23,Winter,2011,Nov,3,0,Wednesday,1,Light_rainsnow,0.5,0.4848,0.94,0.3582,1,2,3,404,3,3
7718,2011-11-23,Winter,2011,Nov,4,0,Wednesday,1,Light_rainsnow,0.52,0.5,0.88,0.3582,0,5,5,404,5,5
7719,2011-11-23,Winter,2011,Nov,5,0,Wednesday,1,Misty,0.46,0.4545,0.94,0.194,1,16,17,404,17,17
7720,2011-11-23,Winter,2011,Nov,6,0,Wednesday,1,Misty,0.44,0.4394,1.0,0.0,1,68,69,404,69,69
7721,2011-11-23,Winter,2011,Nov,7,0,Wednesday,1,Misty,0.46,0.4545,1.0,0.0896,2,154,156,404,156,156
7722,2011-11-23,Winter,2011,Nov,8,0,Wednesday,1,Misty,0.48,0.4697,0.94,0.1045,7,316,323,404,323,323
7723,2011-11-23,Winter,2011,Nov,9,0,Wednesday,1,Misty,0.52,0.5,0.94,0.194,3,164,167,404,167,167
7724,2011-11-23,Winter,2011,Nov,10,0,Wednesday,1,Misty,0.52,0.5,0.94,0.194,6,70,76,404,76,76
7725,2011-11-23,Winter,2011,Nov,11,0,Wednesday,1,Misty,0.5,0.4848,0.72,0.4179,9,107,116,404,116,116
7726,2011-11-23,Winter,2011,Nov,12,0,Wednesday,1,Clear,0.48,0.4697,0.55,0.4179,9,151,160,404,160,160
7727,2011-11-23,Winter,2011,Nov,13,0,Wednesday,1,Misty,0.44,0.4394,0.54,0.4925,12,162,174,404,174,174
7728,2011-11-23,Winter,2011,Nov,14,0,Wednesday,1,Clear,0.42,0.4242,0.54,0.4627,13,200,213,404,213,213
7729,2011-11-23,Winter,2011,Nov,15,0,Wednesday,1,Misty,0.42,0.4242,0.54,0.4478,13,194,207,404,207,207
7730,2011-11-23,Winter,2011,Nov,16,0,Wednesday,1,Misty,0.4,0.4091,0.62,0.4627,4,169,173,404,173,173
7731,2011-11-23,Winter,2011,Nov,17,0,Wednesday,1,Light_rainsnow,0.38,0.3939,0.71,0.3881,7,156,163,404,163,163
7732,2011-11-23,Winter,2011,Nov,18,0,Wednesday,1,Misty,0.4,0.4091,0.58,0.5224,7,138,145,404,145,145
7733,2011-11-23,Winter,2011,Nov,19,0,Wednesday,1,Clear,0.38,0.3939,0.58,0.3881,6,116,122,404,122,122
7734,2011-11-23,Winter,2011,Nov,20,0,Wednesday,1,Clear,0.36,0.3333,0.62,0.3881,1,67,68,404,68,68
7735,2011-11-23,Winter,2011,Nov,21,0,Wednesday,1,Clear,0.36,0.3182,0.57,0.4627,0,66,66,404,66,66
7736,2011-11-23,Winter,2011,Nov,22,0,Wednesday,1,Clear,0.34,0.303,0.61,0.4478,3,59,62,404,62,62
7737,2011-11-23,Winter,2011,Nov,23,0,Wednesday,1,Clear,0.34,0.303,0.61,0.3582,4,47,51,404,51,51
7738,2011-11-24,Winter,2011,Nov,0,1,Thursday,0,Clear,0.32,0.303,0.57,0.2239,1,22,23,403,23,23
7739,2011-11-24,Winter,2011,Nov,1,1,Thursday,0,Clear,0.32,0.2879,0.57,0.4179,1,23,24,403,24,24
7740,2011-11-24,Winter,2011,Nov,2,1,Thursday,0,Clear,0.3,0.2879,0.61,0.2836,3,19,22,403,22,22
7741,2011-11-24,Winter,2011,Nov,3,1,Thursday,0,Clear,0.28,0.2879,0.65,0.1343,1,4,5,403,5,5
7742,2011-11-24,Winter,2011,Nov,4,1,Thursday,0,Clear,0.3,0.3182,0.61,0.0896,1,1,2,403,2,2
7743,2011-11-24,Winter,2011,Nov,5,1,Thursday,0,Clear,0.3,0.3182,0.61,0.1045,1,10,11,403,11,11
7744,2011-11-24,Winter,2011,Nov,6,1,Thursday,0,Clear,0.3,0.3182,0.61,0.0896,1,5,6,403,6,6
7745,2011-11-24,Winter,2011,Nov,7,1,Thursday,0,Clear,0.26,0.2727,0.75,0.1045,9,31,40,403,40,40
7746,2011-11-24,Winter,2011,Nov,8,1,Thursday,0,Clear,0.3,0.3182,0.65,0.0896,4,42,46,403,46,46
7747,2011-11-24,Winter,2011,Nov,9,1,Thursday,0,Clear,0.34,0.3485,0.61,0.0,13,68,81,403,81,81
7748,2011-11-24,Winter,2011,Nov,10,1,Thursday,0,Clear,0.36,0.3788,0.57,0.0,34,64,98,403,98,98
7749,2011-11-24,Winter,2011,Nov,11,1,Thursday,0,Clear,0.42,0.4242,0.41,0.2985,52,90,142,403,142,142
7750,2011-11-24,Winter,2011,Nov,12,1,Thursday,0,Clear,0.46,0.4545,0.36,0.2239,62,88,150,403,150,150
7751,2011-11-24,Winter,2011,Nov,13,1,Thursday,0,Clear,0.48,0.4697,0.33,0.2239,84,91,175,403,175,175
7752,2011-11-24,Winter,2011,Nov,14,1,Thursday,0,Clear,0.5,0.4848,0.31,0.2985,74,94,168,403,168,168
7753,2011-11-24,Winter,2011,Nov,15,1,Thursday,0,Clear,0.5,0.4848,0.31,0.2537,78,71,149,403,149,149
7754,2011-11-24,Winter,2011,Nov,16,1,Thursday,0,Clear,0.5,0.4848,0.34,0.2836,48,66,114,403,114,114
7755,2011-11-24,Winter,2011,Nov,17,1,Thursday,0,Clear,0.48,0.4697,0.33,0.1045,34,40,74,403,74,74
7756,2011-11-24,Winter,2011,Nov,18,1,Thursday,0,Clear,0.42,0.4242,0.5,0.0896,13,24,37,403,37,37
7757,2011-11-24,Winter,2011,Nov,19,1,Thursday,0,Clear,0.4,0.4091,0.54,0.1045,15,13,28,403,28,28
7758,2011-11-24,Winter,2011,Nov,20,1,Thursday,0,Clear,0.36,0.3485,0.76,0.1642,14,17,31,403,31,31
7759,2011-11-24,Winter,2011,Nov,21,1,Thursday,0,Clear,0.36,0.3485,0.71,0.1642,7,19,26,403,26,26
7760,2011-11-24,Winter,2011,Nov,22,1,Thursday,0,Clear,0.36,0.3485,0.71,0.1642,8,14,22,403,22,22
7761,2011-11-24,Winter,2011,Nov,23,1,Thursday,0,Clear,0.34,0.3485,0.76,0.1045,2,19,21,403,21,21
7762,2011-11-25,Winter,2011,Nov,0,0,Friday,1,Clear,0.34,0.3333,0.76,0.1642,7,22,29,402,29,29
7763,2011-11-25,Winter,2011,Nov,1,0,Friday,1,Clear,0.34,0.3636,0.76,0.0,2,12,14,402,14,14
7764,2011-11-25,Winter,2011,Nov,2,0,Friday,1,Clear,0.28,0.2879,0.81,0.1045,4,6,10,402,10,10
7765,2011-11-25,Winter,2011,Nov,3,0,Friday,1,Clear,0.28,0.2879,0.75,0.1045,0,2,2,402,2,2
7766,2011-11-25,Winter,2011,Nov,4,0,Friday,1,Clear,0.3,0.3182,0.75,0.1045,4,3,7,402,7,7
7767,2011-11-25,Winter,2011,Nov,5,0,Friday,1,Clear,0.28,0.3182,0.75,0.0,2,3,5,402,5,5
7768,2011-11-25,Winter,2011,Nov,6,0,Friday,1,Clear,0.26,0.2727,0.81,0.1045,4,9,13,402,13,13
7769,2011-11-25,Winter,2011,Nov,7,0,Friday,1,Clear,0.26,0.303,0.81,0.0,4,31,35,402,35,35
7770,2011-11-25,Winter,2011,Nov,8,0,Friday,1,Clear,0.26,0.2727,0.81,0.1343,6,68,74,402,74,74
7771,2011-11-25,Winter,2011,Nov,9,0,Friday,1,Clear,0.32,0.3485,0.76,0.0,25,70,95,402,95,95
7772,2011-11-25,Winter,2011,Nov,10,0,Friday,1,Clear,0.36,0.3485,0.71,0.1642,60,82,142,402,142,142
7773,2011-11-25,Winter,2011,Nov,11,0,Friday,1,Clear,0.4,0.4091,0.66,0.1045,99,127,226,402,226,226
7774,2011-11-25,Winter,2011,Nov,12,0,Friday,1,Clear,0.46,0.4545,0.51,0.1045,126,146,272,402,272,272
7775,2011-11-25,Winter,2011,Nov,13,0,Friday,1,Clear,0.5,0.4848,0.45,0.2239,143,140,283,402,283,283
7776,2011-11-25,Winter,2011,Nov,14,0,Friday,1,Clear,0.52,0.5,0.39,0.2239,122,150,272,402,272,272
7777,2011-11-25,Winter,2011,Nov,15,0,Friday,1,Clear,0.52,0.5,0.36,0.194,165,145,310,402,310,310
7778,2011-11-25,Winter,2011,Nov,16,0,Friday,1,Clear,0.5,0.4848,0.39,0.1642,122,139,261,402,261,261
7779,2011-11-25,Winter,2011,Nov,17,0,Friday,1,Clear,0.5,0.4848,0.34,0.1045,57,127,184,402,184,184
7780,2011-11-25,Winter,2011,Nov,18,0,Friday,1,Clear,0.46,0.4545,0.44,0.0896,45,108,153,402,153,153
7781,2011-11-25,Winter,2011,Nov,19,0,Friday,1,Clear,0.42,0.4242,0.67,0.0,38,96,134,402,134,134
7782,2011-11-25,Winter,2011,Nov,20,0,Friday,1,Clear,0.4,0.4091,0.58,0.0896,19,76,95,402,95,95
7783,2011-11-25,Winter,2011,Nov,21,0,Friday,1,Clear,0.36,0.3788,0.71,0.0,24,61,85,402,85,85
7784,2011-11-25,Winter,2011,Nov,22,0,Friday,1,Clear,0.34,0.3485,0.71,0.0896,12,46,58,402,58,58
7785,2011-11-25,Winter,2011,Nov,23,0,Friday,1,Clear,0.34,0.3485,0.76,0.1045,5,28,33,402,33,33
7786,2011-11-26,Winter,2011,Nov,0,0,Saturday,0,Clear,0.34,0.3485,0.76,0.1045,9,38,47,401,47,47
7787,2011-11-26,Winter,2011,Nov,1,0,Saturday,0,Clear,0.32,0.3333,0.76,0.0896,5,24,29,401,29,29
7788,2011-11-26,Winter,2011,Nov,2,0,Saturday,0,Clear,0.3,0.3182,0.81,0.1045,3,20,23,401,23,23
7789,2011-11-26,Winter,2011,Nov,3,0,Saturday,0,Clear,0.3,0.3333,0.81,0.0,8,9,17,401,17,17
7790,2011-11-26,Winter,2011,Nov,4,0,Saturday,0,Clear,0.3,0.3333,0.81,0.0,0,4,4,401,4,4
7791,2011-11-26,Winter,2011,Nov,5,0,Saturday,0,Clear,0.3,0.3182,0.75,0.1045,0,3,3,401,3,3
7792,2011-11-26,Winter,2011,Nov,6,0,Saturday,0,Misty,0.3,0.3182,0.75,0.0896,2,8,10,401,10,10
7793,2011-11-26,Winter,2011,Nov,7,0,Saturday,0,Clear,0.26,0.2727,0.87,0.1045,4,13,17,401,17,17
7794,2011-11-26,Winter,2011,Nov,8,0,Saturday,0,Clear,0.32,0.3333,0.76,0.0896,10,50,60,401,60,60
7795,2011-11-26,Winter,2011,Nov,9,0,Saturday,0,Clear,0.34,0.3485,0.76,0.0896,16,67,83,401,83,83
7796,2011-11-26,Winter,2011,Nov,10,0,Saturday,0,Clear,0.36,0.3788,0.81,0.0,57,84,141,401,141,141
7797,2011-11-26,Winter,2011,Nov,11,0,Saturday,0,Clear,0.4,0.4091,0.62,0.1045,107,123,230,401,230,230
7798,2011-11-26,Winter,2011,Nov,12,0,Saturday,0,Clear,0.44,0.4394,0.51,0.0,137,172,309,401,309,309
7799,2011-11-26,Winter,2011,Nov,13,0,Saturday,0,Clear,0.48,0.4697,0.44,0.0,177,148,325,401,325,325
7800,2011-11-26,Winter,2011,Nov,14,0,Saturday,0,Misty,0.48,0.4697,0.48,0.1343,141,158,299,401,299,299
7801,2011-11-26,Winter,2011,Nov,15,0,Saturday,0,Misty,0.5,0.4848,0.42,0.1045,154,160,314,401,314,314
7802,2011-11-26,Winter,2011,Nov,16,0,Saturday,0,Misty,0.46,0.4545,0.47,0.1343,137,138,275,401,275,275
7803,2011-11-26,Winter,2011,Nov,17,0,Saturday,0,Misty,0.46,0.4545,0.47,0.1343,62,122,184,401,184,184
7804,2011-11-26,Winter,2011,Nov,18,0,Saturday,0,Misty,0.42,0.4242,0.62,0.1642,67,118,185,401,185,185
7805,2011-11-26,Winter,2011,Nov,19,0,Saturday,0,Misty,0.4,0.4091,0.71,0.0896,46,100,146,401,146,146
7806,2011-11-26,Winter,2011,Nov,20,0,Saturday,0,Misty,0.42,0.4242,0.58,0.0,55,86,141,401,141,141
7807,2011-11-26,Winter,2011,Nov,21,0,Saturday,0,Misty,0.38,0.3939,0.82,0.0,20,72,92,401,92,92
7808,2011-11-26,Winter,2011,Nov,22,0,Saturday,0,Misty,0.38,0.3939,0.76,0.0,14,51,65,401,65,65
7809,2011-11-26,Winter,2011,Nov,23,0,Saturday,0,Clear,0.36,0.3788,0.81,0.0,18,51,69,401,69,69
7810,2011-11-27,Winter,2011,Nov,0,0,Sunday,0,Clear,0.36,0.3788,0.81,0.0,7,39,46,400,46,46
7811,2011-11-27,Winter,2011,Nov,1,0,Sunday,0,Clear,0.36,0.3788,0.81,0.0,9,35,44,400,44,44
7812,2011-11-27,Winter,2011,Nov,2,0,Sunday,0,Clear,0.34,0.3636,0.81,0.0,9,22,31,400,31,31
7813,2011-11-27,Winter,2011,Nov,3,0,Sunday,0,Clear,0.34,0.3636,0.87,0.0,9,8,17,400,17,17
7814,2011-11-27,Winter,2011,Nov,4,0,Sunday,0,Clear,0.34,0.3485,0.87,0.1045,0,4,4,400,4,4
7815,2011-11-27,Winter,2011,Nov,5,0,Sunday,0,Clear,0.36,0.3485,0.87,0.194,0,5,5,400,5,5
7816,2011-11-27,Winter,2011,Nov,6,0,Sunday,0,Clear,0.38,0.3939,0.82,0.1642,0,9,9,400,9,9
7817,2011-11-27,Winter,2011,Nov,7,0,Sunday,0,Clear,0.38,0.3939,0.87,0.2239,12,11,23,400,23,23
7818,2011-11-27,Winter,2011,Nov,8,0,Sunday,0,Clear,0.4,0.4091,0.82,0.2985,6,36,42,400,42,42
7819,2011-11-27,Winter,2011,Nov,9,0,Sunday,0,Clear,0.46,0.4545,0.72,0.2836,21,90,111,400,111,111
7820,2011-11-27,Winter,2011,Nov,10,0,Sunday,0,Clear,0.46,0.4545,0.72,0.2836,58,131,189,400,189,189
7821,2011-11-27,Winter,2011,Nov,11,0,Sunday,0,Clear,0.5,0.4848,0.63,0.3582,83,157,240,400,240,240
7822,2011-11-27,Winter,2011,Nov,12,0,Sunday,0,Clear,0.54,0.5152,0.56,0.2836,63,193,256,400,256,256
7823,2011-11-27,Winter,2011,Nov,13,0,Sunday,0,Clear,0.54,0.5152,0.6,0.194,97,216,313,400,313,313
7824,2011-11-27,Winter,2011,Nov,14,0,Sunday,0,Clear,0.62,0.6212,0.43,0.4627,113,200,313,400,313,313
7825,2011-11-27,Winter,2011,Nov,15,0,Sunday,0,Clear,0.62,0.6212,0.43,0.2836,96,221,317,400,317,317
7826,2011-11-27,Winter,2011,Nov,16,0,Sunday,0,Clear,0.56,0.5303,0.52,0.2537,94,229,323,400,323,323
7827,2011-11-27,Winter,2011,Nov,17,0,Sunday,0,Clear,0.54,0.5152,0.56,0.194,37,167,204,400,204,204
7828,2011-11-27,Winter,2011,Nov,18,0,Sunday,0,Clear,0.5,0.4848,0.63,0.1642,25,130,155,400,155,155
7829,2011-11-27,Winter,2011,Nov,19,0,Sunday,0,Clear,0.48,0.4697,0.67,0.2239,30,109,139,400,139,139
7830,2011-11-27,Winter,2011,Nov,20,0,Sunday,0,Clear,0.5,0.4848,0.63,0.2537,10,94,104,400,104,104
7831,2011-11-27,Winter,2011,Nov,21,0,Sunday,0,Clear,0.48,0.4697,0.67,0.2836,13,75,88,400,88,88
7832,2011-11-27,Winter,2011,Nov,22,0,Sunday,0,Clear,0.48,0.4697,0.72,0.2537,13,53,66,400,66,66
7833,2011-11-27,Winter,2011,Nov,23,0,Sunday,0,Clear,0.48,0.4697,0.72,0.2537,5,27,32,400,32,32
7834,2011-11-28,Winter,2011,Nov,0,0,Monday,1,Clear,0.46,0.4545,0.77,0.2836,6,10,16,399,16,16
7835,2011-11-28,Winter,2011,Nov,1,0,Monday,1,Clear,0.46,0.4545,0.77,0.2985,1,12,13,399,13,13
7836,2011-11-28,Winter,2011,Nov,3,0,Monday,1,Clear,0.44,0.4394,0.88,0.2239,1,4,5,399,5,5
7837,2011-11-28,Winter,2011,Nov,4,0,Monday,1,Clear,0.44,0.4394,0.82,0.0896,0,4,4,399,4,4
7838,2011-11-28,Winter,2011,Nov,5,0,Monday,1,Clear,0.4,0.4091,0.87,0.0,0,34,34,399,34,34
7839,2011-11-28,Winter,2011,Nov,6,0,Monday,1,Clear,0.42,0.4242,0.82,0.0896,6,98,104,399,104,104
7840,2011-11-28,Winter,2011,Nov,7,0,Monday,1,Clear,0.42,0.4242,0.88,0.0,7,270,277,399,277,277
7841,2011-11-28,Winter,2011,Nov,8,0,Monday,1,Misty,0.42,0.4242,0.94,0.0,13,394,407,399,407,407
7842,2011-11-28,Winter,2011,Nov,9,0,Monday,1,Misty,0.44,0.4394,0.88,0.2239,17,191,208,399,208,208
7843,2011-11-28,Winter,2011,Nov,10,0,Monday,1,Misty,0.48,0.4697,0.77,0.1343,21,86,107,399,107,107
7844,2011-11-28,Winter,2011,Nov,11,0,Monday,1,Misty,0.52,0.5,0.68,0.1045,11,107,118,399,118,118
7845,2011-11-28,Winter,2011,Nov,12,0,Monday,1,Clear,0.56,0.5303,0.6,0.1045,13,165,178,399,178,178
7846,2011-11-28,Winter,2011,Nov,13,0,Monday,1,Misty,0.58,0.5455,0.56,0.0,25,137,162,399,162,162
7847,2011-11-28,Winter,2011,Nov,14,0,Monday,1,Clear,0.6,0.6212,0.56,0.0,14,129,143,399,143,143
7848,2011-11-28,Winter,2011,Nov,15,0,Monday,1,Clear,0.58,0.5455,0.6,0.1642,18,132,150,399,150,150
7849,2011-11-28,Winter,2011,Nov,16,0,Monday,1,Clear,0.56,0.5303,0.6,0.194,24,240,264,399,264,264
7850,2011-11-28,Winter,2011,Nov,17,0,Monday,1,Clear,0.58,0.5455,0.56,0.194,24,444,468,399,468,468
7851,2011-11-28,Winter,2011,Nov,18,0,Monday,1,Clear,0.56,0.5303,0.64,0.2239,20,396,416,399,416,416
7852,2011-11-28,Winter,2011,Nov,19,0,Monday,1,Clear,0.54,0.5152,0.73,0.2239,4,260,264,399,264,264
7853,2011-11-28,Winter,2011,Nov,20,0,Monday,1,Misty,0.54,0.5152,0.73,0.2537,12,206,218,399,218,218
7854,2011-11-28,Winter,2011,Nov,21,0,Monday,1,Misty,0.54,0.5152,0.77,0.2239,4,152,156,399,156,156
7855,2011-11-28,Winter,2011,Nov,22,0,Monday,1,Misty,0.52,0.5,0.83,0.1045,7,102,109,399,109,109
7856,2011-11-28,Winter,2011,Nov,23,0,Monday,1,Misty,0.52,0.5,0.83,0.1343,5,41,46,399,46,46
7857,2011-11-29,Winter,2011,Nov,0,0,Tuesday,1,Clear,0.52,0.5,0.83,0.0,4,18,22,398,22,22
7858,2011-11-29,Winter,2011,Nov,1,0,Tuesday,1,Clear,0.52,0.5,0.83,0.0896,1,16,17,398,17,17
7859,2011-11-29,Winter,2011,Nov,2,0,Tuesday,1,Misty,0.5,0.4848,0.88,0.0,0,5,5,398,5,5
7860,2011-11-29,Winter,2011,Nov,3,0,Tuesday,1,Misty,0.5,0.4848,0.88,0.0,0,2,2,398,2,2
7861,2011-11-29,Winter,2011,Nov,4,0,Tuesday,1,Misty,0.52,0.5,0.83,0.3284,1,5,6,398,6,6
7862,2011-11-29,Winter,2011,Nov,5,0,Tuesday,1,Clear,0.5,0.4848,0.88,0.2836,1,21,22,398,22,22
7863,2011-11-29,Winter,2011,Nov,6,0,Tuesday,1,Clear,0.52,0.5,0.83,0.2836,1,88,89,398,89,89
7864,2011-11-29,Winter,2011,Nov,7,0,Tuesday,1,Clear,0.52,0.5,0.77,0.2239,12,330,342,398,342,342
7865,2011-11-29,Winter,2011,Nov,8,0,Tuesday,1,Clear,0.54,0.5152,0.77,0.2836,9,440,449,398,449,449
7866,2011-11-29,Winter,2011,Nov,9,0,Tuesday,1,Light_rainsnow,0.56,0.5303,0.73,0.4179,5,197,202,398,202,202
7867,2011-11-29,Winter,2011,Nov,10,0,Tuesday,1,Light_rainsnow,0.56,0.5303,0.73,0.4179,2,34,36,398,36,36
7868,2011-11-29,Winter,2011,Nov,11,0,Tuesday,1,Light_rainsnow,0.5,0.4848,0.88,0.2985,1,10,11,398,11,11
7869,2011-11-29,Winter,2011,Nov,12,0,Tuesday,1,Light_rainsnow,0.42,0.4242,0.82,0.4179,1,17,18,398,18,18
7870,2011-11-29,Winter,2011,Nov,13,0,Tuesday,1,Light_rainsnow,0.42,0.4242,0.77,0.2836,0,22,22,398,22,22
7871,2011-11-29,Winter,2011,Nov,14,0,Tuesday,1,Light_rainsnow,0.4,0.4091,0.94,0.194,1,35,36,398,36,36
7872,2011-11-29,Winter,2011,Nov,15,0,Tuesday,1,Light_rainsnow,0.4,0.4091,0.87,0.3284,5,60,65,398,65,65
7873,2011-11-29,Winter,2011,Nov,16,0,Tuesday,1,Light_rainsnow,0.4,0.4091,0.87,0.2239,5,146,151,398,151,151
7874,2011-11-29,Winter,2011,Nov,17,0,Tuesday,1,Misty,0.4,0.4091,0.87,0.2985,8,346,354,398,354,354
7875,2011-11-29,Winter,2011,Nov,18,0,Tuesday,1,Misty,0.4,0.4091,0.82,0.2985,11,347,358,398,358,358
7876,2011-11-29,Winter,2011,Nov,19,0,Tuesday,1,Misty,0.4,0.4091,0.82,0.3284,6,244,250,398,250,250
7877,2011-11-29,Winter,2011,Nov,20,0,Tuesday,1,Misty,0.38,0.3939,0.87,0.2537,8,176,184,398,184,184
7878,2011-11-29,Winter,2011,Nov,21,0,Tuesday,1,Misty,0.38,0.3939,0.87,0.2537,9,116,125,398,125,125
7879,2011-11-29,Winter,2011,Nov,22,0,Tuesday,1,Clear,0.38,0.3939,0.82,0.2985,5,90,95,398,95,95
7880,2011-11-29,Winter,2011,Nov,23,0,Tuesday,1,Clear,0.36,0.3333,0.76,0.3881,0,53,53,398,53,53
7881,2011-11-30,Winter,2011,Nov,0,0,Wednesday,1,Clear,0.36,0.3333,0.62,0.4179,1,23,24,397,24,24
7882,2011-11-30,Winter,2011,Nov,1,0,Wednesday,1,Clear,0.34,0.303,0.66,0.3284,0,8,8,397,8,8
7883,2011-11-30,Winter,2011,Nov,2,0,Wednesday,1,Clear,0.32,0.3182,0.7,0.1642,0,5,5,397,5,5
7884,2011-11-30,Winter,2011,Nov,3,0,Wednesday,1,Clear,0.32,0.3182,0.7,0.1642,0,1,1,397,1,1
7885,2011-11-30,Winter,2011,Nov,4,0,Wednesday,1,Clear,0.3,0.2879,0.75,0.2239,0,5,5,397,5,5
7886,2011-11-30,Winter,2011,Nov,5,0,Wednesday,1,Clear,0.28,0.2727,0.81,0.194,1,21,22,397,22,22
7887,2011-11-30,Winter,2011,Nov,6,0,Wednesday,1,Clear,0.26,0.2727,0.87,0.1045,3,100,103,397,103,103
7888,2011-11-30,Winter,2011,Nov,7,0,Wednesday,1,Clear,0.26,0.2727,0.81,0.1045,9,276,285,397,285,285
7889,2011-11-30,Winter,2011,Nov,8,0,Wednesday,1,Clear,0.28,0.2727,0.81,0.194,13,465,478,397,478,478
7890,2011-11-30,Winter,2011,Nov,9,0,Wednesday,1,Clear,0.3,0.2879,0.75,0.2836,7,186,193,397,193,193
7891,2011-11-30,Winter,2011,Nov,10,0,Wednesday,1,Clear,0.34,0.3182,0.66,0.2239,15,95,110,397,110,110
7892,2011-11-30,Winter,2011,Nov,11,0,Wednesday,1,Clear,0.38,0.3939,0.54,0.2985,10,112,122,397,122,122
7893,2011-11-30,Winter,2011,Nov,12,0,Wednesday,1,Misty,0.36,0.3333,0.53,0.2836,12,148,160,397,160,160
7894,2011-11-30,Winter,2011,Nov,13,0,Wednesday,1,Misty,0.38,0.3939,0.43,0.3582,16,131,147,397,147,147
7895,2011-11-30,Winter,2011,Nov,14,0,Wednesday,1,Misty,0.38,0.3939,0.43,0.3582,13,99,112,397,112,112
7896,2011-11-30,Winter,2011,Nov,15,0,Wednesday,1,Clear,0.36,0.3333,0.46,0.3284,11,104,115,397,115,115
7897,2011-11-30,Winter,2011,Nov,16,0,Wednesday,1,Clear,0.36,0.3333,0.46,0.2836,27,199,226,397,226,226
7898,2011-11-30,Winter,2011,Nov,17,0,Wednesday,1,Misty,0.34,0.303,0.49,0.3284,15,365,380,397,380,380
7899,2011-11-30,Winter,2011,Nov,18,0,Wednesday,1,Clear,0.34,0.303,0.49,0.3284,7,369,376,397,376,376
7900,2011-11-30,Winter,2011,Nov,19,0,Wednesday,1,Misty,0.32,0.303,0.57,0.2836,6,273,279,397,279,279
7901,2011-11-30,Winter,2011,Nov,20,0,Wednesday,1,Misty,0.32,0.303,0.57,0.2836,6,184,190,397,190,190
7902,2011-11-30,Winter,2011,Nov,21,0,Wednesday,1,Clear,0.32,0.2879,0.53,0.3881,7,128,135,397,135,135
7903,2011-11-30,Winter,2011,Nov,22,0,Wednesday,1,Clear,0.3,0.2727,0.56,0.2985,5,82,87,397,87,87
7904,2011-11-30,Winter,2011,Nov,23,0,Wednesday,1,Clear,0.28,0.2576,0.52,0.2836,4,46,50,397,50,50
7905,2011-12-01,Winter,2011,Dec,0,0,Thursday,1,Clear,0.28,0.2576,0.52,0.3284,1,19,20,396,20,20
7906,2011-12-01,Winter,2011,Dec,1,0,Thursday,1,Clear,0.26,0.2424,0.6,0.2836,1,9,10,396,10,10
7907,2011-12-01,Winter,2011,Dec,2,0,Thursday,1,Clear,0.26,0.2273,0.56,0.2985,1,8,9,396,9,9
7908,2011-12-01,Winter,2011,Dec,3,0,Thursday,1,Clear,0.26,0.2424,0.56,0.2537,1,6,7,396,7,7
7909,2011-12-01,Winter,2011,Dec,4,0,Thursday,1,Clear,0.26,0.2424,0.56,0.2836,0,1,1,396,1,1
7910,2011-12-01,Winter,2011,Dec,5,0,Thursday,1,Clear,0.26,0.2424,0.56,0.2537,1,23,24,396,24,24
7911,2011-12-01,Winter,2011,Dec,6,0,Thursday,1,Clear,0.24,0.2121,0.65,0.2836,5,92,97,396,97,97
7912,2011-12-01,Winter,2011,Dec,7,0,Thursday,1,Clear,0.24,0.2121,0.65,0.3582,11,265,276,396,276,276
7913,2011-12-01,Winter,2011,Dec,8,0,Thursday,1,Clear,0.26,0.2273,0.6,0.3284,15,462,477,396,477,477
7914,2011-12-01,Winter,2011,Dec,9,0,Thursday,1,Clear,0.3,0.2727,0.52,0.3284,9,215,224,396,224,224
7915,2011-12-01,Winter,2011,Dec,10,0,Thursday,1,Clear,0.32,0.303,0.53,0.2985,7,86,93,396,93,93
7916,2011-12-01,Winter,2011,Dec,11,0,Thursday,1,Clear,0.34,0.3182,0.49,0.2537,7,95,102,396,102,102
7917,2011-12-01,Winter,2011,Dec,12,0,Thursday,1,Clear,0.36,0.3485,0.46,0.2239,9,139,148,396,148,148
7918,2011-12-01,Winter,2011,Dec,13,0,Thursday,1,Clear,0.4,0.4091,0.4,0.2239,17,137,154,396,154,154
7919,2011-12-01,Winter,2011,Dec,14,0,Thursday,1,Clear,0.4,0.4091,0.4,0.2239,20,130,150,396,150,150
7920,2011-12-01,Winter,2011,Dec,15,0,Thursday,1,Clear,0.4,0.4091,0.4,0.2239,10,144,154,396,154,154
7921,2011-12-01,Winter,2011,Dec,16,0,Thursday,1,Clear,0.4,0.4091,0.4,0.194,9,192,201,396,201,201
7922,2011-12-01,Winter,2011,Dec,17,0,Thursday,1,Clear,0.36,0.3485,0.46,0.1343,9,409,418,396,418,418
7923,2011-12-01,Winter,2011,Dec,18,0,Thursday,1,Clear,0.36,0.3636,0.43,0.1045,12,393,405,396,405,405
7924,2011-12-01,Winter,2011,Dec,19,0,Thursday,1,Clear,0.34,0.3485,0.46,0.1045,9,219,228,396,228,228
7925,2011-12-01,Winter,2011,Dec,20,0,Thursday,1,Clear,0.34,0.3485,0.46,0.1045,12,178,190,396,190,190
7926,2011-12-01,Winter,2011,Dec,21,0,Thursday,1,Clear,0.3,0.3182,0.61,0.1045,8,154,162,396,162,162
7927,2011-12-01,Winter,2011,Dec,22,0,Thursday,1,Clear,0.3,0.3333,0.61,0.0,5,99,104,396,104,104
7928,2011-12-01,Winter,2011,Dec,23,0,Thursday,1,Clear,0.26,0.2879,0.7,0.0896,3,70,73,396,73,73
7929,2011-12-02,Winter,2011,Dec,0,0,Friday,1,Clear,0.26,0.2879,0.7,0.0896,6,32,38,395,38,38
7930,2011-12-02,Winter,2011,Dec,1,0,Friday,1,Clear,0.24,0.2879,0.75,0.0,1,14,15,395,15,15
7931,2011-12-02,Winter,2011,Dec,2,0,Friday,1,Clear,0.24,0.2879,0.75,0.0,0,10,10,395,10,10
7932,2011-12-02,Winter,2011,Dec,3,0,Friday,1,Clear,0.22,0.2727,0.8,0.0,0,1,1,395,1,1
7933,2011-12-02,Winter,2011,Dec,4,0,Friday,1,Clear,0.22,0.2727,0.8,0.0,0,3,3,395,3,3
7934,2011-12-02,Winter,2011,Dec,5,0,Friday,1,Clear,0.22,0.2576,0.8,0.0896,0,23,23,395,23,23
7935,2011-12-02,Winter,2011,Dec,6,0,Friday,1,Clear,0.22,0.2727,0.8,0.0,3,84,87,395,87,87
7936,2011-12-02,Winter,2011,Dec,7,0,Friday,1,Clear,0.22,0.2576,0.87,0.0896,6,199,205,395,205,205
7937,2011-12-02,Winter,2011,Dec,8,0,Friday,1,Clear,0.24,0.2879,0.87,0.0,13,432,445,395,445,445
7938,2011-12-02,Winter,2011,Dec,9,0,Friday,1,Clear,0.28,0.3182,0.81,0.0,12,234,246,395,246,246
7939,2011-12-02,Winter,2011,Dec,10,0,Friday,1,Clear,0.3,0.2879,0.75,0.2239,16,89,105,395,105,105
7940,2011-12-02,Winter,2011,Dec,11,0,Friday,1,Clear,0.34,0.3333,0.66,0.1642,18,142,160,395,160,160
7941,2011-12-02,Winter,2011,Dec,12,0,Friday,1,Clear,0.36,0.3485,0.57,0.1343,18,186,204,395,204,204
7942,2011-12-02,Winter,2011,Dec,13,0,Friday,1,Clear,0.4,0.4091,0.47,0.1343,19,188,207,395,207,207
7943,2011-12-02,Winter,2011,Dec,14,0,Friday,1,Clear,0.42,0.4242,0.44,0.1045,25,145,170,395,170,170
7944,2011-12-02,Winter,2011,Dec,15,0,Friday,1,Clear,0.42,0.4242,0.41,0.0896,24,175,199,395,199,199
7945,2011-12-02,Winter,2011,Dec,16,0,Friday,1,Clear,0.42,0.4242,0.41,0.0896,22,254,276,395,276,276
7946,2011-12-02,Winter,2011,Dec,17,0,Friday,1,Clear,0.42,0.4242,0.38,0.0,20,391,411,395,411,411
7947,2011-12-02,Winter,2011,Dec,18,0,Friday,1,Clear,0.4,0.4091,0.5,0.0,10,362,372,395,372,372
7948,2011-12-02,Winter,2011,Dec,19,0,Friday,1,Clear,0.34,0.3182,0.53,0.2537,13,252,265,395,265,265
7949,2011-12-02,Winter,2011,Dec,20,0,Friday,1,Clear,0.38,0.3939,0.4,0.2836,12,178,190,395,190,190
7950,2011-12-02,Winter,2011,Dec,21,0,Friday,1,Clear,0.34,0.3333,0.49,0.194,9,102,111,395,111,111
7951,2011-12-02,Winter,2011,Dec,22,0,Friday,1,Clear,0.32,0.3182,0.53,0.194,7,95,102,395,102,102
7952,2011-12-02,Winter,2011,Dec,23,0,Friday,1,Clear,0.32,0.303,0.53,0.2836,14,81,95,395,95,95
7953,2011-12-03,Winter,2011,Dec,0,0,Saturday,0,Clear,0.3,0.2879,0.56,0.2537,10,65,75,394,75,75
7954,2011-12-03,Winter,2011,Dec,1,0,Saturday,0,Clear,0.26,0.2576,0.65,0.194,9,62,71,394,71,71
7955,2011-12-03,Winter,2011,Dec,2,0,Saturday,0,Clear,0.26,0.2576,0.65,0.1642,9,41,50,394,50,50
7956,2011-12-03,Winter,2011,Dec,3,0,Saturday,0,Clear,0.24,0.2424,0.7,0.1343,4,5,9,394,9,9
7957,2011-12-03,Winter,2011,Dec,4,0,Saturday,0,Clear,0.22,0.2273,0.75,0.1343,1,7,8,394,8,8
7958,2011-12-03,Winter,2011,Dec,5,0,Saturday,0,Clear,0.24,0.2576,0.7,0.0896,0,6,6,394,6,6
7959,2011-12-03,Winter,2011,Dec,6,0,Saturday,0,Clear,0.24,0.2576,0.65,0.1045,1,10,11,394,11,11
7960,2011-12-03,Winter,2011,Dec,7,0,Saturday,0,Clear,0.22,0.2576,0.75,0.0896,2,24,26,394,26,26
7961,2011-12-03,Winter,2011,Dec,8,0,Saturday,0,Clear,0.24,0.2576,0.75,0.0896,1,62,63,394,63,63
7962,2011-12-03,Winter,2011,Dec,9,0,Saturday,0,Clear,0.26,0.2727,0.7,0.1045,25,99,124,394,124,124
7963,2011-12-03,Winter,2011,Dec,10,0,Saturday,0,Clear,0.32,0.3333,0.61,0.1343,22,173,195,394,195,195
7964,2011-12-03,Winter,2011,Dec,11,0,Saturday,0,Clear,0.32,0.3333,0.57,0.0896,48,227,275,394,275,275
7965,2011-12-03,Winter,2011,Dec,12,0,Saturday,0,Clear,0.36,0.3788,0.5,0.0,78,280,358,394,358,358
7966,2011-12-03,Winter,2011,Dec,13,0,Saturday,0,Clear,0.36,0.3636,0.5,0.0896,70,222,292,394,292,292
7967,2011-12-03,Winter,2011,Dec,14,0,Saturday,0,Clear,0.36,0.3788,0.46,0.0,92,251,343,394,343,343
7968,2011-12-03,Winter,2011,Dec,15,0,Saturday,0,Clear,0.38,0.3939,0.46,0.0,100,237,337,394,337,337
7969,2011-12-03,Winter,2011,Dec,16,0,Saturday,0,Clear,0.38,0.3939,0.46,0.0,75,230,305,394,305,305
7970,2011-12-03,Winter,2011,Dec,17,0,Saturday,0,Clear,0.36,0.3788,0.62,0.0,46,186,232,394,232,232
7971,2011-12-03,Winter,2011,Dec,18,0,Saturday,0,Clear,0.34,0.3333,0.53,0.1343,31,193,224,394,224,224
7972,2011-12-03,Winter,2011,Dec,19,0,Saturday,0,Clear,0.3,0.3182,0.61,0.0896,31,144,175,394,175,175
7973,2011-12-03,Winter,2011,Dec,20,0,Saturday,0,Clear,0.3,0.3182,0.61,0.0896,17,110,127,394,127,127
7974,2011-12-03,Winter,2011,Dec,21,0,Saturday,0,Misty,0.3,0.3182,0.61,0.0896,5,104,109,394,109,109
7975,2011-12-03,Winter,2011,Dec,22,0,Saturday,0,Misty,0.32,0.3333,0.61,0.0896,17,97,114,394,114,114
7976,2011-12-03,Winter,2011,Dec,23,0,Saturday,0,Clear,0.3,0.303,0.7,0.1343,12,73,85,394,85,85
7977,2011-12-04,Winter,2011,Dec,0,0,Sunday,0,Clear,0.3,0.3182,0.7,0.1045,19,64,83,393,83,83
7978,2011-12-04,Winter,2011,Dec,1,0,Sunday,0,Clear,0.3,0.3182,0.75,0.0896,20,54,74,393,74,74
7979,2011-12-04,Winter,2011,Dec,2,0,Sunday,0,Clear,0.26,0.303,0.81,0.0,11,51,62,393,62,62
7980,2011-12-04,Winter,2011,Dec,3,0,Sunday,0,Clear,0.28,0.3182,0.75,0.0,7,34,41,393,41,41
7981,2011-12-04,Winter,2011,Dec,4,0,Sunday,0,Clear,0.26,0.303,0.87,0.0,2,9,11,393,11,11
7982,2011-12-04,Winter,2011,Dec,5,0,Sunday,0,Clear,0.26,0.303,0.81,0.0,2,2,4,393,4,4
7983,2011-12-04,Winter,2011,Dec,6,0,Sunday,0,Clear,0.24,0.2879,0.93,0.0,1,3,4,393,4,4
7984,2011-12-04,Winter,2011,Dec,7,0,Sunday,0,Clear,0.26,0.303,0.87,0.0,3,23,26,393,26,26
7985,2011-12-04,Winter,2011,Dec,8,0,Sunday,0,Clear,0.26,0.303,0.87,0.0,7,48,55,393,55,55
7986,2011-12-04,Winter,2011,Dec,9,0,Sunday,0,Clear,0.3,0.3333,0.81,0.0,12,114,126,393,126,126
7987,2011-12-04,Winter,2011,Dec,10,0,Sunday,0,Clear,0.32,0.3333,0.81,0.1343,36,180,216,393,216,216
7988,2011-12-04,Winter,2011,Dec,11,0,Sunday,0,Clear,0.34,0.3333,0.81,0.1642,48,206,254,393,254,254
7989,2011-12-04,Winter,2011,Dec,12,0,Sunday,0,Clear,0.36,0.3485,0.81,0.1642,82,247,329,393,329,329
7990,2011-12-04,Winter,2011,Dec,13,0,Sunday,0,Clear,0.4,0.4091,0.66,0.2239,88,269,357,393,357,357
7991,2011-12-04,Winter,2011,Dec,14,0,Sunday,0,Clear,0.42,0.4242,0.62,0.1343,77,246,323,393,323,323
7992,2011-12-04,Winter,2011,Dec,15,0,Sunday,0,Clear,0.42,0.4242,0.62,0.194,69,227,296,393,296,296
7993,2011-12-04,Winter,2011,Dec,16,0,Sunday,0,Clear,0.42,0.4242,0.58,0.2239,64,266,330,393,330,330
7994,2011-12-04,Winter,2011,Dec,17,0,Sunday,0,Clear,0.38,0.3939,0.76,0.1343,38,207,245,393,245,245
7995,2011-12-04,Winter,2011,Dec,18,0,Sunday,0,Clear,0.38,0.3939,0.71,0.0,10,161,171,393,171,171
7996,2011-12-04,Winter,2011,Dec,19,0,Sunday,0,Clear,0.38,0.3939,0.76,0.0,15,158,173,393,173,173
7997,2011-12-04,Winter,2011,Dec,20,0,Sunday,0,Clear,0.36,0.3485,0.76,0.1343,8,116,124,393,124,124
7998,2011-12-04,Winter,2011,Dec,21,0,Sunday,0,Clear,0.36,0.3636,0.81,0.1045,7,65,72,393,72,72
7999,2011-12-04,Winter,2011,Dec,22,0,Sunday,0,Clear,0.34,0.3485,0.87,0.1045,5,59,64,393,64,64
8000,2011-12-04,Winter,2011,Dec,23,0,Sunday,0,Clear,0.34,0.3485,0.87,0.1045,3,42,45,393,45,45
8001,2011-12-05,Winter,2011,Dec,0,0,Monday,1,Clear,0.32,0.3333,0.87,0.0896,3,21,24,392,24,24
8002,2011-12-05,Winter,2011,Dec,1,0,Monday,1,Clear,0.32,0.3485,0.87,0.0,2,10,12,392,12,12
8003,2011-12-05,Winter,2011,Dec,2,0,Monday,1,Clear,0.32,0.3485,0.87,0.0,0,8,8,392,8,8
8004,2011-12-05,Winter,2011,Dec,3,0,Monday,1,Clear,0.32,0.3485,0.87,0.0,0,2,2,392,2,2
8005,2011-12-05,Winter,2011,Dec,4,0,Monday,1,Clear,0.3,0.3182,0.87,0.1045,0,7,7,392,7,7
8006,2011-12-05,Winter,2011,Dec,5,0,Monday,1,Clear,0.3,0.3182,0.87,0.1045,1,24,25,392,25,25
8007,2011-12-05,Winter,2011,Dec,6,0,Monday,1,Clear,0.3,0.3182,0.93,0.0896,1,89,90,392,90,90
8008,2011-12-05,Winter,2011,Dec,7,0,Monday,1,Clear,0.32,0.3485,0.9,0.0,9,274,283,392,283,283
8009,2011-12-05,Winter,2011,Dec,8,0,Monday,1,Clear,0.32,0.3485,0.93,0.0,12,392,404,392,404,404
8010,2011-12-05,Winter,2011,Dec,9,0,Monday,1,Misty,0.36,0.3636,0.87,0.0896,12,178,190,392,190,190
8011,2011-12-05,Winter,2011,Dec,10,0,Monday,1,Misty,0.36,0.3636,0.87,0.0896,9,78,87,392,87,87
8012,2011-12-05,Winter,2011,Dec,11,0,Monday,1,Misty,0.36,0.3636,0.87,0.0896,17,106,123,392,123,123
8013,2011-12-05,Winter,2011,Dec,12,0,Monday,1,Misty,0.4,0.4091,0.76,0.1045,29,125,154,392,154,154
8014,2011-12-05,Winter,2011,Dec,13,0,Monday,1,Misty,0.42,0.4242,0.71,0.0896,18,153,171,392,171,171
8015,2011-12-05,Winter,2011,Dec,14,0,Monday,1,Misty,0.46,0.4545,0.67,0.0,7,126,133,392,133,133
8016,2011-12-05,Winter,2011,Dec,15,0,Monday,1,Misty,0.46,0.4545,0.72,0.0896,16,132,148,392,148,148
8017,2011-12-05,Winter,2011,Dec,16,0,Monday,1,Clear,0.5,0.4848,0.63,0.0896,10,238,248,392,248,248
8018,2011-12-05,Winter,2011,Dec,17,0,Monday,1,Clear,0.42,0.4242,0.77,0.0,16,430,446,392,446,446
8019,2011-12-05,Winter,2011,Dec,18,0,Monday,1,Clear,0.44,0.4394,0.77,0.0,13,386,399,392,399,399
8020,2011-12-05,Winter,2011,Dec,19,0,Monday,1,Misty,0.46,0.4545,0.77,0.0,13,295,308,392,308,308
8021,2011-12-05,Winter,2011,Dec,20,0,Monday,1,Misty,0.46,0.4545,0.82,0.1045,15,190,205,392,205,205
8022,2011-12-05,Winter,2011,Dec,21,0,Monday,1,Misty,0.44,0.4394,0.88,0.0896,10,166,176,392,176,176
8023,2011-12-05,Winter,2011,Dec,22,0,Monday,1,Misty,0.44,0.4394,0.88,0.1343,12,94,106,392,106,106
8024,2011-12-05,Winter,2011,Dec,23,0,Monday,1,Misty,0.46,0.4545,0.88,0.1343,8,54,62,392,62,62
8025,2011-12-06,Winter,2011,Dec,0,0,Tuesday,1,Misty,0.5,0.4848,0.77,0.2985,3,25,28,391,28,28
8026,2011-12-06,Winter,2011,Dec,1,0,Tuesday,1,Misty,0.46,0.4545,0.88,0.2985,2,14,16,391,16,16
8027,2011-12-06,Winter,2011,Dec,2,0,Tuesday,1,Misty,0.46,0.4545,0.87,0.194,0,3,3,391,3,3
8028,2011-12-06,Winter,2011,Dec,3,0,Tuesday,1,Misty,0.46,0.4545,0.87,0.194,0,3,3,391,3,3
8029,2011-12-06,Winter,2011,Dec,4,0,Tuesday,1,Light_rainsnow,0.46,0.4545,0.88,0.2239,0,7,7,391,7,7
8030,2011-12-06,Winter,2011,Dec,5,0,Tuesday,1,Light_rainsnow,0.46,0.4545,0.88,0.2239,0,20,20,391,20,20
8031,2011-12-06,Winter,2011,Dec,6,0,Tuesday,1,Misty,0.44,0.4394,0.94,0.2836,5,81,86,391,86,86
8032,2011-12-06,Winter,2011,Dec,7,0,Tuesday,1,Misty,0.46,0.4545,0.94,0.194,7,227,234,391,234,234
8033,2011-12-06,Winter,2011,Dec,8,0,Tuesday,1,Misty,0.46,0.4545,0.94,0.194,13,401,414,391,414,414
8034,2011-12-06,Winter,2011,Dec,9,0,Tuesday,1,Misty,0.46,0.4545,0.94,0.2239,4,200,204,391,204,204
8035,2011-12-06,Winter,2011,Dec,10,0,Tuesday,1,Light_rainsnow,0.46,0.4545,0.94,0.2836,6,44,50,391,50,50
8036,2011-12-06,Winter,2011,Dec,11,0,Tuesday,1,Light_rainsnow,0.46,0.4545,0.94,0.2537,4,28,32,391,32,32
8037,2011-12-06,Winter,2011,Dec,12,0,Tuesday,1,Light_rainsnow,0.46,0.4545,1.0,0.2239,5,50,55,391,55,55
8038,2011-12-06,Winter,2011,Dec,13,0,Tuesday,1,Light_rainsnow,0.46,0.4545,1.0,0.194,6,65,71,391,71,71
8039,2011-12-06,Winter,2011,Dec,14,0,Tuesday,1,Light_rainsnow,0.48,0.4697,1.0,0.2239,6,69,75,391,75,75
8040,2011-12-06,Winter,2011,Dec,15,0,Tuesday,1,Light_rainsnow,0.5,0.4848,1.0,0.194,2,43,45,391,45,45
8041,2011-12-06,Winter,2011,Dec,16,0,Tuesday,1,Light_rainsnow,0.46,0.4545,1.0,0.2537,4,84,88,391,88,88
8042,2011-12-06,Winter,2011,Dec,17,0,Tuesday,1,Misty,0.46,0.4545,1.0,0.2239,13,249,262,391,262,262
8043,2011-12-06,Winter,2011,Dec,18,0,Tuesday,1,Misty,0.46,0.4545,1.0,0.2836,17,287,304,391,304,304
8044,2011-12-06,Winter,2011,Dec,19,0,Tuesday,1,Light_rainsnow,0.46,0.4545,1.0,0.2985,10,223,233,391,233,233
8045,2011-12-06,Winter,2011,Dec,20,0,Tuesday,1,Light_rainsnow,0.46,0.4545,1.0,0.2985,3,107,110,391,110,110
8046,2011-12-06,Winter,2011,Dec,21,0,Tuesday,1,Misty,0.44,0.4394,1.0,0.194,6,108,114,391,114,114
8047,2011-12-06,Winter,2011,Dec,22,0,Tuesday,1,Light_rainsnow,0.46,0.4545,1.0,0.1642,5,82,87,391,87,87
8048,2011-12-06,Winter,2011,Dec,23,0,Tuesday,1,Light_rainsnow,0.46,0.4545,1.0,0.1642,5,48,53,391,53,53
8049,2011-12-07,Winter,2011,Dec,0,0,Wednesday,1,Clear,0.44,0.4394,1.0,0.194,3,30,33,390,33,33
8050,2011-12-07,Winter,2011,Dec,1,0,Wednesday,1,Misty,0.46,0.4545,1.0,0.2537,4,9,13,390,13,13
8051,2011-12-07,Winter,2011,Dec,2,0,Wednesday,1,Light_rainsnow,0.46,0.4545,1.0,0.2239,2,4,6,390,6,6
8052,2011-12-07,Winter,2011,Dec,3,0,Wednesday,1,Light_rainsnow,0.46,0.4545,1.0,0.2239,0,3,3,390,3,3
8053,2011-12-07,Winter,2011,Dec,4,0,Wednesday,1,Light_rainsnow,0.46,0.4545,1.0,0.1642,0,1,1,390,1,1
8054,2011-12-07,Winter,2011,Dec,5,0,Wednesday,1,Light_rainsnow,0.46,0.4545,1.0,0.1642,0,3,3,390,3,3
8055,2011-12-07,Winter,2011,Dec,6,0,Wednesday,1,Light_rainsnow,0.48,0.4697,1.0,0.4179,0,18,18,390,18,18
8056,2011-12-07,Winter,2011,Dec,7,0,Wednesday,1,Light_rainsnow,0.44,0.4394,1.0,0.1045,3,43,46,390,46,46
8057,2011-12-07,Winter,2011,Dec,8,0,Wednesday,1,Light_rainsnow,0.44,0.4394,1.0,0.0,6,80,86,390,86,86
8058,2011-12-07,Winter,2011,Dec,9,0,Wednesday,1,Light_rainsnow,0.44,0.4394,1.0,0.2537,0,64,64,390,64,64
8059,2011-12-07,Winter,2011,Dec,10,0,Wednesday,1,Light_rainsnow,0.44,0.4394,1.0,0.0896,1,32,33,390,33,33
8060,2011-12-07,Winter,2011,Dec,11,0,Wednesday,1,Light_rainsnow,0.44,0.4394,1.0,0.0896,3,47,50,390,50,50
8061,2011-12-07,Winter,2011,Dec,12,0,Wednesday,1,Light_rainsnow,0.44,0.4394,1.0,0.1343,4,29,33,390,33,33
8062,2011-12-07,Winter,2011,Dec,13,0,Wednesday,1,Light_rainsnow,0.44,0.4394,1.0,0.194,5,28,33,390,33,33
8063,2011-12-07,Winter,2011,Dec,14,0,Wednesday,1,Light_rainsnow,0.44,0.4394,1.0,0.194,1,24,25,390,25,25
8064,2011-12-07,Winter,2011,Dec,15,0,Wednesday,1,Light_rainsnow,0.42,0.4242,0.94,0.2239,5,25,30,390,30,30
8065,2011-12-07,Winter,2011,Dec,16,0,Wednesday,1,Light_rainsnow,0.42,0.4242,0.94,0.194,3,28,31,390,31,31
8066,2011-12-07,Winter,2011,Dec,17,0,Wednesday,1,Light_rainsnow,0.4,0.4091,1.0,0.3284,4,48,52,390,52,52
8067,2011-12-07,Winter,2011,Dec,18,0,Wednesday,1,Light_rainsnow,0.4,0.4091,0.94,0.2985,3,48,51,390,51,51
8068,2011-12-07,Winter,2011,Dec,19,0,Wednesday,1,Light_rainsnow,0.34,0.2879,0.87,0.6418,2,31,33,390,33,33
8069,2011-12-07,Winter,2011,Dec,20,0,Wednesday,1,Light_rainsnow,0.34,0.2879,0.87,0.6418,1,25,26,390,26,26
8070,2011-12-07,Winter,2011,Dec,21,0,Wednesday,1,Light_rainsnow,0.3,0.2576,0.87,0.5224,0,6,6,390,6,6
8071,2011-12-07,Winter,2011,Dec,22,0,Wednesday,1,Light_rainsnow,0.24,0.197,0.93,0.4478,0,13,13,390,13,13
8072,2011-12-07,Winter,2011,Dec,23,0,Wednesday,1,Clear,0.24,0.2121,0.93,0.3881,0,16,16,390,16,16
8073,2011-12-08,Winter,2011,Dec,0,0,Thursday,1,Misty,0.26,0.2273,0.87,0.2985,0,21,21,389,21,21
8074,2011-12-08,Winter,2011,Dec,1,0,Thursday,1,Clear,0.26,0.2273,0.81,0.3582,1,6,7,389,7,7
8075,2011-12-08,Winter,2011,Dec,2,0,Thursday,1,Clear,0.28,0.2727,0.65,0.2239,0,4,4,389,4,4
8076,2011-12-08,Winter,2011,Dec,3,0,Thursday,1,Clear,0.26,0.2273,0.6,0.2985,0,1,1,389,1,1
8077,2011-12-08,Winter,2011,Dec,4,0,Thursday,1,Misty,0.24,0.197,0.6,0.4627,0,2,2,389,2,2
8078,2011-12-08,Winter,2011,Dec,5,0,Thursday,1,Clear,0.22,0.2121,0.64,0.2239,0,12,12,389,12,12
8079,2011-12-08,Winter,2011,Dec,6,0,Thursday,1,Clear,0.22,0.2121,0.55,0.2836,0,71,71,389,71,71
8080,2011-12-08,Winter,2011,Dec,7,0,Thursday,1,Clear,0.22,0.2121,0.6,0.2239,11,233,244,389,244,244
8081,2011-12-08,Winter,2011,Dec,8,0,Thursday,1,Clear,0.22,0.2121,0.55,0.2836,11,418,429,389,429,429
8082,2011-12-08,Winter,2011,Dec,9,0,Thursday,1,Clear,0.24,0.2121,0.52,0.3881,7,218,225,389,225,225
8083,2011-12-08,Winter,2011,Dec,10,0,Thursday,1,Clear,0.26,0.2273,0.52,0.3284,1,109,110,389,110,110
8084,2011-12-08,Winter,2011,Dec,11,0,Thursday,1,Clear,0.28,0.2727,0.52,0.2537,6,100,106,389,106,106
8085,2011-12-08,Winter,2011,Dec,12,0,Thursday,1,Clear,0.28,0.2576,0.52,0.3284,8,148,156,389,156,156
8086,2011-12-08,Winter,2011,Dec,13,0,Thursday,1,Clear,0.3,0.2727,0.49,0.3582,9,115,124,389,124,124
8087,2011-12-08,Winter,2011,Dec,14,0,Thursday,1,Clear,0.32,0.303,0.45,0.2537,16,121,137,389,137,137
8088,2011-12-08,Winter,2011,Dec,15,0,Thursday,1,Clear,0.32,0.3333,0.45,0.1343,19,98,117,389,117,117
8089,2011-12-08,Winter,2011,Dec,16,0,Thursday,1,Clear,0.32,0.3182,0.45,0.194,7,201,208,389,208,208
8090,2011-12-08,Winter,2011,Dec,17,0,Thursday,1,Clear,0.3,0.3182,0.49,0.1045,10,321,331,389,331,331
8091,2011-12-08,Winter,2011,Dec,18,0,Thursday,1,Clear,0.28,0.2727,0.52,0.2239,12,306,318,389,318,318
8092,2011-12-08,Winter,2011,Dec,19,0,Thursday,1,Clear,0.26,0.2727,0.56,0.1045,12,220,232,389,232,232
8093,2011-12-08,Winter,2011,Dec,20,0,Thursday,1,Clear,0.26,0.2727,0.6,0.1045,5,170,175,389,175,175
8094,2011-12-08,Winter,2011,Dec,21,0,Thursday,1,Clear,0.28,0.303,0.61,0.0896,4,135,139,389,139,139
8095,2011-12-08,Winter,2011,Dec,22,0,Thursday,1,Clear,0.26,0.2727,0.65,0.1343,8,84,92,389,92,92
8096,2011-12-08,Winter,2011,Dec,23,0,Thursday,1,Clear,0.24,0.2576,0.7,0.1045,3,58,61,389,61,61
8097,2011-12-09,Winter,2011,Dec,0,0,Friday,1,Clear,0.24,0.2879,0.65,0.0,8,26,34,388,34,34
8098,2011-12-09,Winter,2011,Dec,1,0,Friday,1,Clear,0.24,0.2879,0.65,0.0,2,12,14,388,14,14
8099,2011-12-09,Winter,2011,Dec,2,0,Friday,1,Clear,0.24,0.2879,0.7,0.0,2,10,12,388,12,12
8100,2011-12-09,Winter,2011,Dec,3,0,Friday,1,Clear,0.22,0.2727,0.8,0.0,1,5,6,388,6,6
8101,2011-12-09,Winter,2011,Dec,4,0,Friday,1,Clear,0.22,0.2727,0.8,0.0,1,1,2,388,2,2
8102,2011-12-09,Winter,2011,Dec,5,0,Friday,1,Clear,0.22,0.2727,0.8,0.0,0,20,20,388,20,20
8103,2011-12-09,Winter,2011,Dec,6,0,Friday,1,Clear,0.22,0.2576,0.8,0.0896,1,62,63,388,63,63
8104,2011-12-09,Winter,2011,Dec,7,0,Friday,1,Clear,0.22,0.2576,0.75,0.0896,4,195,199,388,199,199
8105,2011-12-09,Winter,2011,Dec,8,0,Friday,1,Clear,0.24,0.2879,0.81,0.0,7,378,385,388,385,385
8106,2011-12-09,Winter,2011,Dec,9,0,Friday,1,Clear,0.26,0.2879,0.81,0.0896,8,256,264,388,264,264
8107,2011-12-09,Winter,2011,Dec,10,0,Friday,1,Misty,0.3,0.303,0.7,0.1642,11,115,126,388,126,126
8108,2011-12-09,Winter,2011,Dec,11,0,Friday,1,Clear,0.32,0.303,0.7,0.2537,15,121,136,388,136,136
8109,2011-12-09,Winter,2011,Dec,12,0,Friday,1,Clear,0.36,0.3333,0.57,0.2985,27,146,173,388,173,173
8110,2011-12-09,Winter,2011,Dec,13,0,Friday,1,Clear,0.38,0.3939,0.5,0.194,27,141,168,388,168,168
8111,2011-12-09,Winter,2011,Dec,14,0,Friday,1,Clear,0.38,0.3939,0.46,0.2836,24,163,187,388,187,187
8112,2011-12-09,Winter,2011,Dec,15,0,Friday,1,Clear,0.38,0.3939,0.46,0.2836,29,160,189,388,189,189
8113,2011-12-09,Winter,2011,Dec,16,0,Friday,1,Clear,0.36,0.3485,0.62,0.1343,24,226,250,388,250,250
8114,2011-12-09,Winter,2011,Dec,17,0,Friday,1,Clear,0.34,0.3485,0.66,0.1045,10,352,362,388,362,362
8115,2011-12-09,Winter,2011,Dec,18,0,Friday,1,Clear,0.34,0.3636,0.61,0.0,10,308,318,388,318,318
8116,2011-12-09,Winter,2011,Dec,19,0,Friday,1,Clear,0.34,0.3636,0.61,0.0,10,189,199,388,199,199
8117,2011-12-09,Winter,2011,Dec,20,0,Friday,1,Clear,0.3,0.3333,0.81,0.0,10,140,150,388,150,150
8118,2011-12-09,Winter,2011,Dec,21,0,Friday,1,Clear,0.3,0.3333,0.75,0.0,9,131,140,388,140,140
8119,2011-12-09,Winter,2011,Dec,22,0,Friday,1,Clear,0.28,0.3182,0.87,0.0,15,114,129,388,129,129
8120,2011-12-09,Winter,2011,Dec,23,0,Friday,1,Clear,0.28,0.3182,0.81,0.0,6,88,94,388,94,94
8121,2011-12-10,Winter,2011,Dec,0,0,Saturday,0,Misty,0.26,0.2727,0.81,0.1045,11,66,77,387,77,77
8122,2011-12-10,Winter,2011,Dec,1,0,Saturday,0,Misty,0.26,0.2576,0.7,0.1642,11,55,66,387,66,66
8123,2011-12-10,Winter,2011,Dec,2,0,Saturday,0,Misty,0.28,0.303,0.61,0.0896,12,48,60,387,60,60
8124,2011-12-10,Winter,2011,Dec,3,0,Saturday,0,Misty,0.28,0.303,0.61,0.0896,5,20,25,387,25,25
8125,2011-12-10,Winter,2011,Dec,4,0,Saturday,0,Misty,0.26,0.2727,0.65,0.1045,0,3,3,387,3,3
8126,2011-12-10,Winter,2011,Dec,5,0,Saturday,0,Clear,0.26,0.2576,0.6,0.1642,0,6,6,387,6,6
8127,2011-12-10,Winter,2011,Dec,6,0,Saturday,0,Clear,0.24,0.2576,0.65,0.1045,1,10,11,387,11,11
8128,2011-12-10,Winter,2011,Dec,7,0,Saturday,0,Clear,0.24,0.2273,0.65,0.194,0,11,11,387,11,11
8129,2011-12-10,Winter,2011,Dec,8,0,Saturday,0,Clear,0.26,0.2727,0.65,0.1343,5,68,73,387,73,73
8130,2011-12-10,Winter,2011,Dec,9,0,Saturday,0,Clear,0.28,0.2576,0.61,0.2836,15,134,149,387,149,149
8131,2011-12-10,Winter,2011,Dec,10,0,Saturday,0,Clear,0.32,0.303,0.57,0.2537,31,161,192,387,192,192
8132,2011-12-10,Winter,2011,Dec,11,0,Saturday,0,Clear,0.32,0.2879,0.53,0.4179,44,192,236,387,236,236
8133,2011-12-10,Winter,2011,Dec,12,0,Saturday,0,Clear,0.32,0.2879,0.45,0.4179,48,235,283,387,283,283
8134,2011-12-10,Winter,2011,Dec,13,0,Saturday,0,Clear,0.34,0.303,0.34,0.4179,47,239,286,387,286,286
8135,2011-12-10,Winter,2011,Dec,14,0,Saturday,0,Clear,0.34,0.303,0.31,0.3284,51,242,293,387,293,293
8136,2011-12-10,Winter,2011,Dec,15,0,Saturday,0,Clear,0.34,0.303,0.34,0.3582,60,239,299,387,299,299
8137,2011-12-10,Winter,2011,Dec,16,0,Saturday,0,Clear,0.32,0.2879,0.31,0.3881,58,183,241,387,241,241
8138,2011-12-10,Winter,2011,Dec,17,0,Saturday,0,Clear,0.28,0.2576,0.36,0.3284,34,151,185,387,185,185
8139,2011-12-10,Winter,2011,Dec,18,0,Saturday,0,Clear,0.26,0.2576,0.38,0.2239,28,144,172,387,172,172
8140,2011-12-10,Winter,2011,Dec,19,0,Saturday,0,Clear,0.26,0.2424,0.38,0.2836,15,139,154,387,154,154
8141,2011-12-10,Winter,2011,Dec,20,0,Saturday,0,Clear,0.24,0.2273,0.35,0.2239,10,114,124,387,124,124
8142,2011-12-10,Winter,2011,Dec,21,0,Saturday,0,Clear,0.22,0.2121,0.44,0.2239,4,79,83,387,83,83
8143,2011-12-10,Winter,2011,Dec,22,0,Saturday,0,Clear,0.22,0.2273,0.41,0.1343,7,88,95,387,95,95
8144,2011-12-10,Winter,2011,Dec,23,0,Saturday,0,Clear,0.2,0.2121,0.47,0.1642,5,61,66,387,66,66
8145,2011-12-11,Winter,2011,Dec,0,0,Sunday,0,Clear,0.2,0.197,0.51,0.2239,5,69,74,386,74,74
8146,2011-12-11,Winter,2011,Dec,1,0,Sunday,0,Clear,0.16,0.1515,0.59,0.2239,8,54,62,386,62,62
8147,2011-12-11,Winter,2011,Dec,2,0,Sunday,0,Clear,0.18,0.1667,0.55,0.2537,5,47,52,386,52,52
8148,2011-12-11,Winter,2011,Dec,3,0,Sunday,0,Clear,0.16,0.1818,0.59,0.1343,2,17,19,386,19,19
8149,2011-12-11,Winter,2011,Dec,4,0,Sunday,0,Clear,0.16,0.1667,0.59,0.1642,0,5,5,386,5,5
8150,2011-12-11,Winter,2011,Dec,5,0,Sunday,0,Clear,0.18,0.2121,0.59,0.1045,0,6,6,386,6,6
8151,2011-12-11,Winter,2011,Dec,6,0,Sunday,0,Clear,0.16,0.2273,0.59,0.0,0,10,10,386,10,10
8152,2011-12-11,Winter,2011,Dec,7,0,Sunday,0,Clear,0.18,0.2424,0.55,0.0,1,30,31,386,31,31
8153,2011-12-11,Winter,2011,Dec,8,0,Sunday,0,Clear,0.16,0.2273,0.69,0.0,4,68,72,386,72,72
8154,2011-12-11,Winter,2011,Dec,9,0,Sunday,0,Clear,0.2,0.2576,0.59,0.0,19,88,107,386,107,107
8155,2011-12-11,Winter,2011,Dec,10,0,Sunday,0,Clear,0.24,0.2879,0.44,0.0,30,164,194,386,194,194
8156,2011-12-11,Winter,2011,Dec,11,0,Sunday,0,Clear,0.26,0.303,0.35,0.0,31,166,197,386,197,197
8157,2011-12-11,Winter,2011,Dec,12,0,Sunday,0,Clear,0.26,0.303,0.35,0.0,42,246,288,386,288,288
8158,2011-12-11,Winter,2011,Dec,13,0,Sunday,0,Clear,0.3,0.3333,0.31,0.0,44,224,268,386,268,268
8159,2011-12-11,Winter,2011,Dec,14,0,Sunday,0,Clear,0.3,0.3333,0.28,0.0,44,198,242,386,242,242
8160,2011-12-11,Winter,2011,Dec,15,0,Sunday,0,Clear,0.3,0.3333,0.26,0.0,47,219,266,386,266,266
8161,2011-12-11,Winter,2011,Dec,16,0,Sunday,0,Clear,0.3,0.3333,0.26,0.0,32,174,206,386,206,206
8162,2011-12-11,Winter,2011,Dec,17,0,Sunday,0,Clear,0.28,0.3182,0.3,0.0,13,150,163,386,163,163
8163,2011-12-11,Winter,2011,Dec,18,0,Sunday,0,Clear,0.24,0.2273,0.48,0.194,12,151,163,386,163,163
8164,2011-12-11,Winter,2011,Dec,19,0,Sunday,0,Clear,0.22,0.2273,0.55,0.194,7,98,105,386,105,105
8165,2011-12-11,Winter,2011,Dec,20,0,Sunday,0,Clear,0.22,0.2424,0.55,0.1045,10,62,72,386,72,72
8166,2011-12-11,Winter,2011,Dec,21,0,Sunday,0,Clear,0.22,0.2727,0.55,0.0,10,53,63,386,63,63
8167,2011-12-11,Winter,2011,Dec,22,0,Sunday,0,Clear,0.22,0.2727,0.55,0.0,7,36,43,386,43,43
8168,2011-12-11,Winter,2011,Dec,23,0,Sunday,0,Clear,0.2,0.2576,0.69,0.0,4,31,35,386,35,35
8169,2011-12-12,Winter,2011,Dec,0,0,Monday,1,Clear,0.2,0.2273,0.69,0.0896,4,16,20,385,20,20
8170,2011-12-12,Winter,2011,Dec,1,0,Monday,1,Clear,0.2,0.2576,0.69,0.0,0,9,9,385,9,9
8171,2011-12-12,Winter,2011,Dec,2,0,Monday,1,Clear,0.2,0.2576,0.69,0.0,0,4,4,385,4,4
8172,2011-12-12,Winter,2011,Dec,3,0,Monday,1,Clear,0.18,0.2424,0.74,0.0,0,2,2,385,2,2
8173,2011-12-12,Winter,2011,Dec,4,0,Monday,1,Clear,0.18,0.2424,0.74,0.0,0,3,3,385,3,3
8174,2011-12-12,Winter,2011,Dec,5,0,Monday,1,Clear,0.16,0.2273,0.8,0.0,0,21,21,385,21,21
8175,2011-12-12,Winter,2011,Dec,6,0,Monday,1,Clear,0.16,0.1818,0.8,0.1045,1,63,64,385,64,64
8176,2011-12-12,Winter,2011,Dec,7,0,Monday,1,Clear,0.14,0.1515,0.86,0.1343,4,231,235,385,235,235
8177,2011-12-12,Winter,2011,Dec,8,0,Monday,1,Misty,0.16,0.1818,0.8,0.1045,7,378,385,385,385,385
8178,2011-12-12,Winter,2011,Dec,9,0,Monday,1,Misty,0.18,0.2121,0.74,0.0896,12,208,220,385,220,220
8179,2011-12-12,Winter,2011,Dec,10,0,Monday,1,Misty,0.22,0.2424,0.69,0.1045,14,91,105,385,105,105
8180,2011-12-12,Winter,2011,Dec,11,0,Monday,1,Misty,0.26,0.2879,0.6,0.0896,15,100,115,385,115,115
8181,2011-12-12,Winter,2011,Dec,12,0,Monday,1,Clear,0.28,0.2879,0.52,0.1045,7,138,145,385,145,145
8182,2011-12-12,Winter,2011,Dec,13,0,Monday,1,Misty,0.3,0.3182,0.52,0.1045,13,153,166,385,166,166
8183,2011-12-12,Winter,2011,Dec,14,0,Monday,1,Misty,0.32,0.3333,0.53,0.1343,16,95,111,385,111,111
8184,2011-12-12,Winter,2011,Dec,15,0,Monday,1,Misty,0.32,0.3333,0.57,0.1045,8,124,132,385,132,132
8185,2011-12-12,Winter,2011,Dec,16,0,Monday,1,Misty,0.32,0.3333,0.57,0.0896,5,209,214,385,214,214
8186,2011-12-12,Winter,2011,Dec,17,0,Monday,1,Misty,0.3,0.3333,0.56,0.0,7,352,359,385,359,359
8187,2011-12-12,Winter,2011,Dec,18,0,Monday,1,Clear,0.3,0.3182,0.56,0.0896,8,349,357,385,357,357
8188,2011-12-12,Winter,2011,Dec,19,0,Monday,1,Clear,0.28,0.303,0.61,0.0896,9,232,241,385,241,241
8189,2011-12-12,Winter,2011,Dec,20,0,Monday,1,Clear,0.3,0.3182,0.56,0.0896,8,157,165,385,165,165
8190,2011-12-12,Winter,2011,Dec,21,0,Monday,1,Clear,0.26,0.303,0.81,0.0,2,119,121,385,121,121
8191,2011-12-12,Winter,2011,Dec,22,0,Monday,1,Clear,0.26,0.303,0.7,0.0,0,71,71,385,71,71
8192,2011-12-12,Winter,2011,Dec,23,0,Monday,1,Clear,0.24,0.2879,0.75,0.0,3,42,45,385,45,45
8193,2011-12-13,Winter,2011,Dec,0,0,Tuesday,1,Clear,0.22,0.2727,0.8,0.0,1,16,17,384,17,17
8194,2011-12-13,Winter,2011,Dec,1,0,Tuesday,1,Clear,0.2,0.2576,0.8,0.0,0,4,4,384,4,4
8195,2011-12-13,Winter,2011,Dec,2,0,Tuesday,1,Clear,0.2,0.2576,0.8,0.0,1,1,2,384,2,2
8196,2011-12-13,Winter,2011,Dec,3,0,Tuesday,1,Clear,0.18,0.2424,0.8,0.0,0,3,3,384,3,3
8197,2011-12-13,Winter,2011,Dec,4,0,Tuesday,1,Clear,0.2,0.2576,0.8,0.0,0,4,4,384,4,4
8198,2011-12-13,Winter,2011,Dec,5,0,Tuesday,1,Clear,0.18,0.2424,0.86,0.0,0,20,20,384,20,20
8199,2011-12-13,Winter,2011,Dec,6,0,Tuesday,1,Clear,0.2,0.2576,0.8,0.0,0,92,92,384,92,92
8200,2011-12-13,Winter,2011,Dec,7,0,Tuesday,1,Clear,0.16,0.1667,0.8,0.1642,2,221,223,384,223,223
8201,2011-12-13,Winter,2011,Dec,8,0,Tuesday,1,Clear,0.2,0.2273,0.69,0.1045,9,391,400,384,400,400
8202,2011-12-13,Winter,2011,Dec,9,0,Tuesday,1,Clear,0.26,0.2576,0.6,0.1642,10,223,233,384,233,233
8203,2011-12-13,Winter,2011,Dec,10,0,Tuesday,1,Clear,0.3,0.303,0.52,0.1642,3,99,102,384,102,102
8204,2011-12-13,Winter,2011,Dec,11,0,Tuesday,1,Clear,0.34,0.3182,0.46,0.2537,9,115,124,384,124,124
8205,2011-12-13,Winter,2011,Dec,12,0,Tuesday,1,Clear,0.36,0.3333,0.43,0.3582,20,147,167,384,167,167
8206,2011-12-13,Winter,2011,Dec,13,0,Tuesday,1,Clear,0.4,0.4091,0.37,0.3284,7,120,127,384,127,127
8207,2011-12-13,Winter,2011,Dec,14,0,Tuesday,1,Clear,0.4,0.4091,0.37,0.2537,18,116,134,384,134,134
8208,2011-12-13,Winter,2011,Dec,15,0,Tuesday,1,Clear,0.4,0.4091,0.35,0.2537,7,144,151,384,151,151
8209,2011-12-13,Winter,2011,Dec,16,0,Tuesday,1,Clear,0.38,0.3939,0.37,0.2537,13,194,207,384,207,207
8210,2011-12-13,Winter,2011,Dec,17,0,Tuesday,1,Clear,0.36,0.3485,0.4,0.194,17,381,398,384,398,398
8211,2011-12-13,Winter,2011,Dec,18,0,Tuesday,1,Clear,0.34,0.3182,0.42,0.2239,12,370,382,384,382,382
8212,2011-12-13,Winter,2011,Dec,19,0,Tuesday,1,Clear,0.32,0.3182,0.49,0.1642,5,262,267,384,267,267
8213,2011-12-13,Winter,2011,Dec,20,0,Tuesday,1,Clear,0.32,0.3182,0.49,0.1642,7,154,161,384,161,161
8214,2011-12-13,Winter,2011,Dec,21,0,Tuesday,1,Clear,0.3,0.303,0.52,0.1642,5,134,139,384,139,139
8215,2011-12-13,Winter,2011,Dec,22,0,Tuesday,1,Clear,0.3,0.303,0.52,0.1642,5,102,107,384,107,107
8216,2011-12-13,Winter,2011,Dec,23,0,Tuesday,1,Clear,0.26,0.303,0.7,0.0,4,55,59,384,59,59
8217,2011-12-14,Winter,2011,Dec,0,0,Wednesday,1,Clear,0.26,0.303,0.75,0.0,0,22,22,383,22,22
8218,2011-12-14,Winter,2011,Dec,1,0,Wednesday,1,Clear,0.26,0.303,0.75,0.0,0,8,8,383,8,8
8219,2011-12-14,Winter,2011,Dec,2,0,Wednesday,1,Clear,0.26,0.303,0.75,0.0,0,2,2,383,2,2
8220,2011-12-14,Winter,2011,Dec,3,0,Wednesday,1,Clear,0.28,0.3182,0.65,0.0,0,3,3,383,3,3
8221,2011-12-14,Winter,2011,Dec,4,0,Wednesday,1,Clear,0.26,0.303,0.75,0.0,0,4,4,383,4,4
8222,2011-12-14,Winter,2011,Dec,5,0,Wednesday,1,Misty,0.26,0.303,0.81,0.0,0,26,26,383,26,26
8223,2011-12-14,Winter,2011,Dec,6,0,Wednesday,1,Misty,0.26,0.303,0.87,0.0,0,87,87,383,87,87
8224,2011-12-14,Winter,2011,Dec,7,0,Wednesday,1,Clear,0.28,0.3182,0.75,0.0,4,243,247,383,247,247
8225,2011-12-14,Winter,2011,Dec,8,0,Wednesday,1,Misty,0.26,0.303,0.87,0.0,9,458,467,383,467,467
8226,2011-12-14,Winter,2011,Dec,9,0,Wednesday,1,Misty,0.3,0.3333,0.61,0.0,9,230,239,383,239,239
8227,2011-12-14,Winter,2011,Dec,10,0,Wednesday,1,Misty,0.32,0.3485,0.57,0.0,9,133,142,383,142,142
8228,2011-12-14,Winter,2011,Dec,11,0,Wednesday,1,Misty,0.34,0.3636,0.55,0.0,12,103,115,383,115,115
8229,2011-12-14,Winter,2011,Dec,12,0,Wednesday,1,Misty,0.36,0.3636,0.57,0.0896,6,138,144,383,144,144
8230,2011-12-14,Winter,2011,Dec,13,0,Wednesday,1,Misty,0.36,0.3636,0.57,0.1045,14,119,133,383,133,133
8231,2011-12-14,Winter,2011,Dec,14,0,Wednesday,1,Misty,0.38,0.3939,0.54,0.0896,17,134,151,383,151,151
8232,2011-12-14,Winter,2011,Dec,15,0,Wednesday,1,Misty,0.38,0.3939,0.54,0.1045,24,143,167,383,167,167
8233,2011-12-14,Winter,2011,Dec,16,0,Wednesday,1,Misty,0.38,0.3939,0.54,0.1045,12,233,245,383,245,245
8234,2011-12-14,Winter,2011,Dec,17,0,Wednesday,1,Misty,0.36,0.3636,0.57,0.1045,19,377,396,383,396,396
8235,2011-12-14,Winter,2011,Dec,18,0,Wednesday,1,Misty,0.36,0.3485,0.62,0.1642,11,379,390,383,390,390
8236,2011-12-14,Winter,2011,Dec,19,0,Wednesday,1,Misty,0.36,0.3636,0.62,0.1045,9,259,268,383,268,268
8237,2011-12-14,Winter,2011,Dec,20,0,Wednesday,1,Misty,0.34,0.3485,0.66,0.1045,6,169,175,383,175,175
8238,2011-12-14,Winter,2011,Dec,21,0,Wednesday,1,Misty,0.34,0.3333,0.66,0.1642,9,145,154,383,154,154
8239,2011-12-14,Winter,2011,Dec,22,0,Wednesday,1,Clear,0.34,0.3333,0.66,0.1642,5,99,104,383,104,104
8240,2011-12-14,Winter,2011,Dec,23,0,Wednesday,1,Clear,0.32,0.3182,0.7,0.1642,3,48,51,383,51,51
8241,2011-12-15,Winter,2011,Dec,0,0,Thursday,1,Clear,0.32,0.3182,0.7,0.1642,5,45,50,382,50,50
8242,2011-12-15,Winter,2011,Dec,1,0,Thursday,1,Misty,0.32,0.3182,0.7,0.1642,5,15,20,382,20,20
8243,2011-12-15,Winter,2011,Dec,2,0,Thursday,1,Misty,0.32,0.3333,0.7,0.1343,2,5,7,382,7,7
8244,2011-12-15,Winter,2011,Dec,3,0,Thursday,1,Misty,0.32,0.3333,0.7,0.1343,1,2,3,382,3,3
8245,2011-12-15,Winter,2011,Dec,4,0,Thursday,1,Misty,0.32,0.303,0.7,0.2239,0,6,6,382,6,6
8246,2011-12-15,Winter,2011,Dec,5,0,Thursday,1,Misty,0.32,0.303,0.7,0.2836,0,24,24,382,24,24
8247,2011-12-15,Winter,2011,Dec,6,0,Thursday,1,Clear,0.32,0.3182,0.66,0.194,2,90,92,382,92,92
8248,2011-12-15,Winter,2011,Dec,7,0,Thursday,1,Clear,0.32,0.3182,0.7,0.194,6,252,258,382,258,258
8249,2011-12-15,Winter,2011,Dec,8,0,Thursday,1,Misty,0.34,0.3182,0.66,0.2239,8,449,457,382,457,457
8250,2011-12-15,Winter,2011,Dec,9,0,Thursday,1,Misty,0.36,0.3333,0.62,0.2836,6,274,280,382,280,280
8251,2011-12-15,Winter,2011,Dec,10,0,Thursday,1,Misty,0.4,0.4091,0.58,0.2985,4,105,109,382,109,109
8252,2011-12-15,Winter,2011,Dec,11,0,Thursday,1,Misty,0.4,0.4091,0.62,0.4179,9,126,135,382,135,135
8253,2011-12-15,Winter,2011,Dec,12,0,Thursday,1,Misty,0.46,0.4545,0.59,0.4925,17,140,157,382,157,157
8254,2011-12-15,Winter,2011,Dec,13,0,Thursday,1,Misty,0.5,0.4848,0.55,0.3582,14,150,164,382,164,164
8255,2011-12-15,Winter,2011,Dec,14,0,Thursday,1,Misty,0.52,0.5,0.52,0.3284,8,124,132,382,132,132
8256,2011-12-15,Winter,2011,Dec,15,0,Thursday,1,Light_rainsnow,0.52,0.5,0.55,0.2239,6,76,82,382,82,82
8257,2011-12-15,Winter,2011,Dec,16,0,Thursday,1,Light_rainsnow,0.46,0.4545,0.72,0.1642,7,124,131,382,131,131
8258,2011-12-15,Winter,2011,Dec,17,0,Thursday,1,Misty,0.52,0.5,0.59,0.2836,14,310,324,382,324,324
8259,2011-12-15,Winter,2011,Dec,18,0,Thursday,1,Misty,0.52,0.5,0.59,0.2985,14,363,377,382,377,377
8260,2011-12-15,Winter,2011,Dec,19,0,Thursday,1,Misty,0.52,0.5,0.59,0.2836,13,274,287,382,287,287
8261,2011-12-15,Winter,2011,Dec,20,0,Thursday,1,Clear,0.52,0.5,0.59,0.3284,12,209,221,382,221,221
8262,2011-12-15,Winter,2011,Dec,21,0,Thursday,1,Clear,0.5,0.4848,0.63,0.2985,10,145,155,382,155,155
8263,2011-12-15,Winter,2011,Dec,22,0,Thursday,1,Clear,0.52,0.5,0.63,0.3284,8,116,124,382,124,124
8264,2011-12-15,Winter,2011,Dec,23,0,Thursday,1,Clear,0.52,0.5,0.63,0.3284,10,104,114,382,114,114
8265,2011-12-16,Winter,2011,Dec,0,0,Friday,1,Clear,0.5,0.4848,0.72,0.3284,12,60,72,381,72,72
8266,2011-12-16,Winter,2011,Dec,1,0,Friday,1,Clear,0.5,0.4848,0.72,0.2239,3,28,31,381,31,31
8267,2011-12-16,Winter,2011,Dec,2,0,Friday,1,Clear,0.48,0.4697,0.77,0.1045,0,23,23,381,23,23
8268,2011-12-16,Winter,2011,Dec,3,0,Friday,1,Clear,0.46,0.4545,0.82,0.1343,2,3,5,381,5,5
8269,2011-12-16,Winter,2011,Dec,4,0,Friday,1,Misty,0.5,0.4848,0.59,0.194,1,4,5,381,5,5
8270,2011-12-16,Winter,2011,Dec,5,0,Friday,1,Clear,0.48,0.4697,0.44,0.3881,0,26,26,381,26,26
8271,2011-12-16,Winter,2011,Dec,6,0,Friday,1,Misty,0.44,0.4394,0.33,0.2985,2,80,82,381,82,82
8272,2011-12-16,Winter,2011,Dec,7,0,Friday,1,Misty,0.38,0.3939,0.46,0.2985,5,226,231,381,231,231
8273,2011-12-16,Winter,2011,Dec,8,0,Friday,1,Clear,0.36,0.3333,0.46,0.4179,10,449,459,381,459,459
8274,2011-12-16,Winter,2011,Dec,9,0,Friday,1,Clear,0.36,0.3333,0.46,0.3881,8,235,243,381,243,243
8275,2011-12-16,Winter,2011,Dec,10,0,Friday,1,Clear,0.34,0.303,0.46,0.2985,10,122,132,381,132,132
8276,2011-12-16,Winter,2011,Dec,11,0,Friday,1,Misty,0.34,0.303,0.42,0.2985,9,135,144,381,144,144
8277,2011-12-16,Winter,2011,Dec,12,0,Friday,1,Misty,0.34,0.303,0.42,0.3582,10,163,173,381,173,173
8278,2011-12-16,Winter,2011,Dec,13,0,Friday,1,Misty,0.34,0.303,0.39,0.3582,12,125,137,381,137,137
8279,2011-12-16,Winter,2011,Dec,14,0,Friday,1,Misty,0.34,0.3182,0.42,0.2239,13,115,128,381,128,128
8280,2011-12-16,Winter,2011,Dec,15,0,Friday,1,Misty,0.32,0.303,0.45,0.2985,12,141,153,381,153,153
8281,2011-12-16,Winter,2011,Dec,16,0,Friday,1,Misty,0.32,0.303,0.45,0.2239,12,212,224,381,224,224
8282,2011-12-16,Winter,2011,Dec,17,0,Friday,1,Misty,0.32,0.303,0.45,0.2836,13,352,365,381,365,365
8283,2011-12-16,Winter,2011,Dec,18,0,Friday,1,Misty,0.32,0.303,0.45,0.2537,10,285,295,381,295,295
8284,2011-12-16,Winter,2011,Dec,19,0,Friday,1,Misty,0.32,0.303,0.45,0.2239,11,203,214,381,214,214
8285,2011-12-16,Winter,2011,Dec,20,0,Friday,1,Misty,0.32,0.3182,0.45,0.194,6,146,152,381,152,152
8286,2011-12-16,Winter,2011,Dec,21,0,Friday,1,Misty,0.32,0.3182,0.45,0.1642,7,95,102,381,102,102
8287,2011-12-16,Winter,2011,Dec,22,0,Friday,1,Misty,0.3,0.303,0.49,0.1642,6,100,106,381,106,106
8288,2011-12-16,Winter,2011,Dec,23,0,Friday,1,Misty,0.3,0.303,0.49,0.1343,4,71,75,381,75,75
8289,2011-12-17,Winter,2011,Dec,0,0,Saturday,0,Clear,0.3,0.2879,0.49,0.2836,3,59,62,380,62,62
8290,2011-12-17,Winter,2011,Dec,1,0,Saturday,0,Misty,0.3,0.2879,0.52,0.2537,4,39,43,380,43,43
8291,2011-12-17,Winter,2011,Dec,2,0,Saturday,0,Misty,0.28,0.2727,0.56,0.2239,11,47,58,380,58,58
8292,2011-12-17,Winter,2011,Dec,3,0,Saturday,0,Clear,0.26,0.2576,0.6,0.194,4,22,26,380,26,26
8293,2011-12-17,Winter,2011,Dec,4,0,Saturday,0,Clear,0.24,0.2424,0.65,0.1642,0,9,9,380,9,9
8294,2011-12-17,Winter,2011,Dec,5,0,Saturday,0,Misty,0.26,0.2576,0.6,0.194,2,7,9,380,9,9
8295,2011-12-17,Winter,2011,Dec,6,0,Saturday,0,Misty,0.26,0.2424,0.56,0.2836,0,17,17,380,17,17
8296,2011-12-17,Winter,2011,Dec,7,0,Saturday,0,Misty,0.26,0.2576,0.56,0.2239,0,20,20,380,20,20
8297,2011-12-17,Winter,2011,Dec,8,0,Saturday,0,Misty,0.26,0.2576,0.56,0.2239,4,55,59,380,59,59
8298,2011-12-17,Winter,2011,Dec,9,0,Saturday,0,Misty,0.26,0.2424,0.56,0.2537,5,95,100,380,100,100
8299,2011-12-17,Winter,2011,Dec,10,0,Saturday,0,Misty,0.26,0.2424,0.52,0.2836,10,171,181,380,181,181
8300,2011-12-17,Winter,2011,Dec,11,0,Saturday,0,Misty,0.28,0.2576,0.45,0.3284,21,188,209,380,209,209
8301,2011-12-17,Winter,2011,Dec,12,0,Saturday,0,Misty,0.28,0.2576,0.45,0.2836,28,216,244,380,244,244
8302,2011-12-17,Winter,2011,Dec,13,0,Saturday,0,Misty,0.28,0.2727,0.48,0.2537,32,204,236,380,236,236
8303,2011-12-17,Winter,2011,Dec,14,0,Saturday,0,Clear,0.28,0.2576,0.45,0.3582,30,207,237,380,237,237
8304,2011-12-17,Winter,2011,Dec,15,0,Saturday,0,Clear,0.28,0.2576,0.45,0.2836,33,195,228,380,228,228
8305,2011-12-17,Winter,2011,Dec,16,0,Saturday,0,Clear,0.28,0.2727,0.45,0.2239,30,192,222,380,222,222
8306,2011-12-17,Winter,2011,Dec,17,0,Saturday,0,Clear,0.26,0.2576,0.48,0.2239,12,153,165,380,165,165
8307,2011-12-17,Winter,2011,Dec,18,0,Saturday,0,Clear,0.26,0.2273,0.48,0.3881,7,150,157,380,157,157
8308,2011-12-17,Winter,2011,Dec,19,0,Saturday,0,Light_rainsnow,0.24,0.2121,0.65,0.3284,11,95,106,380,106,106
8309,2011-12-17,Winter,2011,Dec,20,0,Saturday,0,Clear,0.22,0.2121,0.69,0.2537,7,99,106,380,106,106
8310,2011-12-17,Winter,2011,Dec,21,0,Saturday,0,Clear,0.2,0.2121,0.75,0.1642,8,88,96,380,96,96
8311,2011-12-17,Winter,2011,Dec,22,0,Saturday,0,Clear,0.2,0.2121,0.75,0.1642,7,73,80,380,80,80
8312,2011-12-17,Winter,2011,Dec,23,0,Saturday,0,Clear,0.2,0.2273,0.75,0.0,6,63,69,380,69,69
8313,2011-12-18,Winter,2011,Dec,0,0,Sunday,0,Clear,0.2,0.2121,0.75,0.1343,7,64,71,379,71,71
8314,2011-12-18,Winter,2011,Dec,1,0,Sunday,0,Clear,0.2,0.2273,0.69,0.1045,3,43,46,379,46,46
8315,2011-12-18,Winter,2011,Dec,2,0,Sunday,0,Clear,0.22,0.2424,0.55,0.1045,2,39,41,379,41,41
8316,2011-12-18,Winter,2011,Dec,3,0,Sunday,0,Clear,0.22,0.2121,0.55,0.2239,2,16,18,379,18,18
8317,2011-12-18,Winter,2011,Dec,4,0,Sunday,0,Clear,0.22,0.2121,0.55,0.2239,0,1,1,379,1,1
8318,2011-12-18,Winter,2011,Dec,5,0,Sunday,0,Clear,0.2,0.2273,0.59,0.1045,1,4,5,379,5,5
8319,2011-12-18,Winter,2011,Dec,6,0,Sunday,0,Clear,0.2,0.2121,0.59,0.1343,0,3,3,379,3,3
8320,2011-12-18,Winter,2011,Dec,7,0,Sunday,0,Clear,0.2,0.2121,0.59,0.1642,1,11,12,379,12,12
8321,2011-12-18,Winter,2011,Dec,8,0,Sunday,0,Clear,0.2,0.2576,0.69,0.0,1,31,32,379,32,32
8322,2011-12-18,Winter,2011,Dec,9,0,Sunday,0,Clear,0.22,0.2273,0.64,0.1642,6,75,81,379,81,81
8323,2011-12-18,Winter,2011,Dec,10,0,Sunday,0,Clear,0.24,0.2273,0.6,0.2537,7,122,129,379,129,129
8324,2011-12-18,Winter,2011,Dec,11,0,Sunday,0,Misty,0.24,0.2273,0.6,0.2239,20,168,188,379,188,188
8325,2011-12-18,Winter,2011,Dec,12,0,Sunday,0,Clear,0.26,0.2576,0.6,0.2239,26,202,228,379,228,228
8326,2011-12-18,Winter,2011,Dec,13,0,Sunday,0,Clear,0.3,0.2727,0.49,0.2985,18,210,228,379,228,228
8327,2011-12-18,Winter,2011,Dec,14,0,Sunday,0,Clear,0.3,0.2879,0.49,0.2836,19,200,219,379,219,219
8328,2011-12-18,Winter,2011,Dec,15,0,Sunday,0,Clear,0.32,0.303,0.45,0.2836,23,184,207,379,207,207
8329,2011-12-18,Winter,2011,Dec,16,0,Sunday,0,Clear,0.28,0.2727,0.48,0.2537,27,207,234,379,234,234
8330,2011-12-18,Winter,2011,Dec,17,0,Sunday,0,Clear,0.28,0.2727,0.46,0.1642,10,126,136,379,136,136
8331,2011-12-18,Winter,2011,Dec,18,0,Sunday,0,Clear,0.28,0.2727,0.45,0.194,15,123,138,379,138,138
8332,2011-12-18,Winter,2011,Dec,19,0,Sunday,0,Clear,0.26,0.2727,0.52,0.1343,5,130,135,379,135,135
8333,2011-12-18,Winter,2011,Dec,20,0,Sunday,0,Clear,0.24,0.2576,0.6,0.1045,10,94,104,379,104,104
8334,2011-12-18,Winter,2011,Dec,21,0,Sunday,0,Clear,0.22,0.2727,0.64,0.0,9,80,89,379,89,89
8335,2011-12-18,Winter,2011,Dec,22,0,Sunday,0,Clear,0.22,0.2273,0.75,0.194,2,47,49,379,49,49
8336,2011-12-18,Winter,2011,Dec,23,0,Sunday,0,Clear,0.2,0.2273,0.75,0.1045,6,31,37,379,37,37
8337,2011-12-19,Winter,2011,Dec,0,0,Monday,1,Clear,0.2,0.2273,0.75,0.0896,3,14,17,378,17,17
8338,2011-12-19,Winter,2011,Dec,1,0,Monday,1,Clear,0.18,0.2121,0.8,0.0896,3,8,11,378,11,11
8339,2011-12-19,Winter,2011,Dec,2,0,Monday,1,Clear,0.18,0.2121,0.8,0.0896,0,3,3,378,3,3
8340,2011-12-19,Winter,2011,Dec,3,0,Monday,1,Clear,0.16,0.197,0.86,0.0896,0,3,3,378,3,3
8341,2011-12-19,Winter,2011,Dec,4,0,Monday,1,Clear,0.16,0.1818,0.86,0.1343,0,4,4,378,4,4
8342,2011-12-19,Winter,2011,Dec,5,0,Monday,1,Clear,0.14,0.1667,0.93,0.1045,0,21,21,378,21,21
8343,2011-12-19,Winter,2011,Dec,6,0,Monday,1,Clear,0.16,0.1818,0.86,0.1045,0,68,68,378,68,68
8344,2011-12-19,Winter,2011,Dec,7,0,Monday,1,Clear,0.18,0.2121,0.74,0.1045,4,187,191,378,191,191
8345,2011-12-19,Winter,2011,Dec,8,0,Monday,1,Clear,0.2,0.197,0.75,0.194,8,389,397,378,397,397
8346,2011-12-19,Winter,2011,Dec,9,0,Monday,1,Clear,0.22,0.2121,0.69,0.2239,17,166,183,378,183,183
8347,2011-12-19,Winter,2011,Dec,10,0,Monday,1,Clear,0.24,0.2273,0.67,0.194,12,96,108,378,108,108
8348,2011-12-19,Winter,2011,Dec,11,0,Monday,1,Clear,0.26,0.2424,0.65,0.2537,22,105,127,378,127,127
8349,2011-12-19,Winter,2011,Dec,12,0,Monday,1,Clear,0.3,0.2727,0.61,0.3284,13,128,141,378,141,141
8350,2011-12-19,Winter,2011,Dec,13,0,Monday,1,Clear,0.34,0.303,0.49,0.3284,15,127,142,378,142,142
8351,2011-12-19,Winter,2011,Dec,14,0,Monday,1,Clear,0.36,0.3485,0.46,0.2239,30,107,137,378,137,137
8352,2011-12-19,Winter,2011,Dec,15,0,Monday,1,Clear,0.38,0.3939,0.46,0.1642,24,135,159,378,159,159
8353,2011-12-19,Winter,2011,Dec,16,0,Monday,1,Clear,0.4,0.4091,0.4,0.2537,19,189,208,378,208,208
8354,2011-12-19,Winter,2011,Dec,17,0,Monday,1,Clear,0.38,0.3939,0.46,0.194,16,362,378,378,378,378
8355,2011-12-19,Winter,2011,Dec,18,0,Monday,1,Clear,0.36,0.3485,0.5,0.194,11,343,354,378,354,354
8356,2011-12-19,Winter,2011,Dec,19,0,Monday,1,Misty,0.36,0.3485,0.53,0.1642,17,234,251,378,251,251
8357,2011-12-19,Winter,2011,Dec,20,0,Monday,1,Clear,0.4,0.4091,0.4,0.1642,9,197,206,378,206,206
8358,2011-12-19,Winter,2011,Dec,21,0,Monday,1,Misty,0.36,0.3485,0.53,0.1343,15,112,127,378,127,127
8359,2011-12-19,Winter,2011,Dec,22,0,Monday,1,Misty,0.36,0.3485,0.57,0.1642,12,95,107,378,107,107
8360,2011-12-19,Winter,2011,Dec,23,0,Monday,1,Clear,0.36,0.3485,0.53,0.1642,10,50,60,378,60,60
8361,2011-12-20,Winter,2011,Dec,0,0,Tuesday,1,Clear,0.36,0.3636,0.57,0.1045,0,21,21,377,21,21
8362,2011-12-20,Winter,2011,Dec,1,0,Tuesday,1,Clear,0.36,0.3788,0.53,0.0,0,6,6,377,6,6
8363,2011-12-20,Winter,2011,Dec,2,0,Tuesday,1,Misty,0.34,0.3636,0.61,0.0,1,10,11,377,11,11
8364,2011-12-20,Winter,2011,Dec,3,0,Tuesday,1,Misty,0.34,0.3636,0.61,0.0,1,1,2,377,2,2
8365,2011-12-20,Winter,2011,Dec,4,0,Tuesday,1,Misty,0.36,0.3636,0.53,0.1045,0,4,4,377,4,4
8366,2011-12-20,Winter,2011,Dec,5,0,Tuesday,1,Misty,0.36,0.3788,0.57,0.0,0,15,15,377,15,15
8367,2011-12-20,Winter,2011,Dec,6,0,Tuesday,1,Misty,0.36,0.3788,0.57,0.0,1,71,72,377,72,72
8368,2011-12-20,Winter,2011,Dec,7,0,Tuesday,1,Misty,0.36,0.3788,0.62,0.0,7,261,268,377,268,268
8369,2011-12-20,Winter,2011,Dec,8,0,Tuesday,1,Misty,0.42,0.4242,0.54,0.0896,10,422,432,377,432,432
8370,2011-12-20,Winter,2011,Dec,9,0,Tuesday,1,Misty,0.36,0.3788,0.66,0.0,14,245,259,377,259,259
8371,2011-12-20,Winter,2011,Dec,10,0,Tuesday,1,Misty,0.42,0.4242,0.58,0.194,20,109,129,377,129,129
8372,2011-12-20,Winter,2011,Dec,11,0,Tuesday,1,Misty,0.4,0.4091,0.62,0.1642,13,116,129,377,129,129
8373,2011-12-20,Winter,2011,Dec,12,0,Tuesday,1,Misty,0.44,0.4394,0.54,0.1343,16,159,175,377,175,175
8374,2011-12-20,Winter,2011,Dec,13,0,Tuesday,1,Misty,0.44,0.4394,0.54,0.1343,18,163,181,377,181,181
8375,2011-12-20,Winter,2011,Dec,14,0,Tuesday,1,Misty,0.44,0.4394,0.58,0.1045,11,127,138,377,138,138
8376,2011-12-20,Winter,2011,Dec,15,0,Tuesday,1,Misty,0.44,0.4394,0.54,0.0,15,139,154,377,154,154
8377,2011-12-20,Winter,2011,Dec,16,0,Tuesday,1,Clear,0.44,0.4394,0.54,0.0,20,218,238,377,238,238
8378,2011-12-20,Winter,2011,Dec,17,0,Tuesday,1,Clear,0.4,0.4091,0.62,0.1642,14,417,431,377,431,431
8379,2011-12-20,Winter,2011,Dec,18,0,Tuesday,1,Clear,0.38,0.3939,0.66,0.194,26,385,411,377,411,411
8380,2011-12-20,Winter,2011,Dec,19,0,Tuesday,1,Clear,0.38,0.3939,0.66,0.0,6,218,224,377,224,224
8381,2011-12-20,Winter,2011,Dec,20,0,Tuesday,1,Clear,0.36,0.3788,0.66,0.0,3,144,147,377,147,147
8382,2011-12-20,Winter,2011,Dec,21,0,Tuesday,1,Clear,0.36,0.3636,0.66,0.0896,4,139,143,377,143,143
8383,2011-12-20,Winter,2011,Dec,22,0,Tuesday,1,Misty,0.36,0.3788,0.66,0.0,3,104,107,377,107,107
8384,2011-12-20,Winter,2011,Dec,23,0,Tuesday,1,Misty,0.38,0.3939,0.62,0.0,13,40,53,377,53,53
8385,2011-12-21,Spring,2011,Dec,0,0,Wednesday,1,Misty,0.34,0.3333,0.71,0.1343,7,18,25,376,25,25
8386,2011-12-21,Spring,2011,Dec,1,0,Wednesday,1,Misty,0.36,0.3636,0.66,0.1045,1,10,11,376,11,11
8387,2011-12-21,Spring,2011,Dec,2,0,Wednesday,1,Misty,0.36,0.3788,0.71,0.0,0,4,4,376,4,4
8388,2011-12-21,Spring,2011,Dec,3,0,Wednesday,1,Misty,0.36,0.3788,0.71,0.0,0,2,2,376,2,2
8389,2011-12-21,Spring,2011,Dec,4,0,Wednesday,1,Misty,0.36,0.3788,0.71,0.0,0,2,2,376,2,2
8390,2011-12-21,Spring,2011,Dec,5,0,Wednesday,1,Misty,0.38,0.3939,0.82,0.1045,0,28,28,376,28,28
8391,2011-12-21,Spring,2011,Dec,6,0,Wednesday,1,Misty,0.36,0.3788,0.87,0.0,1,75,76,376,76,76
8392,2011-12-21,Spring,2011,Dec,7,0,Wednesday,1,Misty,0.36,0.3636,0.87,0.1045,5,224,229,376,229,229
8393,2011-12-21,Spring,2011,Dec,8,0,Wednesday,1,Light_rainsnow,0.36,0.3788,0.93,0.0,12,393,405,376,405,405
8394,2011-12-21,Spring,2011,Dec,9,0,Wednesday,1,Misty,0.4,0.4091,0.87,0.2239,14,220,234,376,234,234
8395,2011-12-21,Spring,2011,Dec,10,0,Wednesday,1,Misty,0.48,0.4697,0.82,0.4179,6,83,89,376,89,89
8396,2011-12-21,Spring,2011,Dec,11,0,Wednesday,1,Misty,0.48,0.4697,0.82,0.4179,3,53,56,376,56,56
8397,2011-12-21,Spring,2011,Dec,12,0,Wednesday,1,Light_rainsnow,0.46,0.4545,0.88,0.3881,3,58,61,376,61,61
8398,2011-12-21,Spring,2011,Dec,13,0,Wednesday,1,Light_rainsnow,0.44,0.4394,0.94,0.2985,3,55,58,376,58,58
8399,2011-12-21,Spring,2011,Dec,14,0,Wednesday,1,Misty,0.48,0.4697,0.88,0.3582,11,40,51,376,51,51
8400,2011-12-21,Spring,2011,Dec,15,0,Wednesday,1,Misty,0.48,0.4697,0.88,0.3881,4,57,61,376,61,61
8401,2011-12-21,Spring,2011,Dec,16,0,Wednesday,1,Light_rainsnow,0.44,0.4394,1.0,0.3284,6,95,101,376,101,101
8402,2011-12-21,Spring,2011,Dec,17,0,Wednesday,1,Light_rainsnow,0.44,0.4394,1.0,0.3284,3,226,229,376,229,229
8403,2011-12-21,Spring,2011,Dec,18,0,Wednesday,1,Misty,0.44,0.4394,1.0,0.2985,2,278,280,376,280,280
8404,2011-12-21,Spring,2011,Dec,19,0,Wednesday,1,Misty,0.5,0.4848,0.94,0.3284,9,200,209,376,209,209
8405,2011-12-21,Spring,2011,Dec,20,0,Wednesday,1,Misty,0.5,0.4848,0.94,0.3582,5,162,167,376,167,167
8406,2011-12-21,Spring,2011,Dec,21,0,Wednesday,1,Clear,0.5,0.4848,0.88,0.2836,9,114,123,376,123,123
8407,2011-12-21,Spring,2011,Dec,22,0,Wednesday,1,Clear,0.5,0.4848,0.88,0.2537,3,102,105,376,105,105
8408,2011-12-21,Spring,2011,Dec,23,0,Wednesday,1,Clear,0.5,0.4848,0.88,0.194,0,54,54,376,54,54
8409,2011-12-22,Spring,2011,Dec,0,0,Thursday,1,Misty,0.5,0.4848,0.82,0.1045,3,24,27,375,27,27
8410,2011-12-22,Spring,2011,Dec,1,0,Thursday,1,Clear,0.44,0.4394,0.94,0.0896,0,15,15,375,15,15
8411,2011-12-22,Spring,2011,Dec,2,0,Thursday,1,Clear,0.48,0.4697,0.82,0.1045,1,10,11,375,11,11
8412,2011-12-22,Spring,2011,Dec,3,0,Thursday,1,Clear,0.44,0.4394,0.67,0.1642,0,6,6,375,6,6
8413,2011-12-22,Spring,2011,Dec,4,0,Thursday,1,Clear,0.38,0.3939,0.82,0.1343,0,3,3,375,3,3
8414,2011-12-22,Spring,2011,Dec,5,0,Thursday,1,Clear,0.38,0.3939,0.82,0.0,1,15,16,375,16,16
8415,2011-12-22,Spring,2011,Dec,6,0,Thursday,1,Clear,0.36,0.3788,0.87,0.0,1,63,64,375,64,64
8416,2011-12-22,Spring,2011,Dec,7,0,Thursday,1,Clear,0.34,0.3636,0.93,0.0,4,182,186,375,186,186
8417,2011-12-22,Spring,2011,Dec,8,0,Thursday,1,Misty,0.36,0.3788,0.87,0.0,10,333,343,375,343,343
8418,2011-12-22,Spring,2011,Dec,9,0,Thursday,1,Misty,0.38,0.3939,0.87,0.0896,10,218,228,375,228,228
8419,2011-12-22,Spring,2011,Dec,10,0,Thursday,1,Misty,0.4,0.4091,0.82,0.0896,13,128,141,375,141,141
8420,2011-12-22,Spring,2011,Dec,11,0,Thursday,1,Misty,0.44,0.4394,0.77,0.0,10,135,145,375,145,145
8421,2011-12-22,Spring,2011,Dec,12,0,Thursday,1,Misty,0.48,0.4697,0.55,0.0,22,180,202,375,202,202
8422,2011-12-22,Spring,2011,Dec,13,0,Thursday,1,Misty,0.46,0.4545,0.63,0.0,21,167,188,375,188,188
8423,2011-12-22,Spring,2011,Dec,14,0,Thursday,1,Misty,0.46,0.4545,0.63,0.0,23,136,159,375,159,159
8424,2011-12-22,Spring,2011,Dec,15,0,Thursday,1,Misty,0.48,0.4697,0.59,0.0,28,186,214,375,214,214
8425,2011-12-22,Spring,2011,Dec,16,0,Thursday,1,Misty,0.46,0.4545,0.63,0.0,30,226,256,375,256,256
8426,2011-12-22,Spring,2011,Dec,17,0,Thursday,1,Misty,0.44,0.4394,0.67,0.1642,24,332,356,375,356,356
8427,2011-12-22,Spring,2011,Dec,18,0,Thursday,1,Misty,0.44,0.4394,0.62,0.0896,11,277,288,375,288,288
8428,2011-12-22,Spring,2011,Dec,19,0,Thursday,1,Misty,0.44,0.4394,0.62,0.0,12,130,142,375,142,142
8429,2011-12-22,Spring,2011,Dec,20,0,Thursday,1,Light_rainsnow,0.42,0.4242,0.71,0.0,0,33,33,375,33,33
8430,2011-12-22,Spring,2011,Dec,21,0,Thursday,1,Light_rainsnow,0.42,0.4242,0.71,0.0,2,15,17,375,17,17
8431,2011-12-22,Spring,2011,Dec,22,0,Thursday,1,Light_rainsnow,0.36,0.3636,0.93,0.1045,0,17,17,375,17,17
8432,2011-12-22,Spring,2011,Dec,23,0,Thursday,1,Light_rainsnow,0.4,0.4091,0.87,0.0,1,10,11,375,11,11
8433,2011-12-23,Spring,2011,Dec,0,0,Friday,1,Light_rainsnow,0.4,0.4091,0.87,0.194,2,7,9,374,9,9
8434,2011-12-23,Spring,2011,Dec,1,0,Friday,1,Light_rainsnow,0.4,0.4091,0.87,0.194,1,11,12,374,12,12
8435,2011-12-23,Spring,2011,Dec,2,0,Friday,1,Light_rainsnow,0.38,0.3939,0.94,0.1343,1,12,13,374,13,13
8436,2011-12-23,Spring,2011,Dec,3,0,Friday,1,Light_rainsnow,0.38,0.3939,0.94,0.1343,0,4,4,374,4,4
8437,2011-12-23,Spring,2011,Dec,4,0,Friday,1,Light_rainsnow,0.38,0.3939,0.94,0.2836,0,2,2,374,2,2
8438,2011-12-23,Spring,2011,Dec,5,0,Friday,1,Clear,0.36,0.3485,0.93,0.194,0,8,8,374,8,8
8439,2011-12-23,Spring,2011,Dec,6,0,Friday,1,Clear,0.38,0.3939,0.82,0.2537,0,40,40,374,40,40
8440,2011-12-23,Spring,2011,Dec,7,0,Friday,1,Clear,0.38,0.3939,0.82,0.2239,4,88,92,374,92,92
8441,2011-12-23,Spring,2011,Dec,8,0,Friday,1,Clear,0.4,0.4091,0.76,0.2537,9,173,182,374,182,182
8442,2011-12-23,Spring,2011,Dec,9,0,Friday,1,Clear,0.4,0.4091,0.66,0.2985,4,152,156,374,156,156
8443,2011-12-23,Spring,2011,Dec,10,0,Friday,1,Clear,0.4,0.4091,0.62,0.3582,8,96,104,374,104,104
8444,2011-12-23,Spring,2011,Dec,11,0,Friday,1,Clear,0.4,0.4091,0.58,0.4478,26,148,174,374,174,174
8445,2011-12-23,Spring,2011,Dec,12,0,Friday,1,Clear,0.4,0.4091,0.54,0.5224,14,156,170,374,170,170
8446,2011-12-23,Spring,2011,Dec,13,0,Friday,1,Clear,0.4,0.4091,0.5,0.4627,17,177,194,374,194,194
8447,2011-12-23,Spring,2011,Dec,14,0,Friday,1,Clear,0.4,0.4091,0.54,0.4179,23,177,200,374,200,200
8448,2011-12-23,Spring,2011,Dec,15,0,Friday,1,Clear,0.38,0.3939,0.54,0.3582,12,191,203,374,203,203
8449,2011-12-23,Spring,2011,Dec,16,0,Friday,1,Clear,0.38,0.3939,0.5,0.2985,15,166,181,374,181,181
8450,2011-12-23,Spring,2011,Dec,17,0,Friday,1,Clear,0.36,0.3485,0.53,0.2239,11,129,140,374,140,140
8451,2011-12-23,Spring,2011,Dec,18,0,Friday,1,Clear,0.36,0.3333,0.5,0.2537,4,91,95,374,95,95
8452,2011-12-23,Spring,2011,Dec,19,0,Friday,1,Clear,0.34,0.3333,0.53,0.194,1,75,76,374,76,76
8453,2011-12-23,Spring,2011,Dec,20,0,Friday,1,Clear,0.32,0.303,0.61,0.3284,3,47,50,374,50,50
8454,2011-12-23,Spring,2011,Dec,21,0,Friday,1,Clear,0.32,0.303,0.61,0.2239,0,32,32,374,32,32
8455,2011-12-23,Spring,2011,Dec,22,0,Friday,1,Clear,0.32,0.3182,0.66,0.194,4,43,47,374,47,47
8456,2011-12-23,Spring,2011,Dec,23,0,Friday,1,Clear,0.32,0.3333,0.66,0.1343,4,21,25,374,25,25
8457,2011-12-24,Spring,2011,Dec,0,0,Saturday,0,Misty,0.32,0.3182,0.7,0.1642,3,20,23,373,23,23
8458,2011-12-24,Spring,2011,Dec,1,0,Saturday,0,Misty,0.32,0.3485,0.66,0.0,1,15,16,373,16,16
8459,2011-12-24,Spring,2011,Dec,2,0,Saturday,0,Misty,0.32,0.3333,0.66,0.0896,4,22,26,373,26,26
8460,2011-12-24,Spring,2011,Dec,3,0,Saturday,0,Misty,0.32,0.3333,0.7,0.0896,0,5,5,373,5,5
8461,2011-12-24,Spring,2011,Dec,4,0,Saturday,0,Misty,0.32,0.3182,0.66,0.1642,0,3,3,373,3,3
8462,2011-12-24,Spring,2011,Dec,5,0,Saturday,0,Misty,0.32,0.3182,0.66,0.1642,1,3,4,373,4,4
8463,2011-12-24,Spring,2011,Dec,6,0,Saturday,0,Misty,0.3,0.303,0.75,0.1642,0,10,10,373,10,10
8464,2011-12-24,Spring,2011,Dec,7,0,Saturday,0,Clear,0.3,0.2727,0.7,0.3582,0,10,10,373,10,10
8465,2011-12-24,Spring,2011,Dec,8,0,Saturday,0,Clear,0.28,0.2727,0.7,0.194,0,27,27,373,27,27
8466,2011-12-24,Spring,2011,Dec,9,0,Saturday,0,Clear,0.3,0.2727,0.45,0.4179,3,53,56,373,56,56
8467,2011-12-24,Spring,2011,Dec,10,0,Saturday,0,Clear,0.3,0.2576,0.42,0.4925,4,52,56,373,56,56
8468,2011-12-24,Spring,2011,Dec,11,0,Saturday,0,Clear,0.32,0.2879,0.39,0.3582,9,62,71,373,71,71
8469,2011-12-24,Spring,2011,Dec,12,0,Saturday,0,Clear,0.34,0.3182,0.39,0.2836,15,79,94,373,94,94
8470,2011-12-24,Spring,2011,Dec,13,0,Saturday,0,Clear,0.34,0.303,0.39,0.2985,24,97,121,373,121,121
8471,2011-12-24,Spring,2011,Dec,14,0,Saturday,0,Clear,0.34,0.303,0.39,0.2985,15,70,85,373,85,85
8472,2011-12-24,Spring,2011,Dec,15,0,Saturday,0,Clear,0.32,0.303,0.39,0.2239,15,82,97,373,97,97
8473,2011-12-24,Spring,2011,Dec,16,0,Saturday,0,Clear,0.32,0.3182,0.42,0.194,25,74,99,373,99,99
8474,2011-12-24,Spring,2011,Dec,17,0,Saturday,0,Clear,0.28,0.2879,0.45,0.1343,15,53,68,373,68,68
8475,2011-12-24,Spring,2011,Dec,18,0,Saturday,0,Clear,0.3,0.3182,0.42,0.0896,2,33,35,373,35,35
8476,2011-12-24,Spring,2011,Dec,19,0,Saturday,0,Clear,0.3,0.3182,0.52,0.0896,1,24,25,373,25,25
8477,2011-12-24,Spring,2011,Dec,20,0,Saturday,0,Clear,0.26,0.2727,0.56,0.1343,5,19,24,373,24,24
8478,2011-12-24,Spring,2011,Dec,21,0,Saturday,0,Clear,0.26,0.2576,0.56,0.1642,4,15,19,373,19,19
8479,2011-12-24,Spring,2011,Dec,22,0,Saturday,0,Clear,0.24,0.2879,0.52,0.0,8,12,20,373,20,20
8480,2011-12-24,Spring,2011,Dec,23,0,Saturday,0,Clear,0.24,0.2576,0.56,0.0,1,16,17,373,17,17
8481,2011-12-25,Spring,2011,Dec,0,0,Sunday,0,Clear,0.24,0.2273,0.6,0.194,2,4,6,372,6,6
8482,2011-12-25,Spring,2011,Dec,1,0,Sunday,0,Clear,0.22,0.2273,0.69,0.1343,2,2,4,372,4,4
8483,2011-12-25,Spring,2011,Dec,2,0,Sunday,0,Clear,0.22,0.2576,0.75,0.0896,0,2,2,372,2,2
8484,2011-12-25,Spring,2011,Dec,3,0,Sunday,0,Clear,0.22,0.2727,0.72,0.0,1,3,4,372,4,4
8485,2011-12-25,Spring,2011,Dec,5,0,Sunday,0,Clear,0.2,0.2273,0.75,0.1045,0,1,1,372,1,1
8486,2011-12-25,Spring,2011,Dec,6,0,Sunday,0,Clear,0.2,0.2273,0.75,0.1045,0,1,1,372,1,1
8487,2011-12-25,Spring,2011,Dec,7,0,Sunday,0,Clear,0.22,0.2424,0.8,0.1045,0,4,4,372,4,4
8488,2011-12-25,Spring,2011,Dec,8,0,Sunday,0,Clear,0.2,0.2121,0.8,0.1642,1,4,5,372,5,5
8489,2011-12-25,Spring,2011,Dec,9,0,Sunday,0,Clear,0.24,0.2424,0.87,0.1642,3,20,23,372,23,23
8490,2011-12-25,Spring,2011,Dec,10,0,Sunday,0,Clear,0.26,0.2424,0.81,0.2537,31,12,43,372,43,43
8491,2011-12-25,Spring,2011,Dec,11,0,Sunday,0,Clear,0.3,0.303,0.7,0.1642,43,42,85,372,85,85
8492,2011-12-25,Spring,2011,Dec,12,0,Sunday,0,Clear,0.3,0.2727,0.75,0.2985,25,41,66,372,66,66
8493,2011-12-25,Spring,2011,Dec,13,0,Sunday,0,Clear,0.32,0.303,0.7,0.2537,40,39,79,372,79,79
8494,2011-12-25,Spring,2011,Dec,14,0,Sunday,0,Clear,0.34,0.3182,0.61,0.2537,41,45,86,372,86,86
8495,2011-12-25,Spring,2011,Dec,15,0,Sunday,0,Clear,0.34,0.3333,0.61,0.194,43,48,91,372,91,91
8496,2011-12-25,Spring,2011,Dec,16,0,Sunday,0,Clear,0.36,0.3636,0.57,0.1045,35,51,86,372,86,86
8497,2011-12-25,Spring,2011,Dec,17,0,Sunday,0,Clear,0.34,0.3333,0.61,0.1343,11,33,44,372,44,44
8498,2011-12-25,Spring,2011,Dec,18,0,Sunday,0,Clear,0.32,0.3182,0.7,0.194,7,23,30,372,30,30
8499,2011-12-25,Spring,2011,Dec,19,0,Sunday,0,Clear,0.32,0.3333,0.57,0.1343,2,14,16,372,16,16
8500,2011-12-25,Spring,2011,Dec,20,0,Sunday,0,Clear,0.32,0.3333,0.49,0.0896,8,18,26,372,26,26
8501,2011-12-25,Spring,2011,Dec,21,0,Sunday,0,Clear,0.3,0.303,0.56,0.1343,4,15,19,372,19,19
8502,2011-12-25,Spring,2011,Dec,22,0,Sunday,0,Clear,0.28,0.2727,0.61,0.1642,2,15,17,372,17,17
8503,2011-12-25,Spring,2011,Dec,23,0,Sunday,0,Clear,0.26,0.2727,0.65,0.1343,2,14,16,372,16,16
8504,2011-12-26,Spring,2011,Dec,0,1,Monday,0,Clear,0.22,0.2273,0.75,0.1642,5,6,11,371,11,11
8505,2011-12-26,Spring,2011,Dec,1,1,Monday,0,Clear,0.28,0.2727,0.56,0.194,3,7,10,371,10,10
8506,2011-12-26,Spring,2011,Dec,2,1,Monday,0,Clear,0.34,0.3182,0.46,0.2239,2,5,7,371,7,7
8507,2011-12-26,Spring,2011,Dec,4,1,Monday,0,Clear,0.34,0.303,0.46,0.2985,0,2,2,371,2,2
8508,2011-12-26,Spring,2011,Dec,5,1,Monday,0,Clear,0.34,0.303,0.42,0.3881,0,4,4,371,4,4
8509,2011-12-26,Spring,2011,Dec,6,1,Monday,0,Clear,0.32,0.303,0.45,0.2836,0,4,4,371,4,4
8510,2011-12-26,Spring,2011,Dec,7,1,Monday,0,Clear,0.32,0.3182,0.45,0.194,2,17,19,371,19,19
8511,2011-12-26,Spring,2011,Dec,8,1,Monday,0,Clear,0.32,0.3333,0.45,0.1343,5,13,18,371,18,18
8512,2011-12-26,Spring,2011,Dec,9,1,Monday,0,Clear,0.34,0.303,0.46,0.2985,24,38,62,371,62,62
8513,2011-12-26,Spring,2011,Dec,10,1,Monday,0,Clear,0.34,0.2879,0.42,0.5224,31,39,70,371,70,70
8514,2011-12-26,Spring,2011,Dec,11,1,Monday,0,Clear,0.34,0.2879,0.46,0.5821,40,51,91,371,91,91
8515,2011-12-26,Spring,2011,Dec,12,1,Monday,0,Clear,0.36,0.3182,0.43,0.4627,34,66,100,371,100,100
8516,2011-12-26,Spring,2011,Dec,13,1,Monday,0,Clear,0.38,0.3939,0.4,0.2985,57,83,140,371,140,140
8517,2011-12-26,Spring,2011,Dec,14,1,Monday,0,Clear,0.38,0.3939,0.4,0.3284,73,80,153,371,153,153
8518,2011-12-26,Spring,2011,Dec,15,1,Monday,0,Clear,0.38,0.3939,0.4,0.2537,26,105,131,371,131,131
8519,2011-12-26,Spring,2011,Dec,16,1,Monday,0,Clear,0.36,0.3333,0.43,0.2836,28,69,97,371,97,97
8520,2011-12-26,Spring,2011,Dec,17,1,Monday,0,Clear,0.34,0.3182,0.46,0.2239,30,67,97,371,97,97
8521,2011-12-26,Spring,2011,Dec,18,1,Monday,0,Clear,0.32,0.3333,0.49,0.0896,21,54,75,371,75,75
8522,2011-12-26,Spring,2011,Dec,19,1,Monday,0,Clear,0.3,0.3182,0.65,0.0896,16,49,65,371,65,65
8523,2011-12-26,Spring,2011,Dec,20,1,Monday,0,Clear,0.3,0.3182,0.56,0.0896,14,42,56,371,56,56
8524,2011-12-26,Spring,2011,Dec,21,1,Monday,0,Clear,0.26,0.303,0.7,0.0,10,39,49,371,49,49
8525,2011-12-26,Spring,2011,Dec,22,1,Monday,0,Clear,0.26,0.303,0.7,0.0,5,22,27,371,27,27
8526,2011-12-26,Spring,2011,Dec,23,1,Monday,0,Clear,0.26,0.2727,0.7,0.1045,4,25,29,371,29,29
8527,2011-12-27,Spring,2011,Dec,0,0,Tuesday,1,Clear,0.26,0.2576,0.7,0.1642,3,9,12,370,12,12
8528,2011-12-27,Spring,2011,Dec,1,0,Tuesday,1,Clear,0.26,0.2727,0.7,0.1343,0,6,6,370,6,6
8529,2011-12-27,Spring,2011,Dec,2,0,Tuesday,1,Clear,0.26,0.2727,0.7,0.1343,2,2,4,370,4,4
8530,2011-12-27,Spring,2011,Dec,3,0,Tuesday,1,Misty,0.3,0.2879,0.61,0.2239,0,3,3,370,3,3
8531,2011-12-27,Spring,2011,Dec,4,0,Tuesday,1,Misty,0.3,0.2879,0.65,0.2239,0,3,3,370,3,3
8532,2011-12-27,Spring,2011,Dec,5,0,Tuesday,1,Misty,0.3,0.2727,0.64,0.2836,0,8,8,370,8,8
8533,2011-12-27,Spring,2011,Dec,6,0,Tuesday,1,Misty,0.3,0.2727,0.61,0.2985,0,35,35,370,35,35
8534,2011-12-27,Spring,2011,Dec,7,0,Tuesday,1,Misty,0.3,0.2879,0.65,0.2836,1,79,80,370,80,80
8535,2011-12-27,Spring,2011,Dec,8,0,Tuesday,1,Misty,0.3,0.303,0.65,0.1642,9,155,164,370,164,164
8536,2011-12-27,Spring,2011,Dec,9,0,Tuesday,1,Light_rainsnow,0.32,0.3333,0.66,0.1045,19,85,104,370,104,104
8537,2011-12-27,Spring,2011,Dec,10,0,Tuesday,1,Misty,0.32,0.3333,0.66,0.0896,13,47,60,370,60,60
8538,2011-12-27,Spring,2011,Dec,11,0,Tuesday,1,Light_rainsnow,0.32,0.3333,0.66,0.1045,6,24,30,370,30,30
8539,2011-12-27,Spring,2011,Dec,12,0,Tuesday,1,Light_rainsnow,0.3,0.3182,0.81,0.0896,8,16,24,370,24,24
8540,2011-12-27,Spring,2011,Dec,13,0,Tuesday,1,Light_rainsnow,0.3,0.303,0.87,0.1343,1,19,20,370,20,20
8541,2011-12-27,Spring,2011,Dec,14,0,Tuesday,1,Light_rainsnow,0.42,0.4242,0.82,0.3881,0,14,14,370,14,14
8542,2011-12-27,Spring,2011,Dec,15,0,Tuesday,1,Light_rainsnow,0.42,0.4242,0.82,0.3881,2,17,19,370,19,19
8543,2011-12-27,Spring,2011,Dec,16,0,Tuesday,1,Light_rainsnow,0.44,0.4394,0.88,0.3284,2,44,46,370,46,46
8544,2011-12-27,Spring,2011,Dec,17,0,Tuesday,1,Light_rainsnow,0.4,0.4091,0.87,0.1343,6,109,115,370,115,115
8545,2011-12-27,Spring,2011,Dec,18,0,Tuesday,1,Clear,0.38,0.3939,0.87,0.2836,9,126,135,370,135,135
8546,2011-12-27,Spring,2011,Dec,19,0,Tuesday,1,Clear,0.34,0.3333,0.87,0.1642,3,87,90,370,90,90
8547,2011-12-27,Spring,2011,Dec,20,0,Tuesday,1,Clear,0.32,0.3333,0.93,0.0896,3,66,69,370,69,69
8548,2011-12-27,Spring,2011,Dec,21,0,Tuesday,1,Clear,0.32,0.3333,0.87,0.0896,11,52,63,370,63,63
8549,2011-12-27,Spring,2011,Dec,22,0,Tuesday,1,Clear,0.32,0.3333,0.87,0.0896,3,29,32,370,32,32
8550,2011-12-27,Spring,2011,Dec,23,0,Tuesday,1,Clear,0.3,0.303,0.93,0.1343,2,24,26,370,26,26
8551,2011-12-28,Spring,2011,Dec,0,0,Wednesday,1,Clear,0.32,0.3182,0.87,0.1642,0,10,10,369,10,10
8552,2011-12-28,Spring,2011,Dec,1,0,Wednesday,1,Clear,0.32,0.3182,0.76,0.1642,0,12,12,369,12,12
8553,2011-12-28,Spring,2011,Dec,2,0,Wednesday,1,Clear,0.32,0.303,0.61,0.2537,0,7,7,369,7,7
8554,2011-12-28,Spring,2011,Dec,3,0,Wednesday,1,Clear,0.32,0.303,0.61,0.2537,0,4,4,369,4,4
8555,2011-12-28,Spring,2011,Dec,5,0,Wednesday,1,Clear,0.32,0.2879,0.57,0.3582,0,9,9,369,9,9
8556,2011-12-28,Spring,2011,Dec,6,0,Wednesday,1,Clear,0.32,0.303,0.57,0.2537,1,42,43,369,43,43
8557,2011-12-28,Spring,2011,Dec,7,0,Wednesday,1,Clear,0.32,0.303,0.57,0.2537,4,106,110,369,110,110
8558,2011-12-28,Spring,2011,Dec,8,0,Wednesday,1,Clear,0.32,0.2879,0.57,0.3582,11,206,217,369,217,217
8559,2011-12-28,Spring,2011,Dec,9,0,Wednesday,1,Clear,0.32,0.303,0.57,0.3284,18,171,189,369,189,189
8560,2011-12-28,Spring,2011,Dec,10,0,Wednesday,1,Clear,0.34,0.3182,0.57,0.2239,12,84,96,369,96,96
8561,2011-12-28,Spring,2011,Dec,11,0,Wednesday,1,Clear,0.36,0.3333,0.46,0.3582,18,93,111,369,111,111
8562,2011-12-28,Spring,2011,Dec,12,0,Wednesday,1,Clear,0.34,0.2879,0.46,0.5522,32,108,140,369,140,140
8563,2011-12-28,Spring,2011,Dec,13,0,Wednesday,1,Clear,0.34,0.2879,0.39,0.4627,24,135,159,369,159,159
8564,2011-12-28,Spring,2011,Dec,14,0,Wednesday,1,Clear,0.32,0.2879,0.39,0.3881,24,96,120,369,120,120
8565,2011-12-28,Spring,2011,Dec,15,0,Wednesday,1,Clear,0.32,0.2879,0.36,0.4179,16,101,117,369,117,117
8566,2011-12-28,Spring,2011,Dec,16,0,Wednesday,1,Clear,0.3,0.2727,0.36,0.4179,23,144,167,369,167,167
8567,2011-12-28,Spring,2011,Dec,17,0,Wednesday,1,Clear,0.28,0.2727,0.38,0.2537,25,225,250,369,250,250
8568,2011-12-28,Spring,2011,Dec,18,0,Wednesday,1,Clear,0.26,0.2273,0.38,0.3284,10,159,169,369,169,169
8569,2011-12-28,Spring,2011,Dec,19,0,Wednesday,1,Clear,0.24,0.2273,0.41,0.2537,16,135,151,369,151,151
8570,2011-12-28,Spring,2011,Dec,20,0,Wednesday,1,Clear,0.24,0.2273,0.41,0.2239,9,70,79,369,79,79
8571,2011-12-28,Spring,2011,Dec,21,0,Wednesday,1,Clear,0.22,0.2273,0.44,0.1343,7,63,70,369,70,70
8572,2011-12-28,Spring,2011,Dec,22,0,Wednesday,1,Clear,0.22,0.2424,0.44,0.1045,2,31,33,369,33,33
8573,2011-12-28,Spring,2011,Dec,23,0,Wednesday,1,Clear,0.22,0.2121,0.44,0.2537,3,36,39,369,39,39
8574,2011-12-29,Spring,2011,Dec,0,0,Thursday,1,Misty,0.22,0.2273,0.47,0.194,4,24,28,368,28,28
8575,2011-12-29,Spring,2011,Dec,1,0,Thursday,1,Clear,0.22,0.2121,0.47,0.2239,0,15,15,368,15,15
8576,2011-12-29,Spring,2011,Dec,2,0,Thursday,1,Clear,0.2,0.2273,0.51,0.1045,0,3,3,368,3,3
8577,2011-12-29,Spring,2011,Dec,3,0,Thursday,1,Clear,0.2,0.197,0.55,0.194,0,2,2,368,2,2
8578,2011-12-29,Spring,2011,Dec,4,0,Thursday,1,Clear,0.2,0.2121,0.55,0.1642,1,2,3,368,3,3
8579,2011-12-29,Spring,2011,Dec,5,0,Thursday,1,Clear,0.2,0.2273,0.55,0.1045,0,10,10,368,10,10
8580,2011-12-29,Spring,2011,Dec,6,0,Thursday,1,Clear,0.2,0.2576,0.59,0.0,2,39,41,368,41,41
8581,2011-12-29,Spring,2011,Dec,7,0,Thursday,1,Clear,0.18,0.2121,0.64,0.0896,2,104,106,368,106,106
8582,2011-12-29,Spring,2011,Dec,8,0,Thursday,1,Misty,0.2,0.2576,0.64,0.0,3,207,210,368,210,210
8583,2011-12-29,Spring,2011,Dec,9,0,Thursday,1,Misty,0.2,0.2121,0.64,0.1343,15,155,170,368,170,170
8584,2011-12-29,Spring,2011,Dec,10,0,Thursday,1,Misty,0.22,0.2273,0.64,0.1642,13,97,110,368,110,110
8585,2011-12-29,Spring,2011,Dec,11,0,Thursday,1,Misty,0.24,0.2576,0.6,0.0896,23,99,122,368,122,122
8586,2011-12-29,Spring,2011,Dec,12,0,Thursday,1,Misty,0.26,0.2727,0.56,0.1045,12,118,130,368,130,130
8587,2011-12-29,Spring,2011,Dec,13,0,Thursday,1,Misty,0.28,0.2879,0.52,0.1045,36,95,131,368,131,131
8588,2011-12-29,Spring,2011,Dec,14,0,Thursday,1,Misty,0.3,0.3333,0.52,0.0,30,112,142,368,142,142
8589,2011-12-29,Spring,2011,Dec,15,0,Thursday,1,Misty,0.3,0.3182,0.52,0.0896,27,150,177,368,177,177
8590,2011-12-29,Spring,2011,Dec,16,0,Thursday,1,Clear,0.3,0.303,0.52,0.1642,22,155,177,368,177,177
8591,2011-12-29,Spring,2011,Dec,17,0,Thursday,1,Clear,0.3,0.303,0.61,0.1642,14,226,240,368,240,240
8592,2011-12-29,Spring,2011,Dec,18,0,Thursday,1,Clear,0.3,0.303,0.56,0.1343,15,192,207,368,207,207
8593,2011-12-29,Spring,2011,Dec,19,0,Thursday,1,Clear,0.3,0.3182,0.56,0.1045,11,124,135,368,135,135
8594,2011-12-29,Spring,2011,Dec,20,0,Thursday,1,Clear,0.28,0.2879,0.65,0.1045,8,88,96,368,96,96
8595,2011-12-29,Spring,2011,Dec,21,0,Thursday,1,Misty,0.28,0.2879,0.61,0.1343,8,60,68,368,68,68
8596,2011-12-29,Spring,2011,Dec,22,0,Thursday,1,Clear,0.28,0.2879,0.65,0.1343,7,48,55,368,55,55
8597,2011-12-29,Spring,2011,Dec,23,0,Thursday,1,Clear,0.3,0.303,0.65,0.1642,1,44,45,368,45,45
8598,2011-12-30,Spring,2011,Dec,0,0,Friday,1,Clear,0.28,0.2879,0.7,0.1343,4,26,30,367,30,30
8599,2011-12-30,Spring,2011,Dec,1,0,Friday,1,Clear,0.26,0.2879,0.65,0.0896,9,11,20,367,20,20
8600,2011-12-30,Spring,2011,Dec,2,0,Friday,1,Clear,0.24,0.2576,0.7,0.1045,2,10,12,367,12,12
8601,2011-12-30,Spring,2011,Dec,3,0,Friday,1,Clear,0.24,0.2576,0.7,0.1045,0,6,6,367,6,6
8602,2011-12-30,Spring,2011,Dec,4,0,Friday,1,Clear,0.24,0.2576,0.7,0.0896,0,2,2,367,2,2
8603,2011-12-30,Spring,2011,Dec,5,0,Friday,1,Clear,0.22,0.2576,0.75,0.0896,0,10,10,367,10,10
8604,2011-12-30,Spring,2011,Dec,6,0,Friday,1,Clear,0.24,0.2576,0.7,0.0896,1,31,32,367,32,32
8605,2011-12-30,Spring,2011,Dec,7,0,Friday,1,Clear,0.24,0.2576,0.75,0.0896,3,92,95,367,95,95
8606,2011-12-30,Spring,2011,Dec,8,0,Friday,1,Misty,0.24,0.2576,0.75,0.0896,12,193,205,367,205,205
8607,2011-12-30,Spring,2011,Dec,9,0,Friday,1,Clear,0.26,0.303,0.75,0.0,19,175,194,367,194,194
8608,2011-12-30,Spring,2011,Dec,10,0,Friday,1,Clear,0.3,0.2879,0.65,0.2537,10,108,118,367,118,118
8609,2011-12-30,Spring,2011,Dec,11,0,Friday,1,Clear,0.32,0.3182,0.66,0.194,45,126,171,367,171,171
8610,2011-12-30,Spring,2011,Dec,12,0,Friday,1,Clear,0.32,0.3333,0.57,0.1343,38,159,197,367,197,197
8611,2011-12-30,Spring,2011,Dec,13,0,Friday,1,Misty,0.36,0.3485,0.53,0.1343,53,154,207,367,207,207
8612,2011-12-30,Spring,2011,Dec,14,0,Friday,1,Misty,0.4,0.4091,0.47,0.0896,67,178,245,367,245,245
8613,2011-12-30,Spring,2011,Dec,15,0,Friday,1,Clear,0.42,0.4242,0.44,0.0,56,236,292,367,292,292
8614,2011-12-30,Spring,2011,Dec,16,0,Friday,1,Clear,0.42,0.4242,0.47,0.194,36,247,283,367,283,283
8615,2011-12-30,Spring,2011,Dec,17,0,Friday,1,Clear,0.38,0.3939,0.54,0.1642,54,188,242,367,242,242
8616,2011-12-30,Spring,2011,Dec,18,0,Friday,1,Clear,0.36,0.3485,0.62,0.1343,19,163,182,367,182,182
8617,2011-12-30,Spring,2011,Dec,19,0,Friday,1,Misty,0.34,0.303,0.49,0.4179,16,96,112,367,112,112
8618,2011-12-30,Spring,2011,Dec,20,0,Friday,1,Misty,0.34,0.3485,0.66,0.1045,16,75,91,367,91,91
8619,2011-12-30,Spring,2011,Dec,21,0,Friday,1,Misty,0.36,0.3636,0.66,0.1045,11,84,95,367,95,95
8620,2011-12-30,Spring,2011,Dec,22,0,Friday,1,Misty,0.34,0.3333,0.71,0.1642,7,78,85,367,85,85
8621,2011-12-30,Spring,2011,Dec,23,0,Friday,1,Misty,0.36,0.3333,0.66,0.2537,13,60,73,367,73,73
8622,2011-12-31,Spring,2011,Dec,0,0,Saturday,0,Misty,0.38,0.3939,0.62,0.3284,7,37,44,366,44,44
8623,2011-12-31,Spring,2011,Dec,1,0,Saturday,0,Misty,0.4,0.4091,0.62,0.2836,4,31,35,366,35,35
8624,2011-12-31,Spring,2011,Dec,2,0,Saturday,0,Misty,0.4,0.4091,0.62,0.2836,1,27,28,366,28,28
8625,2011-12-31,Spring,2011,Dec,3,0,Saturday,0,Misty,0.4,0.4091,0.62,0.2836,1,17,18,366,18,18
8626,2011-12-31,Spring,2011,Dec,4,0,Saturday,0,Clear,0.38,0.3939,0.71,0.2239,1,9,10,366,10,10
8627,2011-12-31,Spring,2011,Dec,5,0,Saturday,0,Misty,0.36,0.3485,0.76,0.2239,1,0,1,366,1,1
8628,2011-12-31,Spring,2011,Dec,6,0,Saturday,0,Misty,0.4,0.4091,0.71,0.0896,1,5,6,366,6,6
8629,2011-12-31,Spring,2011,Dec,7,0,Saturday,0,Light_rainsnow,0.38,0.3939,0.76,0.0,6,13,19,366,19,19
8630,2011-12-31,Spring,2011,Dec,8,0,Saturday,0,Clear,0.34,0.3333,0.81,0.1343,7,42,49,366,49,49
8631,2011-12-31,Spring,2011,Dec,9,0,Saturday,0,Clear,0.38,0.3939,0.76,0.0,18,72,90,366,90,90
8632,2011-12-31,Spring,2011,Dec,10,0,Saturday,0,Clear,0.4,0.4091,0.76,0.1642,20,108,128,366,128,128
8633,2011-12-31,Spring,2011,Dec,11,0,Saturday,0,Clear,0.42,0.4242,0.71,0.1642,65,152,217,366,217,217
8634,2011-12-31,Spring,2011,Dec,12,0,Saturday,0,Clear,0.52,0.5,0.39,0.2985,93,180,273,366,273,273
8635,2011-12-31,Spring,2011,Dec,13,0,Saturday,0,Clear,0.5,0.4848,0.42,0.4925,108,205,313,366,313,313
8636,2011-12-31,Spring,2011,Dec,14,0,Saturday,0,Clear,0.46,0.4545,0.51,0.3284,115,185,300,366,300,300
8637,2011-12-31,Spring,2011,Dec,15,0,Saturday,0,Clear,0.46,0.4545,0.47,0.4925,89,164,253,366,253,253
8638,2011-12-31,Spring,2011,Dec,16,0,Saturday,0,Clear,0.44,0.4394,0.51,0.3881,52,143,195,366,195,195
8639,2011-12-31,Spring,2011,Dec,17,0,Saturday,0,Clear,0.42,0.4242,0.54,0.194,28,101,129,366,129,129
8640,2011-12-31,Spring,2011,Dec,18,0,Saturday,0,Clear,0.42,0.4242,0.54,0.1343,13,80,93,366,93,93
8641,2011-12-31,Spring,2011,Dec,19,0,Saturday,0,Clear,0.42,0.4242,0.54,0.2239,19,73,92,366,92,92
8642,2011-12-31,Spring,2011,Dec,20,0,Saturday,0,Clear,0.42,0.4242,0.54,0.2239,8,63,71,366,71,71
8643,2011-12-31,Spring,2011,Dec,21,0,Saturday,0,Clear,0.4,0.4091,0.58,0.194,2,50,52,366,52,52
8644,2011-12-31,Spring,2011,Dec,22,0,Saturday,0,Clear,0.38,0.3939,0.62,0.1343,2,36,38,366,38,38
8645,2011-12-31,Spring,2011,Dec,23,0,Saturday,0,Clear,0.36,0.3788,0.66,0.0,4,27,31,366,31,31
8646,2012-01-01,Spring,2012,Jan,0,0,Sunday,0,Clear,0.36,0.3788,0.66,0.0,5,43,48,365,48,48
8647,2012-01-01,Spring,2012,Jan,1,0,Sunday,0,Clear,0.36,0.3485,0.66,0.1343,15,78,93,365,93,93
8648,2012-01-01,Spring,2012,Jan,2,0,Sunday,0,Clear,0.32,0.3485,0.76,0.0,16,59,75,365,75,75
8649,2012-01-01,Spring,2012,Jan,3,0,Sunday,0,Clear,0.3,0.3333,0.81,0.0,11,41,52,365,52,52
8650,2012-01-01,Spring,2012,Jan,4,0,Sunday,0,Clear,0.28,0.303,0.81,0.0896,0,8,8,365,8,8
8651,2012-01-01,Spring,2012,Jan,5,0,Sunday,0,Clear,0.28,0.2879,0.81,0.1045,0,5,5,365,5,5
8652,2012-01-01,Spring,2012,Jan,6,0,Sunday,0,Clear,0.26,0.2727,0.93,0.1343,1,1,2,365,2,2
8653,2012-01-01,Spring,2012,Jan,7,0,Sunday,0,Clear,0.26,0.2576,0.93,0.1642,1,6,7,365,7,7
8654,2012-01-01,Spring,2012,Jan,8,0,Sunday,0,Clear,0.26,0.2727,0.87,0.1045,4,10,14,365,14,14
8655,2012-01-01,Spring,2012,Jan,9,0,Sunday,0,Clear,0.26,0.2727,0.93,0.1045,13,27,40,365,40,40
8656,2012-01-01,Spring,2012,Jan,10,0,Sunday,0,Clear,0.3,0.3182,0.81,0.1045,18,52,70,365,70,70
8657,2012-01-01,Spring,2012,Jan,11,0,Sunday,0,Clear,0.34,0.3333,0.76,0.1343,40,98,138,365,138,138
8658,2012-01-01,Spring,2012,Jan,12,0,Sunday,0,Clear,0.4,0.4091,0.62,0.2836,58,143,201,365,201,201
8659,2012-01-01,Spring,2012,Jan,13,0,Sunday,0,Clear,0.42,0.4242,0.58,0.2836,82,141,223,365,223,223
8660,2012-01-01,Spring,2012,Jan,14,0,Sunday,0,Clear,0.44,0.4394,0.54,0.2985,120,147,267,365,267,267
8661,2012-01-01,Spring,2012,Jan,15,0,Sunday,0,Clear,0.46,0.4545,0.51,0.2985,101,164,265,365,265,265
8662,2012-01-01,Spring,2012,Jan,16,0,Sunday,0,Misty,0.44,0.4394,0.54,0.2985,68,147,215,365,215,215
8663,2012-01-01,Spring,2012,Jan,17,0,Sunday,0,Misty,0.48,0.4697,0.48,0.1642,36,75,111,365,111,111
8664,2012-01-01,Spring,2012,Jan,18,0,Sunday,0,Light_rainsnow,0.46,0.4545,0.59,0.2537,25,81,106,365,106,106
8665,2012-01-01,Spring,2012,Jan,19,0,Sunday,0,Light_rainsnow,0.42,0.4242,0.67,0.3881,20,85,105,365,105,105
8666,2012-01-01,Spring,2012,Jan,20,0,Sunday,0,Misty,0.44,0.4394,0.62,0.2985,25,58,83,365,83,83
8667,2012-01-01,Spring,2012,Jan,21,0,Sunday,0,Misty,0.44,0.4394,0.67,0.2537,10,61,71,365,71,71
8668,2012-01-01,Spring,2012,Jan,22,0,Sunday,0,Clear,0.46,0.4545,0.55,0.4179,13,53,66,365,66,66
8669,2012-01-01,Spring,2012,Jan,23,0,Sunday,0,Clear,0.44,0.4394,0.51,0.2985,4,25,29,365,29,29
8670,2012-01-02,Spring,2012,Jan,0,1,Monday,0,Clear,0.4,0.4091,0.4,0.4627,8,31,39,364,39,39
8671,2012-01-02,Spring,2012,Jan,1,1,Monday,0,Clear,0.36,0.3333,0.43,0.4179,1,11,12,364,12,12
8672,2012-01-02,Spring,2012,Jan,2,1,Monday,0,Clear,0.36,0.3182,0.34,0.4478,1,6,7,364,7,7
8673,2012-01-02,Spring,2012,Jan,4,1,Monday,0,Clear,0.28,0.2576,0.45,0.3284,0,4,4,364,4,4
8674,2012-01-02,Spring,2012,Jan,5,1,Monday,0,Clear,0.28,0.2576,0.45,0.3284,1,3,4,364,4,4
8675,2012-01-02,Spring,2012,Jan,6,1,Monday,0,Clear,0.26,0.2273,0.41,0.3881,0,14,14,364,14,14
8676,2012-01-02,Spring,2012,Jan,7,1,Monday,0,Clear,0.24,0.2121,0.32,0.3881,0,16,16,364,16,16
8677,2012-01-02,Spring,2012,Jan,8,1,Monday,0,Clear,0.24,0.2273,0.35,0.2537,2,51,53,364,53,53
8678,2012-01-02,Spring,2012,Jan,9,1,Monday,0,Clear,0.24,0.2576,0.35,0.0,15,53,68,364,68,68
8679,2012-01-02,Spring,2012,Jan,10,1,Monday,0,Clear,0.26,0.2424,0.35,0.2836,20,89,109,364,109,109
8680,2012-01-02,Spring,2012,Jan,11,1,Monday,0,Clear,0.26,0.2121,0.35,0.4925,33,142,175,364,175,175
8681,2012-01-02,Spring,2012,Jan,12,1,Monday,0,Clear,0.28,0.2727,0.36,0.2537,41,161,202,364,202,202
8682,2012-01-02,Spring,2012,Jan,13,1,Monday,0,Clear,0.3,0.2727,0.36,0.2985,26,150,176,364,176,176
8683,2012-01-02,Spring,2012,Jan,14,1,Monday,0,Clear,0.3,0.2727,0.36,0.4179,10,141,151,364,151,151
8684,2012-01-02,Spring,2012,Jan,15,1,Monday,0,Clear,0.28,0.2424,0.38,0.4478,29,139,168,364,168,168
8685,2012-01-02,Spring,2012,Jan,16,1,Monday,0,Clear,0.26,0.2273,0.35,0.4179,10,144,154,364,154,154
8686,2012-01-02,Spring,2012,Jan,17,1,Monday,0,Clear,0.26,0.2273,0.35,0.3881,17,136,153,364,153,153
8687,2012-01-02,Spring,2012,Jan,18,1,Monday,0,Clear,0.26,0.2424,0.33,0.2537,13,113,126,364,126,126
8688,2012-01-02,Spring,2012,Jan,19,1,Monday,0,Clear,0.24,0.2273,0.38,0.2239,4,89,93,364,93,93
8689,2012-01-02,Spring,2012,Jan,20,1,Monday,0,Clear,0.24,0.2273,0.41,0.2239,5,83,88,364,88,88
8690,2012-01-02,Spring,2012,Jan,21,1,Monday,0,Misty,0.24,0.2121,0.41,0.3284,3,63,66,364,66,66
8691,2012-01-02,Spring,2012,Jan,22,1,Monday,0,Misty,0.22,0.2121,0.44,0.2836,3,36,39,364,39,39
8692,2012-01-02,Spring,2012,Jan,23,1,Monday,0,Clear,0.22,0.2121,0.44,0.2537,2,32,34,364,34,34
8693,2012-01-03,Spring,2012,Jan,0,0,Tuesday,1,Clear,0.2,0.197,0.51,0.2537,0,13,13,363,13,13
8694,2012-01-03,Spring,2012,Jan,1,0,Tuesday,1,Clear,0.18,0.1818,0.55,0.2239,1,5,6,363,6,6
8695,2012-01-03,Spring,2012,Jan,2,0,Tuesday,1,Clear,0.18,0.1667,0.51,0.2537,0,3,3,363,3,3
8696,2012-01-03,Spring,2012,Jan,3,0,Tuesday,1,Clear,0.16,0.1364,0.55,0.2836,0,2,2,363,2,2
8697,2012-01-03,Spring,2012,Jan,4,0,Tuesday,1,Clear,0.16,0.1515,0.55,0.2537,0,5,5,363,5,5
8698,2012-01-03,Spring,2012,Jan,5,0,Tuesday,1,Clear,0.14,0.1364,0.54,0.194,0,12,12,363,12,12
8699,2012-01-03,Spring,2012,Jan,6,0,Tuesday,1,Clear,0.14,0.1212,0.59,0.2836,4,81,85,363,85,85
8700,2012-01-03,Spring,2012,Jan,7,0,Tuesday,1,Clear,0.14,0.1212,0.59,0.2537,2,168,170,363,170,170
8701,2012-01-03,Spring,2012,Jan,8,0,Tuesday,1,Clear,0.16,0.1364,0.55,0.2836,5,349,354,363,354,354
8702,2012-01-03,Spring,2012,Jan,9,0,Tuesday,1,Clear,0.16,0.1364,0.5,0.2836,8,145,153,363,153,153
8703,2012-01-03,Spring,2012,Jan,10,0,Tuesday,1,Clear,0.16,0.1212,0.47,0.4627,5,55,60,363,60,60
8704,2012-01-03,Spring,2012,Jan,11,0,Tuesday,1,Clear,0.18,0.1364,0.37,0.5224,12,63,75,363,75,75
8705,2012-01-03,Spring,2012,Jan,12,0,Tuesday,1,Clear,0.18,0.1364,0.37,0.5224,4,70,74,363,74,74
8706,2012-01-03,Spring,2012,Jan,13,0,Tuesday,1,Clear,0.18,0.1212,0.34,0.6567,5,68,73,363,73,73
8707,2012-01-03,Spring,2012,Jan,14,0,Tuesday,1,Clear,0.16,0.1212,0.43,0.5224,7,72,79,363,79,79
8708,2012-01-03,Spring,2012,Jan,15,0,Tuesday,1,Clear,0.16,0.1212,0.37,0.4179,9,68,77,363,77,77
8709,2012-01-03,Spring,2012,Jan,16,0,Tuesday,1,Clear,0.14,0.0909,0.39,0.5821,7,129,136,363,136,136
8710,2012-01-03,Spring,2012,Jan,17,0,Tuesday,1,Clear,0.14,0.1061,0.26,0.4627,4,241,245,363,245,245
8711,2012-01-03,Spring,2012,Jan,18,0,Tuesday,1,Clear,0.14,0.0909,0.26,0.5224,10,214,224,363,224,224
8712,2012-01-03,Spring,2012,Jan,19,0,Tuesday,1,Clear,0.12,0.0909,0.28,0.4179,4,152,156,363,156,156
8713,2012-01-03,Spring,2012,Jan,20,0,Tuesday,1,Clear,0.12,0.1212,0.33,0.2537,0,115,115,363,115,115
8714,2012-01-03,Spring,2012,Jan,21,0,Tuesday,1,Clear,0.1,0.1061,0.36,0.2239,2,66,68,363,68,68
8715,2012-01-03,Spring,2012,Jan,22,0,Tuesday,1,Clear,0.1,0.1061,0.46,0.2537,0,33,33,363,33,33
8716,2012-01-03,Spring,2012,Jan,23,0,Tuesday,1,Clear,0.1,0.0758,0.46,0.3881,0,18,18,363,18,18
8717,2012-01-04,Spring,2012,Jan,0,0,Wednesday,1,Clear,0.08,0.0606,0.42,0.3284,0,9,9,362,9,9
8718,2012-01-04,Spring,2012,Jan,1,0,Wednesday,1,Clear,0.04,0.0303,0.38,0.2985,0,3,3,362,3,3
8719,2012-01-04,Spring,2012,Jan,2,0,Wednesday,1,Clear,0.02,0.0152,0.34,0.2836,0,1,1,362,1,1
8720,2012-01-04,Spring,2012,Jan,3,0,Wednesday,1,Clear,0.02,0.0152,0.34,0.2836,0,1,1,362,1,1
8721,2012-01-04,Spring,2012,Jan,4,0,Wednesday,1,Clear,0.02,0.0455,0.41,0.194,0,2,2,362,2,2
8722,2012-01-04,Spring,2012,Jan,5,0,Wednesday,1,Clear,0.02,0.0455,0.41,0.194,0,14,14,362,14,14
8723,2012-01-04,Spring,2012,Jan,6,0,Wednesday,1,Clear,0.02,0.0455,0.41,0.1642,0,59,59,362,59,59
8724,2012-01-04,Spring,2012,Jan,7,0,Wednesday,1,Clear,0.02,0.0455,0.44,0.194,1,151,152,362,152,152
8725,2012-01-04,Spring,2012,Jan,8,0,Wednesday,1,Clear,0.02,0.0606,0.44,0.1343,5,310,315,362,315,315
8726,2012-01-04,Spring,2012,Jan,9,0,Wednesday,1,Clear,0.04,0.0606,0.45,0.1343,7,173,180,362,180,180
8727,2012-01-04,Spring,2012,Jan,10,0,Wednesday,1,Clear,0.06,0.1061,0.45,0.0,7,57,64,362,64,64
8728,2012-01-04,Spring,2012,Jan,11,0,Wednesday,1,Misty,0.08,0.1212,0.42,0.0896,6,40,46,362,46,46
8729,2012-01-04,Spring,2012,Jan,12,0,Wednesday,1,Misty,0.1,0.1061,0.46,0.194,9,75,84,362,84,84
8730,2012-01-04,Spring,2012,Jan,13,0,Wednesday,1,Misty,0.14,0.1212,0.43,0.2537,9,82,91,362,91,91
8731,2012-01-04,Spring,2012,Jan,14,0,Wednesday,1,Misty,0.14,0.1212,0.46,0.2537,6,69,75,362,75,75
8732,2012-01-04,Spring,2012,Jan,15,0,Wednesday,1,Misty,0.18,0.1515,0.37,0.3284,9,81,90,362,90,90
8733,2012-01-04,Spring,2012,Jan,16,0,Wednesday,1,Misty,0.18,0.1667,0.4,0.2836,8,123,131,362,131,131
8734,2012-01-04,Spring,2012,Jan,17,0,Wednesday,1,Misty,0.2,0.197,0.4,0.194,9,272,281,362,281,281
8735,2012-01-04,Spring,2012,Jan,18,0,Wednesday,1,Misty,0.2,0.2121,0.37,0.1343,9,280,289,362,289,289
8736,2012-01-04,Spring,2012,Jan,19,0,Wednesday,1,Misty,0.2,0.2273,0.4,0.1045,2,182,184,362,184,184
8737,2012-01-04,Spring,2012,Jan,20,0,Wednesday,1,Misty,0.2,0.197,0.4,0.194,2,121,123,362,123,123
8738,2012-01-04,Spring,2012,Jan,21,0,Wednesday,1,Misty,0.2,0.2576,0.44,0.0,2,88,90,362,90,90
8739,2012-01-04,Spring,2012,Jan,22,0,Wednesday,1,Misty,0.2,0.2273,0.47,0.0896,4,48,52,362,52,52
8740,2012-01-04,Spring,2012,Jan,23,0,Wednesday,1,Misty,0.2,0.2273,0.44,0.1045,0,32,32,362,32,32
8741,2012-01-05,Spring,2012,Jan,0,0,Thursday,1,Misty,0.22,0.2273,0.47,0.194,1,13,14,361,14,14
8742,2012-01-05,Spring,2012,Jan,1,0,Thursday,1,Clear,0.2,0.2273,0.51,0.0896,0,5,5,361,5,5
8743,2012-01-05,Spring,2012,Jan,2,0,Thursday,1,Clear,0.2,0.2273,0.51,0.0896,0,4,4,361,4,4
8744,2012-01-05,Spring,2012,Jan,3,0,Thursday,1,Clear,0.2,0.2576,0.61,0.0,0,4,4,361,4,4
8745,2012-01-05,Spring,2012,Jan,4,0,Thursday,1,Misty,0.2,0.2273,0.59,0.0896,0,5,5,361,5,5
8746,2012-01-05,Spring,2012,Jan,5,0,Thursday,1,Misty,0.2,0.2273,0.59,0.0896,0,26,26,361,26,26
8747,2012-01-05,Spring,2012,Jan,6,0,Thursday,1,Misty,0.2,0.2121,0.75,0.1343,0,78,78,361,78,78
8748,2012-01-05,Spring,2012,Jan,7,0,Thursday,1,Misty,0.2,0.2273,0.69,0.0896,3,212,215,361,215,215
8749,2012-01-05,Spring,2012,Jan,8,0,Thursday,1,Misty,0.2,0.2576,0.75,0.0,11,377,388,361,388,388
8750,2012-01-05,Spring,2012,Jan,9,0,Thursday,1,Misty,0.22,0.2727,0.69,0.0,7,220,227,361,227,227
8751,2012-01-05,Spring,2012,Jan,10,0,Thursday,1,Misty,0.24,0.2576,0.52,0.0896,5,81,86,361,86,86
8752,2012-01-05,Spring,2012,Jan,11,0,Thursday,1,Clear,0.3,0.3333,0.49,0.0,6,78,84,361,84,84
8753,2012-01-05,Spring,2012,Jan,12,0,Thursday,1,Clear,0.3,0.2879,0.49,0.2537,6,114,120,361,120,120
8754,2012-01-05,Spring,2012,Jan,13,0,Thursday,1,Clear,0.34,0.303,0.42,0.2985,6,112,118,361,118,118
8755,2012-01-05,Spring,2012,Jan,14,0,Thursday,1,Clear,0.34,0.3182,0.39,0.2836,13,104,117,361,117,117
8756,2012-01-05,Spring,2012,Jan,15,0,Thursday,1,Clear,0.36,0.3333,0.34,0.2836,6,113,119,361,119,119
8757,2012-01-05,Spring,2012,Jan,16,0,Thursday,1,Clear,0.36,0.3333,0.34,0.2836,19,178,197,361,197,197
8758,2012-01-05,Spring,2012,Jan,17,0,Thursday,1,Misty,0.36,0.3485,0.34,0.194,19,393,412,361,412,412
8759,2012-01-05,Spring,2012,Jan,18,0,Thursday,1,Clear,0.34,0.3333,0.36,0.1642,9,374,383,361,383,383
8760,2012-01-05,Spring,2012,Jan,19,0,Thursday,1,Clear,0.34,0.3485,0.34,0.0896,10,255,265,361,265,265
8761,2012-01-05,Spring,2012,Jan,20,0,Thursday,1,Clear,0.3,0.3333,0.49,0.0,5,172,177,361,177,177
8762,2012-01-05,Spring,2012,Jan,21,0,Thursday,1,Clear,0.26,0.2727,0.6,0.1343,9,88,97,361,97,97
8763,2012-01-05,Spring,2012,Jan,22,0,Thursday,1,Clear,0.26,0.2576,0.6,0.1642,1,70,71,361,71,71
8764,2012-01-05,Spring,2012,Jan,23,0,Thursday,1,Clear,0.24,0.2576,0.7,0.1045,4,56,60,361,60,60
8765,2012-01-06,Spring,2012,Jan,0,0,Friday,1,Clear,0.22,0.2576,0.75,0.0896,1,24,25,360,25,25
8766,2012-01-06,Spring,2012,Jan,1,0,Friday,1,Clear,0.22,0.2727,0.75,0.0,2,6,8,360,8,8
8767,2012-01-06,Spring,2012,Jan,2,0,Friday,1,Clear,0.22,0.2273,0.69,0.1642,2,3,5,360,5,5
8768,2012-01-06,Spring,2012,Jan,3,0,Friday,1,Clear,0.22,0.2424,0.69,0.1045,1,3,4,360,4,4
8769,2012-01-06,Spring,2012,Jan,4,0,Friday,1,Clear,0.22,0.2273,0.69,0.1343,0,3,3,360,3,3
8770,2012-01-06,Spring,2012,Jan,5,0,Friday,1,Misty,0.2,0.2121,0.8,0.1343,0,13,13,360,13,13
8771,2012-01-06,Spring,2012,Jan,6,0,Friday,1,Misty,0.22,0.2424,0.73,0.1045,1,69,70,360,70,70
8772,2012-01-06,Spring,2012,Jan,7,0,Friday,1,Misty,0.24,0.2879,0.65,0.0,4,201,205,360,205,205
8773,2012-01-06,Spring,2012,Jan,8,0,Friday,1,Clear,0.24,0.2424,0.7,0.1343,11,436,447,360,447,447
8774,2012-01-06,Spring,2012,Jan,9,0,Friday,1,Clear,0.24,0.2424,0.7,0.1642,4,237,241,360,241,241
8775,2012-01-06,Spring,2012,Jan,10,0,Friday,1,Clear,0.26,0.2576,0.65,0.194,14,102,116,360,116,116
8776,2012-01-06,Spring,2012,Jan,11,0,Friday,1,Clear,0.3,0.303,0.56,0.1642,8,130,138,360,138,138
8777,2012-01-06,Spring,2012,Jan,12,0,Friday,1,Clear,0.36,0.3333,0.5,0.2537,23,168,191,360,191,191
8778,2012-01-06,Spring,2012,Jan,13,0,Friday,1,Clear,0.4,0.4091,0.43,0.2836,16,188,204,360,204,204
8779,2012-01-06,Spring,2012,Jan,14,0,Friday,1,Clear,0.46,0.4545,0.36,0.194,26,152,178,360,178,178
8780,2012-01-06,Spring,2012,Jan,15,0,Friday,1,Clear,0.52,0.5,0.27,0.2537,44,178,222,360,222,222
8781,2012-01-06,Spring,2012,Jan,16,0,Friday,1,Clear,0.52,0.5,0.27,0.2836,35,259,294,360,294,294
8782,2012-01-06,Spring,2012,Jan,17,0,Friday,1,Clear,0.46,0.4545,0.36,0.2239,20,456,476,360,476,476
8783,2012-01-06,Spring,2012,Jan,18,0,Friday,1,Clear,0.5,0.4848,0.29,0.2537,28,391,419,360,419,419
8784,2012-01-06,Spring,2012,Jan,19,0,Friday,1,Clear,0.46,0.4545,0.33,0.2836,11,261,272,360,272,272
8785,2012-01-06,Spring,2012,Jan,20,0,Friday,1,Clear,0.42,0.4242,0.41,0.194,14,163,177,360,177,177
8786,2012-01-06,Spring,2012,Jan,21,0,Friday,1,Clear,0.4,0.4091,0.43,0.2239,17,137,154,360,154,154
8787,2012-01-06,Spring,2012,Jan,22,0,Friday,1,Clear,0.36,0.3485,0.5,0.194,12,123,135,360,135,135
8788,2012-01-06,Spring,2012,Jan,23,0,Friday,1,Clear,0.36,0.3788,0.5,0.0,13,88,101,360,101,101
8789,2012-01-07,Spring,2012,Jan,0,0,Saturday,0,Clear,0.36,0.3485,0.5,0.1642,2,77,79,359,79,79
8790,2012-01-07,Spring,2012,Jan,1,0,Saturday,0,Clear,0.38,0.3939,0.46,0.1642,6,56,62,359,62,62
8791,2012-01-07,Spring,2012,Jan,2,0,Saturday,0,Clear,0.36,0.3636,0.5,0.1045,2,36,38,359,38,38
8792,2012-01-07,Spring,2012,Jan,3,0,Saturday,0,Clear,0.32,0.3333,0.57,0.1045,1,19,20,359,20,20
8793,2012-01-07,Spring,2012,Jan,4,0,Saturday,0,Clear,0.32,0.3333,0.57,0.0896,1,9,10,359,10,10
8794,2012-01-07,Spring,2012,Jan,5,0,Saturday,0,Clear,0.26,0.2727,0.75,0.1045,2,7,9,359,9,9
8795,2012-01-07,Spring,2012,Jan,6,0,Saturday,0,Clear,0.26,0.2727,0.75,0.1045,0,7,7,359,7,7
8796,2012-01-07,Spring,2012,Jan,7,0,Saturday,0,Clear,0.22,0.2273,0.87,0.194,0,20,20,359,20,20
8797,2012-01-07,Spring,2012,Jan,8,0,Saturday,0,Clear,0.24,0.2576,0.75,0.1045,0,64,64,359,64,64
8798,2012-01-07,Spring,2012,Jan,9,0,Saturday,0,Clear,0.22,0.2273,0.8,0.1343,14,116,130,359,130,130
8799,2012-01-07,Spring,2012,Jan,10,0,Saturday,0,Clear,0.28,0.303,0.75,0.0896,43,160,203,359,203,203
8800,2012-01-07,Spring,2012,Jan,11,0,Saturday,0,Clear,0.34,0.3182,0.57,0.2239,74,250,324,359,324,324
8801,2012-01-07,Spring,2012,Jan,12,0,Saturday,0,Clear,0.4,0.4091,0.43,0.2239,100,276,376,359,376,376
8802,2012-01-07,Spring,2012,Jan,13,0,Saturday,0,Clear,0.44,0.4394,0.44,0.194,149,296,445,359,445,445
8803,2012-01-07,Spring,2012,Jan,14,0,Saturday,0,Clear,0.5,0.4848,0.42,0.2836,156,356,512,359,512,512
8804,2012-01-07,Spring,2012,Jan,15,0,Saturday,0,Clear,0.58,0.5455,0.37,0.2985,132,317,449,359,449,449
8805,2012-01-07,Spring,2012,Jan,16,0,Saturday,0,Misty,0.56,0.5303,0.37,0.2836,133,268,401,359,401,401
8806,2012-01-07,Spring,2012,Jan,17,0,Saturday,0,Misty,0.54,0.5152,0.43,0.1343,87,235,322,359,322,322
8807,2012-01-07,Spring,2012,Jan,18,0,Saturday,0,Clear,0.54,0.5152,0.45,0.1343,49,248,297,359,297,297
8808,2012-01-07,Spring,2012,Jan,19,0,Saturday,0,Clear,0.52,0.5,0.42,0.1045,44,171,215,359,215,215
8809,2012-01-07,Spring,2012,Jan,20,0,Saturday,0,Clear,0.5,0.4848,0.39,0.2537,21,149,170,359,170,170
8810,2012-01-07,Spring,2012,Jan,21,0,Saturday,0,Clear,0.44,0.4394,0.44,0.2239,22,118,140,359,140,140
8811,2012-01-07,Spring,2012,Jan,22,0,Saturday,0,Clear,0.44,0.4394,0.38,0.2537,16,93,109,359,109,109
8812,2012-01-07,Spring,2012,Jan,23,0,Saturday,0,Clear,0.42,0.4242,0.38,0.2239,16,103,119,359,119,119
8813,2012-01-08,Spring,2012,Jan,0,0,Sunday,0,Clear,0.38,0.3939,0.4,0.2836,14,77,91,358,91,91
8814,2012-01-08,Spring,2012,Jan,1,0,Sunday,0,Clear,0.34,0.3333,0.42,0.194,10,62,72,358,72,72
8815,2012-01-08,Spring,2012,Jan,2,0,Sunday,0,Clear,0.36,0.3333,0.37,0.2836,10,57,67,358,67,67
8816,2012-01-08,Spring,2012,Jan,3,0,Sunday,0,Clear,0.34,0.3333,0.42,0.1343,6,26,32,358,32,32
8817,2012-01-08,Spring,2012,Jan,4,0,Sunday,0,Clear,0.32,0.303,0.49,0.2537,2,4,6,358,6,6
8818,2012-01-08,Spring,2012,Jan,5,0,Sunday,0,Misty,0.32,0.3333,0.49,0.1045,0,2,2,358,2,2
8819,2012-01-08,Spring,2012,Jan,6,0,Sunday,0,Misty,0.3,0.3333,0.52,0.0,0,2,2,358,2,2
8820,2012-01-08,Spring,2012,Jan,7,0,Sunday,0,Misty,0.3,0.3333,0.52,0.0,1,23,24,358,24,24
8821,2012-01-08,Spring,2012,Jan,8,0,Sunday,0,Clear,0.3,0.303,0.52,0.1343,4,53,57,358,57,57
8822,2012-01-08,Spring,2012,Jan,9,0,Sunday,0,Clear,0.32,0.3333,0.53,0.1343,23,102,125,358,125,125
8823,2012-01-08,Spring,2012,Jan,10,0,Sunday,0,Clear,0.34,0.3333,0.49,0.1642,27,181,208,358,208,208
8824,2012-01-08,Spring,2012,Jan,11,0,Sunday,0,Clear,0.36,0.3485,0.46,0.2239,55,201,256,358,256,256
8825,2012-01-08,Spring,2012,Jan,12,0,Sunday,0,Clear,0.38,0.3939,0.43,0.2239,78,273,351,358,351,351
8826,2012-01-08,Spring,2012,Jan,13,0,Sunday,0,Clear,0.4,0.4091,0.37,0.2985,77,266,343,358,343,343
8827,2012-01-08,Spring,2012,Jan,14,0,Sunday,0,Clear,0.4,0.4091,0.4,0.194,75,253,328,358,328,328
8828,2012-01-08,Spring,2012,Jan,15,0,Sunday,0,Clear,0.4,0.4091,0.37,0.2836,89,241,330,358,330,330
8829,2012-01-08,Spring,2012,Jan,16,0,Sunday,0,Clear,0.4,0.4091,0.37,0.2985,58,256,314,358,314,314
8830,2012-01-08,Spring,2012,Jan,17,0,Sunday,0,Clear,0.38,0.3939,0.4,0.2239,22,197,219,358,219,219
8831,2012-01-08,Spring,2012,Jan,18,0,Sunday,0,Clear,0.34,0.3182,0.46,0.2239,19,162,181,358,181,181
8832,2012-01-08,Spring,2012,Jan,19,0,Sunday,0,Clear,0.32,0.3182,0.49,0.194,8,104,112,358,112,112
8833,2012-01-08,Spring,2012,Jan,20,0,Sunday,0,Clear,0.3,0.303,0.52,0.1642,7,119,126,358,126,126
8834,2012-01-08,Spring,2012,Jan,21,0,Sunday,0,Clear,0.28,0.2727,0.56,0.2239,10,81,91,358,91,91
8835,2012-01-08,Spring,2012,Jan,22,0,Sunday,0,Clear,0.26,0.2727,0.6,0.1045,4,54,58,358,58,58
8836,2012-01-08,Spring,2012,Jan,23,0,Sunday,0,Clear,0.26,0.2424,0.56,0.2537,0,30,30,358,30,30
8837,2012-01-09,Spring,2012,Jan,0,0,Monday,1,Clear,0.24,0.2273,0.6,0.2239,3,12,15,357,15,15
8838,2012-01-09,Spring,2012,Jan,1,0,Monday,1,Clear,0.24,0.2424,0.6,0.1343,1,4,5,357,5,5
8839,2012-01-09,Spring,2012,Jan,2,0,Monday,1,Clear,0.24,0.2424,0.56,0.1343,2,3,5,357,5,5
8840,2012-01-09,Spring,2012,Jan,3,0,Monday,1,Clear,0.24,0.2424,0.52,0.1642,0,3,3,357,3,3
8841,2012-01-09,Spring,2012,Jan,4,0,Monday,1,Clear,0.22,0.2424,0.64,0.1045,0,4,4,357,4,4
8842,2012-01-09,Spring,2012,Jan,5,0,Monday,1,Misty,0.2,0.2273,0.64,0.0896,0,21,21,357,21,21
8843,2012-01-09,Spring,2012,Jan,6,0,Monday,1,Misty,0.22,0.2273,0.6,0.1343,3,85,88,357,88,88
8844,2012-01-09,Spring,2012,Jan,7,0,Monday,1,Misty,0.22,0.2424,0.6,0.1045,1,239,240,357,240,240
8845,2012-01-09,Spring,2012,Jan,8,0,Monday,1,Misty,0.22,0.2576,0.55,0.0896,13,407,420,357,420,420
8846,2012-01-09,Spring,2012,Jan,9,0,Monday,1,Misty,0.22,0.2727,0.64,0.0,9,188,197,357,197,197
8847,2012-01-09,Spring,2012,Jan,10,0,Monday,1,Clear,0.24,0.2879,0.6,0.0,13,95,108,357,108,108
8848,2012-01-09,Spring,2012,Jan,11,0,Monday,1,Misty,0.26,0.2879,0.56,0.0896,6,82,88,357,88,88
8849,2012-01-09,Spring,2012,Jan,12,0,Monday,1,Misty,0.26,0.2727,0.56,0.1045,10,93,103,357,103,103
8850,2012-01-09,Spring,2012,Jan,13,0,Monday,1,Misty,0.26,0.2727,0.56,0.1045,3,77,80,357,80,80
8851,2012-01-09,Spring,2012,Jan,14,0,Monday,1,Light_rainsnow,0.22,0.2273,0.75,0.1642,5,45,50,357,50,50
8852,2012-01-09,Spring,2012,Jan,15,0,Monday,1,Light_rainsnow,0.22,0.2273,0.75,0.1642,5,64,69,357,69,69
8853,2012-01-09,Spring,2012,Jan,16,0,Monday,1,Light_rainsnow,0.22,0.2576,0.87,0.0896,3,46,49,357,49,49
8854,2012-01-09,Spring,2012,Jan,17,0,Monday,1,Light_rainsnow,0.22,0.2727,0.87,0.0,5,147,152,357,152,152
8855,2012-01-09,Spring,2012,Jan,18,0,Monday,1,Heavy_rainsnow,0.2,0.2273,0.86,0.0896,6,158,164,357,164,164
8856,2012-01-09,Spring,2012,Jan,19,0,Monday,1,Light_rainsnow,0.2,0.2273,0.93,0.0896,3,187,190,357,190,190
8857,2012-01-09,Spring,2012,Jan,20,0,Monday,1,Misty,0.2,0.2273,0.86,0.0896,5,127,132,357,132,132
8858,2012-01-09,Spring,2012,Jan,21,0,Monday,1,Misty,0.2,0.2576,0.93,0.0,1,78,79,357,79,79
8859,2012-01-09,Spring,2012,Jan,22,0,Monday,1,Misty,0.2,0.2273,0.92,0.1045,8,54,62,357,62,62
8860,2012-01-09,Spring,2012,Jan,23,0,Monday,1,Misty,0.22,0.2424,0.87,0.1045,1,51,52,357,52,52
8861,2012-01-10,Spring,2012,Jan,0,0,Tuesday,1,Misty,0.22,0.2424,0.87,0.1045,0,14,14,356,14,14
8862,2012-01-10,Spring,2012,Jan,1,0,Tuesday,1,Misty,0.22,0.2424,0.93,0.1045,2,3,5,356,5,5
8863,2012-01-10,Spring,2012,Jan,2,0,Tuesday,1,Misty,0.22,0.2273,0.87,0.1642,2,2,4,356,4,4
8864,2012-01-10,Spring,2012,Jan,4,0,Tuesday,1,Misty,0.2,0.2121,0.86,0.1642,0,4,4,356,4,4
8865,2012-01-10,Spring,2012,Jan,5,0,Tuesday,1,Clear,0.4,0.4091,0.47,0.2239,0,23,23,356,23,23
8866,2012-01-10,Spring,2012,Jan,6,0,Tuesday,1,Misty,0.18,0.1818,0.93,0.194,0,79,79,356,79,79
8867,2012-01-10,Spring,2012,Jan,7,0,Tuesday,1,Misty,0.18,0.197,0.93,0.1642,3,219,222,356,222,222
8868,2012-01-10,Spring,2012,Jan,8,0,Tuesday,1,Misty,0.18,0.197,0.93,0.1642,6,465,471,356,471,471
8869,2012-01-10,Spring,2012,Jan,9,0,Tuesday,1,Misty,0.18,0.197,0.93,0.1642,11,184,195,356,195,195
8870,2012-01-10,Spring,2012,Jan,10,0,Tuesday,1,Misty,0.18,0.197,0.93,0.1642,3,80,83,356,83,83
8871,2012-01-10,Spring,2012,Jan,11,0,Tuesday,1,Clear,0.42,0.4242,0.38,0.2985,8,93,101,356,101,101
8872,2012-01-10,Spring,2012,Jan,12,0,Tuesday,1,Clear,0.42,0.4242,0.38,0.2985,13,127,140,356,140,140
8873,2012-01-10,Spring,2012,Jan,13,0,Tuesday,1,Clear,0.42,0.4242,0.38,0.2985,15,163,178,356,178,178
8874,2012-01-10,Spring,2012,Jan,14,0,Tuesday,1,Clear,0.42,0.4242,0.38,0.2985,10,96,106,356,106,106
8875,2012-01-10,Spring,2012,Jan,15,0,Tuesday,1,Clear,0.42,0.4242,0.38,0.2985,17,119,136,356,136,136
8876,2012-01-10,Spring,2012,Jan,16,0,Tuesday,1,Clear,0.42,0.4242,0.38,0.3582,15,225,240,356,240,240
8877,2012-01-10,Spring,2012,Jan,17,0,Tuesday,1,Clear,0.42,0.4242,0.38,0.2537,14,446,460,356,460,460
8878,2012-01-10,Spring,2012,Jan,18,0,Tuesday,1,Clear,0.4,0.4091,0.4,0.1045,13,372,385,356,385,385
8879,2012-01-10,Spring,2012,Jan,19,0,Tuesday,1,Clear,0.38,0.3939,0.46,0.1045,11,270,281,356,281,281
8880,2012-01-10,Spring,2012,Jan,20,0,Tuesday,1,Clear,0.34,0.3485,0.53,0.1045,10,190,200,356,200,200
8881,2012-01-10,Spring,2012,Jan,21,0,Tuesday,1,Clear,0.32,0.3333,0.66,0.0896,7,109,116,356,116,116
8882,2012-01-10,Spring,2012,Jan,22,0,Tuesday,1,Clear,0.3,0.303,0.7,0.0896,10,104,114,356,114,114
8883,2012-01-10,Spring,2012,Jan,23,0,Tuesday,1,Clear,0.26,0.2727,0.81,0.1045,3,38,41,356,41,41
8884,2012-01-11,Spring,2012,Jan,0,0,Wednesday,1,Clear,0.26,0.303,0.81,0.0,2,26,28,355,28,28
8885,2012-01-11,Spring,2012,Jan,1,0,Wednesday,1,Clear,0.24,0.2576,0.87,0.0896,1,6,7,355,7,7
8886,2012-01-11,Spring,2012,Jan,2,0,Wednesday,1,Clear,0.2,0.2121,0.85,0.1642,0,5,5,355,5,5
8887,2012-01-11,Spring,2012,Jan,3,0,Wednesday,1,Clear,0.22,0.2727,0.8,0.0,0,4,4,355,4,4
8888,2012-01-11,Spring,2012,Jan,4,0,Wednesday,1,Clear,0.2,0.2121,0.8,0.1343,0,2,2,355,2,2
8889,2012-01-11,Spring,2012,Jan,5,0,Wednesday,1,Clear,0.2,0.2121,0.8,0.1343,0,22,22,355,22,22
8890,2012-01-11,Spring,2012,Jan,6,0,Wednesday,1,Clear,0.2,0.2121,0.86,0.1343,2,72,74,355,74,74
8891,2012-01-11,Spring,2012,Jan,7,0,Wednesday,1,Clear,0.2,0.2121,0.8,0.1343,9,247,256,355,256,256
8892,2012-01-11,Spring,2012,Jan,8,0,Wednesday,1,Clear,0.2,0.2273,0.82,0.1045,11,488,499,355,499,499
8893,2012-01-11,Spring,2012,Jan,9,0,Wednesday,1,Misty,0.2,0.2121,0.86,0.1343,7,218,225,355,225,225
8894,2012-01-11,Spring,2012,Jan,10,0,Wednesday,1,Misty,0.24,0.2424,0.87,0.1343,13,84,97,355,97,97
8895,2012-01-11,Spring,2012,Jan,11,0,Wednesday,1,Misty,0.26,0.2879,0.87,0.0896,9,90,99,355,99,99
8896,2012-01-11,Spring,2012,Jan,12,0,Wednesday,1,Light_rainsnow,0.3,0.3333,0.81,0.0,4,51,55,355,55,55
8897,2012-01-11,Spring,2012,Jan,13,0,Wednesday,1,Light_rainsnow,0.32,0.3485,0.76,0.0,8,57,65,355,65,65
8898,2012-01-11,Spring,2012,Jan,14,0,Wednesday,1,Light_rainsnow,0.32,0.3333,0.81,0.1045,3,70,73,355,73,73
8899,2012-01-11,Spring,2012,Jan,15,0,Wednesday,1,Misty,0.34,0.3485,0.87,0.0896,6,73,79,355,79,79
8900,2012-01-11,Spring,2012,Jan,16,0,Wednesday,1,Misty,0.34,0.3182,0.87,0.2537,6,112,118,355,118,118
8901,2012-01-11,Spring,2012,Jan,17,0,Wednesday,1,Light_rainsnow,0.34,0.3182,0.87,0.2239,6,128,134,355,134,134
8902,2012-01-11,Spring,2012,Jan,18,0,Wednesday,1,Light_rainsnow,0.34,0.3333,0.87,0.194,2,96,98,355,98,98
8903,2012-01-11,Spring,2012,Jan,19,0,Wednesday,1,Light_rainsnow,0.32,0.303,0.93,0.2239,1,92,93,355,93,93
8904,2012-01-11,Spring,2012,Jan,20,0,Wednesday,1,Light_rainsnow,0.32,0.3182,0.93,0.1642,2,55,57,355,57,57
8905,2012-01-11,Spring,2012,Jan,21,0,Wednesday,1,Light_rainsnow,0.34,0.3182,0.87,0.2239,0,29,29,355,29,29
8906,2012-01-11,Spring,2012,Jan,22,0,Wednesday,1,Light_rainsnow,0.34,0.3333,0.87,0.194,0,49,49,355,49,49
8907,2012-01-11,Spring,2012,Jan,23,0,Wednesday,1,Light_rainsnow,0.34,0.3182,0.87,0.2239,0,9,9,355,9,9
8908,2012-01-12,Spring,2012,Jan,0,0,Thursday,1,Light_rainsnow,0.34,0.3333,0.93,0.194,0,3,3,354,3,3
8909,2012-01-12,Spring,2012,Jan,1,0,Thursday,1,Light_rainsnow,0.36,0.3485,0.93,0.194,0,3,3,354,3,3
8910,2012-01-12,Spring,2012,Jan,2,0,Thursday,1,Light_rainsnow,0.36,0.3485,0.93,0.2537,1,1,2,354,2,2
8911,2012-01-12,Spring,2012,Jan,3,0,Thursday,1,Light_rainsnow,0.36,0.3485,0.93,0.2537,0,3,3,354,3,3
8912,2012-01-12,Spring,2012,Jan,4,0,Thursday,1,Light_rainsnow,0.36,0.3485,0.93,0.194,0,2,2,354,2,2
8913,2012-01-12,Spring,2012,Jan,5,0,Thursday,1,Light_rainsnow,0.34,0.3485,0.93,0.0896,0,16,16,354,16,16
8914,2012-01-12,Spring,2012,Jan,6,0,Thursday,1,Light_rainsnow,0.36,0.3485,0.93,0.1343,1,88,89,354,89,89
8915,2012-01-12,Spring,2012,Jan,7,0,Thursday,1,Misty,0.34,0.3182,0.87,0.2836,2,218,220,354,220,220
8916,2012-01-12,Spring,2012,Jan,8,0,Thursday,1,Clear,0.32,0.3182,0.81,0.194,11,497,508,354,508,508
8917,2012-01-12,Spring,2012,Jan,9,0,Thursday,1,Clear,0.32,0.3333,0.81,0.1045,10,220,230,354,230,230
8918,2012-01-12,Spring,2012,Jan,10,0,Thursday,1,Clear,0.34,0.3485,0.81,0.1045,6,84,90,354,90,90
8919,2012-01-12,Spring,2012,Jan,11,0,Thursday,1,Misty,0.34,0.3485,0.81,0.1045,18,101,119,354,119,119
8920,2012-01-12,Spring,2012,Jan,12,0,Thursday,1,Misty,0.34,0.3485,0.81,0.1045,14,130,144,354,144,144
8921,2012-01-12,Spring,2012,Jan,13,0,Thursday,1,Clear,0.42,0.4242,0.77,0.1642,13,170,183,354,183,183
8922,2012-01-12,Spring,2012,Jan,14,0,Thursday,1,Clear,0.42,0.4242,0.77,0.1642,24,132,156,354,156,156
8923,2012-01-12,Spring,2012,Jan,15,0,Thursday,1,Clear,0.44,0.4394,0.72,0.1343,32,156,188,354,188,188
8924,2012-01-12,Spring,2012,Jan,16,0,Thursday,1,Clear,0.46,0.4545,0.67,0.194,33,248,281,354,281,281
8925,2012-01-12,Spring,2012,Jan,17,0,Thursday,1,Clear,0.46,0.4545,0.63,0.1642,23,472,495,354,495,495
8926,2012-01-12,Spring,2012,Jan,18,0,Thursday,1,Clear,0.44,0.4394,0.67,0.194,22,399,421,354,421,421
8927,2012-01-12,Spring,2012,Jan,19,0,Thursday,1,Misty,0.42,0.4242,0.71,0.1642,17,313,330,354,330,330
8928,2012-01-12,Spring,2012,Jan,20,0,Thursday,1,Misty,0.42,0.4242,0.71,0.194,11,229,240,354,240,240
8929,2012-01-12,Spring,2012,Jan,21,0,Thursday,1,Clear,0.44,0.4394,0.67,0.1343,12,162,174,354,174,174
8930,2012-01-12,Spring,2012,Jan,22,0,Thursday,1,Clear,0.38,0.3939,0.76,0.2985,12,121,133,354,133,133
8931,2012-01-12,Spring,2012,Jan,23,0,Thursday,1,Clear,0.4,0.4091,0.76,0.3284,7,60,67,354,67,67
8932,2012-01-13,Spring,2012,Jan,0,0,Friday,1,Misty,0.4,0.4091,0.71,0.2836,4,38,42,353,42,42
8933,2012-01-13,Spring,2012,Jan,1,0,Friday,1,Misty,0.38,0.3939,0.76,0.2985,0,12,12,353,12,12
8934,2012-01-13,Spring,2012,Jan,2,0,Friday,1,Clear,0.4,0.4091,0.76,0.3582,1,13,14,353,14,14
8935,2012-01-13,Spring,2012,Jan,3,0,Friday,1,Clear,0.36,0.3333,0.87,0.2537,3,4,7,353,7,7
8936,2012-01-13,Spring,2012,Jan,4,0,Friday,1,Light_rainsnow,0.32,0.2879,0.7,0.4925,1,2,3,353,3,3
8937,2012-01-13,Spring,2012,Jan,5,0,Friday,1,Misty,0.3,0.2424,0.7,0.5522,0,21,21,353,21,21
8938,2012-01-13,Spring,2012,Jan,6,0,Friday,1,Misty,0.26,0.2576,0.75,0.2239,2,71,73,353,73,73
8939,2012-01-13,Spring,2012,Jan,7,0,Friday,1,Clear,0.26,0.2576,0.6,0.2239,3,174,177,353,177,177
8940,2012-01-13,Spring,2012,Jan,8,0,Friday,1,Clear,0.24,0.2121,0.52,0.3582,11,408,419,353,419,419
8941,2012-01-13,Spring,2012,Jan,9,0,Friday,1,Clear,0.22,0.197,0.47,0.3881,10,204,214,353,214,214
8942,2012-01-13,Spring,2012,Jan,10,0,Friday,1,Clear,0.24,0.197,0.44,0.4478,2,101,103,353,103,103
8943,2012-01-13,Spring,2012,Jan,11,0,Friday,1,Clear,0.24,0.1818,0.38,0.6119,12,102,114,353,114,114
8944,2012-01-13,Spring,2012,Jan,12,0,Friday,1,Clear,0.24,0.197,0.38,0.4925,14,140,154,353,154,154
8945,2012-01-13,Spring,2012,Jan,13,0,Friday,1,Clear,0.26,0.2121,0.33,0.5224,14,140,154,353,154,154
8946,2012-01-13,Spring,2012,Jan,14,0,Friday,1,Clear,0.26,0.2121,0.33,0.5522,10,119,129,353,129,129
8947,2012-01-13,Spring,2012,Jan,15,0,Friday,1,Clear,0.26,0.2121,0.33,0.5821,15,123,138,353,138,138
8948,2012-01-13,Spring,2012,Jan,16,0,Friday,1,Clear,0.28,0.2424,0.3,0.4627,18,215,233,353,233,233
8949,2012-01-13,Spring,2012,Jan,17,0,Friday,1,Clear,0.28,0.2424,0.33,0.4179,15,317,332,353,332,332
8950,2012-01-13,Spring,2012,Jan,18,0,Friday,1,Clear,0.26,0.2273,0.38,0.2985,7,294,301,353,301,301
8951,2012-01-13,Spring,2012,Jan,19,0,Friday,1,Clear,0.26,0.2424,0.38,0.2836,7,199,206,353,206,206
8952,2012-01-13,Spring,2012,Jan,20,0,Friday,1,Clear,0.24,0.2424,0.41,0.1642,6,130,136,353,136,136
8953,2012-01-13,Spring,2012,Jan,21,0,Friday,1,Clear,0.24,0.2121,0.41,0.2836,7,95,102,353,102,102
8954,2012-01-13,Spring,2012,Jan,22,0,Friday,1,Clear,0.2,0.1818,0.47,0.3284,7,58,65,353,65,65
8955,2012-01-13,Spring,2012,Jan,23,0,Friday,1,Clear,0.18,0.1818,0.47,0.194,5,60,65,353,65,65
8956,2012-01-14,Spring,2012,Jan,0,0,Saturday,0,Clear,0.16,0.1818,0.47,0.1045,2,42,44,352,44,44
8957,2012-01-14,Spring,2012,Jan,1,0,Saturday,0,Clear,0.16,0.1515,0.47,0.194,6,44,50,352,50,50
8958,2012-01-14,Spring,2012,Jan,2,0,Saturday,0,Clear,0.16,0.1667,0.47,0.1642,6,32,38,352,38,38
8959,2012-01-14,Spring,2012,Jan,3,0,Saturday,0,Clear,0.14,0.1667,0.54,0.1045,6,14,20,352,20,20
8960,2012-01-14,Spring,2012,Jan,4,0,Saturday,0,Clear,0.14,0.1515,0.5,0.1343,0,3,3,352,3,3
8961,2012-01-14,Spring,2012,Jan,5,0,Saturday,0,Clear,0.14,0.1515,0.5,0.1343,0,4,4,352,4,4
8962,2012-01-14,Spring,2012,Jan,6,0,Saturday,0,Clear,0.14,0.1515,0.5,0.0,0,5,5,352,5,5
8963,2012-01-14,Spring,2012,Jan,7,0,Saturday,0,Clear,0.14,0.1515,0.5,0.1343,0,24,24,352,24,24
8964,2012-01-14,Spring,2012,Jan,8,0,Saturday,0,Clear,0.12,0.1515,0.54,0.1045,3,89,92,352,92,92
8965,2012-01-14,Spring,2012,Jan,9,0,Saturday,0,Clear,0.14,0.1667,0.5,0.1045,3,78,81,352,81,81
8966,2012-01-14,Spring,2012,Jan,10,0,Saturday,0,Clear,0.16,0.2273,0.47,0.0,14,135,149,352,149,149
8967,2012-01-14,Spring,2012,Jan,11,0,Saturday,0,Clear,0.2,0.197,0.4,0.194,28,150,178,352,178,178
8968,2012-01-14,Spring,2012,Jan,12,0,Saturday,0,Clear,0.22,0.2121,0.41,0.2537,30,189,219,352,219,219
8969,2012-01-14,Spring,2012,Jan,13,0,Saturday,0,Clear,0.22,0.2121,0.44,0.2836,38,182,220,352,220,220
8970,2012-01-14,Spring,2012,Jan,14,0,Saturday,0,Clear,0.24,0.2121,0.41,0.2985,52,179,231,352,231,231
8971,2012-01-14,Spring,2012,Jan,15,0,Saturday,0,Clear,0.24,0.2121,0.38,0.2985,49,177,226,352,226,226
8972,2012-01-14,Spring,2012,Jan,16,0,Saturday,0,Clear,0.24,0.2273,0.38,0.2239,28,178,206,352,206,206
8973,2012-01-14,Spring,2012,Jan,17,0,Saturday,0,Clear,0.24,0.2273,0.41,0.2537,15,129,144,352,144,144
8974,2012-01-14,Spring,2012,Jan,18,0,Saturday,0,Clear,0.22,0.2273,0.41,0.194,21,122,143,352,143,143
8975,2012-01-14,Spring,2012,Jan,19,0,Saturday,0,Clear,0.2,0.197,0.47,0.2239,12,90,102,352,102,102
8976,2012-01-14,Spring,2012,Jan,20,0,Saturday,0,Clear,0.2,0.197,0.44,0.2537,8,95,103,352,103,103
8977,2012-01-14,Spring,2012,Jan,21,0,Saturday,0,Clear,0.18,0.1667,0.43,0.2537,3,66,69,352,69,69
8978,2012-01-14,Spring,2012,Jan,22,0,Saturday,0,Clear,0.16,0.1364,0.47,0.3582,4,62,66,352,66,66
8979,2012-01-14,Spring,2012,Jan,23,0,Saturday,0,Clear,0.16,0.1515,0.47,0.2239,5,71,76,352,76,76
8980,2012-01-15,Spring,2012,Jan,0,0,Sunday,0,Clear,0.16,0.1364,0.47,0.3284,9,50,59,351,59,59
8981,2012-01-15,Spring,2012,Jan,1,0,Sunday,0,Misty,0.16,0.1364,0.47,0.2985,2,40,42,351,42,42
8982,2012-01-15,Spring,2012,Jan,2,0,Sunday,0,Misty,0.16,0.1364,0.47,0.2836,5,38,43,351,43,43
8983,2012-01-15,Spring,2012,Jan,3,0,Sunday,0,Misty,0.16,0.1364,0.48,0.3881,1,24,25,351,25,25
8984,2012-01-15,Spring,2012,Jan,4,0,Sunday,0,Misty,0.16,0.1364,0.47,0.3881,1,5,6,351,6,6
8985,2012-01-15,Spring,2012,Jan,5,0,Sunday,0,Misty,0.16,0.1364,0.47,0.3284,0,5,5,351,5,5
8986,2012-01-15,Spring,2012,Jan,6,0,Sunday,0,Misty,0.14,0.1212,0.5,0.2836,1,7,8,351,8,8
8987,2012-01-15,Spring,2012,Jan,7,0,Sunday,0,Clear,0.12,0.1212,0.54,0.2836,3,14,17,351,17,17
8988,2012-01-15,Spring,2012,Jan,8,0,Sunday,0,Clear,0.12,0.1212,0.54,0.2239,2,34,36,351,36,36
8989,2012-01-15,Spring,2012,Jan,9,0,Sunday,0,Clear,0.12,0.1364,0.54,0.194,10,80,90,351,90,90
8990,2012-01-15,Spring,2012,Jan,10,0,Sunday,0,Clear,0.14,0.1212,0.54,0.2836,11,115,126,351,126,126
8991,2012-01-15,Spring,2012,Jan,11,0,Sunday,0,Clear,0.16,0.1515,0.47,0.2239,21,144,165,351,165,165
8992,2012-01-15,Spring,2012,Jan,12,0,Sunday,0,Clear,0.18,0.1667,0.4,0.2985,42,192,234,351,234,234
8993,2012-01-15,Spring,2012,Jan,13,0,Sunday,0,Clear,0.2,0.1818,0.34,0.2836,40,184,224,351,224,224
8994,2012-01-15,Spring,2012,Jan,14,0,Sunday,0,Clear,0.2,0.1818,0.32,0.3582,25,163,188,351,188,188
8995,2012-01-15,Spring,2012,Jan,15,0,Sunday,0,Clear,0.22,0.2273,0.27,0.194,33,173,206,351,206,206
8996,2012-01-15,Spring,2012,Jan,16,0,Sunday,0,Clear,0.22,0.2121,0.29,0.2985,31,174,205,351,205,205
8997,2012-01-15,Spring,2012,Jan,17,0,Sunday,0,Clear,0.22,0.2121,0.25,0.2537,15,131,146,351,146,146
8998,2012-01-15,Spring,2012,Jan,18,0,Sunday,0,Clear,0.18,0.1818,0.29,0.2239,7,113,120,351,120,120
8999,2012-01-15,Spring,2012,Jan,19,0,Sunday,0,Clear,0.16,0.1667,0.37,0.1642,9,101,110,351,110,110
9000,2012-01-15,Spring,2012,Jan,20,0,Sunday,0,Clear,0.16,0.1818,0.37,0.1045,10,85,95,351,95,95
9001,2012-01-15,Spring,2012,Jan,21,0,Sunday,0,Clear,0.16,0.1667,0.4,0.1642,1,71,72,351,72,72
9002,2012-01-15,Spring,2012,Jan,22,0,Sunday,0,Clear,0.18,0.2121,0.37,0.0896,2,58,60,351,60,60
9003,2012-01-15,Spring,2012,Jan,23,0,Sunday,0,Clear,0.16,0.197,0.43,0.0896,3,26,29,351,29,29
9004,2012-01-16,Spring,2012,Jan,0,1,Monday,0,Clear,0.14,0.1515,0.46,0.1343,2,23,25,350,25,25
9005,2012-01-16,Spring,2012,Jan,1,1,Monday,0,Clear,0.14,0.1667,0.43,0.1045,2,18,20,350,20,20
9006,2012-01-16,Spring,2012,Jan,2,1,Monday,0,Clear,0.14,0.2121,0.46,0.0,3,14,17,350,17,17
9007,2012-01-16,Spring,2012,Jan,3,1,Monday,0,Clear,0.12,0.197,0.5,0.0,0,3,3,350,3,3
9008,2012-01-16,Spring,2012,Jan,4,1,Monday,0,Clear,0.12,0.1515,0.58,0.1045,2,6,8,350,8,8
9009,2012-01-16,Spring,2012,Jan,5,1,Monday,0,Clear,0.12,0.1667,0.54,0.0896,1,5,6,350,6,6
9010,2012-01-16,Spring,2012,Jan,6,1,Monday,0,Clear,0.1,0.1364,0.54,0.0896,0,13,13,350,13,13
9011,2012-01-16,Spring,2012,Jan,7,1,Monday,0,Clear,0.1,0.1364,0.54,0.1045,5,28,33,350,33,33
9012,2012-01-16,Spring,2012,Jan,8,1,Monday,0,Clear,0.1,0.1212,0.58,0.1642,3,75,78,350,78,78
9013,2012-01-16,Spring,2012,Jan,9,1,Monday,0,Clear,0.1,0.1212,0.58,0.1642,7,89,96,350,96,96
9014,2012-01-16,Spring,2012,Jan,10,1,Monday,0,Misty,0.14,0.1364,0.59,0.194,19,107,126,350,126,126
9015,2012-01-16,Spring,2012,Jan,11,1,Monday,0,Clear,0.16,0.1515,0.59,0.2537,21,158,179,350,179,179
9016,2012-01-16,Spring,2012,Jan,12,1,Monday,0,Clear,0.2,0.1818,0.55,0.3284,20,165,185,350,185,185
9017,2012-01-16,Spring,2012,Jan,13,1,Monday,0,Misty,0.24,0.197,0.41,0.4179,26,202,228,350,228,228
9018,2012-01-16,Spring,2012,Jan,14,1,Monday,0,Clear,0.24,0.2121,0.44,0.3881,23,158,181,350,181,181
9019,2012-01-16,Spring,2012,Jan,15,1,Monday,0,Clear,0.26,0.2121,0.44,0.4478,17,175,192,350,192,192
9020,2012-01-16,Spring,2012,Jan,16,1,Monday,0,Clear,0.26,0.2273,0.44,0.3582,22,158,180,350,180,180
9021,2012-01-16,Spring,2012,Jan,17,1,Monday,0,Clear,0.26,0.2273,0.48,0.3284,19,174,193,350,193,193
9022,2012-01-16,Spring,2012,Jan,18,1,Monday,0,Clear,0.26,0.2273,0.52,0.3284,6,175,181,350,181,181
9023,2012-01-16,Spring,2012,Jan,19,1,Monday,0,Clear,0.26,0.2424,0.56,0.2836,10,134,144,350,144,144
9024,2012-01-16,Spring,2012,Jan,20,1,Monday,0,Clear,0.26,0.2424,0.6,0.2836,2,88,90,350,90,90
9025,2012-01-16,Spring,2012,Jan,21,1,Monday,0,Clear,0.28,0.2576,0.52,0.3284,3,46,49,350,49,49
9026,2012-01-16,Spring,2012,Jan,22,1,Monday,0,Misty,0.3,0.2727,0.49,0.3582,4,39,43,350,43,43
9027,2012-01-16,Spring,2012,Jan,23,1,Monday,0,Light_rainsnow,0.26,0.2273,0.7,0.2985,0,28,28,350,28,28
9028,2012-01-17,Spring,2012,Jan,0,0,Tuesday,1,Misty,0.26,0.2273,0.7,0.3284,0,12,12,349,12,12
9029,2012-01-17,Spring,2012,Jan,1,0,Tuesday,1,Misty,0.28,0.2576,0.65,0.3582,0,2,2,349,2,2
9030,2012-01-17,Spring,2012,Jan,2,0,Tuesday,1,Light_rainsnow,0.28,0.2727,0.75,0.2537,0,12,12,349,12,12
9031,2012-01-17,Spring,2012,Jan,4,0,Tuesday,1,Light_rainsnow,0.32,0.303,0.66,0.3284,0,2,2,349,2,2
9032,2012-01-17,Spring,2012,Jan,5,0,Tuesday,1,Light_rainsnow,0.32,0.303,0.66,0.3284,0,13,13,349,13,13
9033,2012-01-17,Spring,2012,Jan,6,0,Tuesday,1,Light_rainsnow,0.3,0.2879,0.75,0.2537,0,57,57,349,57,57
9034,2012-01-17,Spring,2012,Jan,7,0,Tuesday,1,Light_rainsnow,0.3,0.2879,0.81,0.2239,5,121,126,349,126,126
9035,2012-01-17,Spring,2012,Jan,8,0,Tuesday,1,Light_rainsnow,0.3,0.2879,0.81,0.2836,3,90,93,349,93,93
9036,2012-01-17,Spring,2012,Jan,9,0,Tuesday,1,Light_rainsnow,0.32,0.303,0.81,0.2537,7,61,68,349,68,68
9037,2012-01-17,Spring,2012,Jan,10,0,Tuesday,1,Light_rainsnow,0.3,0.2879,0.87,0.2537,1,61,62,349,62,62
9038,2012-01-17,Spring,2012,Jan,11,0,Tuesday,1,Misty,0.34,0.3485,0.87,0.1045,2,73,75,349,75,75
9039,2012-01-17,Spring,2012,Jan,12,0,Tuesday,1,Misty,0.32,0.303,0.87,0.2836,3,83,86,349,86,86
9040,2012-01-17,Spring,2012,Jan,13,0,Tuesday,1,Misty,0.38,0.3939,0.76,0.3284,8,95,103,349,103,103
9041,2012-01-17,Spring,2012,Jan,14,0,Tuesday,1,Clear,0.44,0.4394,0.62,0.4925,12,120,132,349,132,132
9042,2012-01-17,Spring,2012,Jan,15,0,Tuesday,1,Clear,0.44,0.4394,0.62,0.4925,6,123,129,349,129,129
9043,2012-01-17,Spring,2012,Jan,16,0,Tuesday,1,Clear,0.46,0.4545,0.63,0.5522,14,205,219,349,219,219
9044,2012-01-17,Spring,2012,Jan,17,0,Tuesday,1,Clear,0.46,0.4545,0.63,0.4478,20,442,462,349,462,462
9045,2012-01-17,Spring,2012,Jan,18,0,Tuesday,1,Clear,0.46,0.4545,0.63,0.4478,12,451,463,349,463,463
9046,2012-01-17,Spring,2012,Jan,19,0,Tuesday,1,Clear,0.46,0.4545,0.63,0.4179,11,297,308,349,308,308
9047,2012-01-17,Spring,2012,Jan,20,0,Tuesday,1,Clear,0.46,0.4545,0.63,0.3582,11,169,180,349,180,180
9048,2012-01-17,Spring,2012,Jan,21,0,Tuesday,1,Clear,0.46,0.4545,0.67,0.4627,6,174,180,349,180,180
9049,2012-01-17,Spring,2012,Jan,22,0,Tuesday,1,Clear,0.46,0.4545,0.72,0.3881,5,85,90,349,90,90
9050,2012-01-17,Spring,2012,Jan,23,0,Tuesday,1,Clear,0.46,0.4545,0.72,0.3881,1,60,61,349,61,61
9051,2012-01-18,Spring,2012,Jan,0,0,Wednesday,1,Misty,0.46,0.4545,0.77,0.3284,3,14,17,348,17,17
9052,2012-01-18,Spring,2012,Jan,1,0,Wednesday,1,Misty,0.46,0.4545,0.77,0.3284,0,10,10,348,10,10
9053,2012-01-18,Spring,2012,Jan,2,0,Wednesday,1,Misty,0.44,0.4394,0.51,0.4925,1,1,2,348,2,2
9054,2012-01-18,Spring,2012,Jan,3,0,Wednesday,1,Misty,0.44,0.4394,0.51,0.4925,1,3,4,348,4,4
9055,2012-01-18,Spring,2012,Jan,4,0,Wednesday,1,Clear,0.34,0.2879,0.46,0.5224,0,1,1,348,1,1
9056,2012-01-18,Spring,2012,Jan,5,0,Wednesday,1,Clear,0.34,0.2879,0.46,0.5224,0,29,29,348,29,29
9057,2012-01-18,Spring,2012,Jan,6,0,Wednesday,1,Clear,0.34,0.2879,0.36,0.5224,0,88,88,348,88,88
9058,2012-01-18,Spring,2012,Jan,7,0,Wednesday,1,Clear,0.32,0.2879,0.42,0.3582,1,262,263,348,263,263
9059,2012-01-18,Spring,2012,Jan,8,0,Wednesday,1,Clear,0.3,0.2727,0.52,0.4179,15,474,489,348,489,489
9060,2012-01-18,Spring,2012,Jan,9,0,Wednesday,1,Clear,0.28,0.2576,0.52,0.3284,6,196,202,348,202,202
9061,2012-01-18,Spring,2012,Jan,10,0,Wednesday,1,Clear,0.3,0.2727,0.42,0.4627,5,88,93,348,93,93
9062,2012-01-18,Spring,2012,Jan,11,0,Wednesday,1,Clear,0.3,0.2727,0.42,0.3881,4,110,114,348,114,114
9063,2012-01-18,Spring,2012,Jan,12,0,Wednesday,1,Clear,0.3,0.2576,0.39,0.4925,6,155,161,348,161,161
9064,2012-01-18,Spring,2012,Jan,13,0,Wednesday,1,Clear,0.3,0.2727,0.42,0.4627,6,124,130,348,130,130
9065,2012-01-18,Spring,2012,Jan,14,0,Wednesday,1,Clear,0.3,0.2727,0.33,0.3881,7,98,105,348,105,105
9066,2012-01-18,Spring,2012,Jan,15,0,Wednesday,1,Clear,0.3,0.2576,0.33,0.5224,8,122,130,348,130,130
9067,2012-01-18,Spring,2012,Jan,16,0,Wednesday,1,Clear,0.28,0.2273,0.3,0.5224,13,163,176,348,176,176
9068,2012-01-18,Spring,2012,Jan,17,0,Wednesday,1,Clear,0.26,0.2121,0.33,0.4478,8,338,346,348,346,346
9069,2012-01-18,Spring,2012,Jan,18,0,Wednesday,1,Clear,0.24,0.2121,0.32,0.3582,8,347,355,348,355,355
9070,2012-01-18,Spring,2012,Jan,19,0,Wednesday,1,Clear,0.22,0.197,0.37,0.3881,5,251,256,348,256,256
9071,2012-01-18,Spring,2012,Jan,20,0,Wednesday,1,Clear,0.22,0.2121,0.37,0.2537,1,164,165,348,165,165
9072,2012-01-18,Spring,2012,Jan,21,0,Wednesday,1,Clear,0.2,0.1667,0.4,0.4179,5,119,124,348,124,124
9073,2012-01-18,Spring,2012,Jan,22,0,Wednesday,1,Clear,0.18,0.1667,0.47,0.2537,4,74,78,348,78,78
9074,2012-01-18,Spring,2012,Jan,23,0,Wednesday,1,Clear,0.16,0.1364,0.47,0.2985,2,36,38,348,38,38
9075,2012-01-19,Spring,2012,Jan,0,0,Thursday,1,Clear,0.14,0.1364,0.5,0.194,0,16,16,347,16,16
9076,2012-01-19,Spring,2012,Jan,1,0,Thursday,1,Clear,0.14,0.1515,0.5,0.1642,0,5,5,347,5,5
9077,2012-01-19,Spring,2012,Jan,2,0,Thursday,1,Clear,0.14,0.1515,0.5,0.1343,0,3,3,347,3,3
9078,2012-01-19,Spring,2012,Jan,3,0,Thursday,1,Clear,0.12,0.1515,0.54,0.1045,0,4,4,347,4,4
9079,2012-01-19,Spring,2012,Jan,4,0,Thursday,1,Clear,0.12,0.1515,0.54,0.1045,0,1,1,347,1,1
9080,2012-01-19,Spring,2012,Jan,5,0,Thursday,1,Clear,0.12,0.1212,0.55,0.2537,0,19,19,347,19,19
9081,2012-01-19,Spring,2012,Jan,6,0,Thursday,1,Clear,0.12,0.1364,0.54,0.1642,0,86,86,347,86,86
9082,2012-01-19,Spring,2012,Jan,7,0,Thursday,1,Clear,0.12,0.1667,0.54,0.0896,2,204,206,347,206,206
9083,2012-01-19,Spring,2012,Jan,8,0,Thursday,1,Clear,0.12,0.1515,0.54,0.1045,9,414,423,347,423,423
9084,2012-01-19,Spring,2012,Jan,9,0,Thursday,1,Clear,0.12,0.197,0.54,0.0,6,204,210,347,210,210
9085,2012-01-19,Spring,2012,Jan,10,0,Thursday,1,Clear,0.14,0.2121,0.59,0.0,10,98,108,347,108,108
9086,2012-01-19,Spring,2012,Jan,11,0,Thursday,1,Clear,0.16,0.1667,0.55,0.1642,6,93,99,347,99,99
9087,2012-01-19,Spring,2012,Jan,12,0,Thursday,1,Clear,0.2,0.197,0.51,0.194,5,106,111,347,111,111
9088,2012-01-19,Spring,2012,Jan,13,0,Thursday,1,Clear,0.22,0.2121,0.47,0.2836,6,118,124,347,124,124
9089,2012-01-19,Spring,2012,Jan,14,0,Thursday,1,Clear,0.24,0.2273,0.44,0.194,15,104,119,347,119,119
9090,2012-01-19,Spring,2012,Jan,15,0,Thursday,1,Clear,0.26,0.2273,0.44,0.2985,9,118,127,347,127,127
9091,2012-01-19,Spring,2012,Jan,16,0,Thursday,1,Clear,0.26,0.2273,0.41,0.3284,8,185,193,347,193,193
9092,2012-01-19,Spring,2012,Jan,17,0,Thursday,1,Misty,0.26,0.2273,0.44,0.3284,21,364,385,347,385,385
9093,2012-01-19,Spring,2012,Jan,18,0,Thursday,1,Misty,0.26,0.2273,0.44,0.3284,16,345,361,347,361,361
9094,2012-01-19,Spring,2012,Jan,19,0,Thursday,1,Misty,0.26,0.2273,0.48,0.2985,5,229,234,347,234,234
9095,2012-01-19,Spring,2012,Jan,20,0,Thursday,1,Clear,0.26,0.2121,0.52,0.4478,7,184,191,347,191,191
9096,2012-01-19,Spring,2012,Jan,21,0,Thursday,1,Clear,0.26,0.2273,0.44,0.3582,4,117,121,347,121,121
9097,2012-01-19,Spring,2012,Jan,22,0,Thursday,1,Misty,0.26,0.2273,0.44,0.4179,0,90,90,347,90,90
9098,2012-01-19,Spring,2012,Jan,23,0,Thursday,1,Clear,0.26,0.2273,0.48,0.3284,1,55,56,347,56,56
9099,2012-01-20,Spring,2012,Jan,0,0,Friday,1,Misty,0.26,0.2273,0.48,0.2985,3,24,27,346,27,27
9100,2012-01-20,Spring,2012,Jan,1,0,Friday,1,Clear,0.26,0.2727,0.48,0.1343,0,15,15,346,15,15
9101,2012-01-20,Spring,2012,Jan,2,0,Friday,1,Clear,0.26,0.2727,0.48,0.1343,0,11,11,346,11,11
9102,2012-01-20,Spring,2012,Jan,3,0,Friday,1,Clear,0.24,0.2576,0.52,0.1045,0,4,4,346,4,4
9103,2012-01-20,Spring,2012,Jan,4,0,Friday,1,Clear,0.22,0.2424,0.6,0.1045,0,3,3,346,3,3
9104,2012-01-20,Spring,2012,Jan,5,0,Friday,1,Clear,0.22,0.2424,0.6,0.1045,0,19,19,346,19,19
9105,2012-01-20,Spring,2012,Jan,6,0,Friday,1,Clear,0.24,0.2121,0.6,0.2836,0,68,68,346,68,68
9106,2012-01-20,Spring,2012,Jan,7,0,Friday,1,Clear,0.22,0.2121,0.69,0.2239,2,183,185,346,185,185
9107,2012-01-20,Spring,2012,Jan,8,0,Friday,1,Clear,0.22,0.2121,0.64,0.2537,4,421,425,346,425,425
9108,2012-01-20,Spring,2012,Jan,9,0,Friday,1,Clear,0.22,0.197,0.47,0.3881,21,242,263,346,263,263
9109,2012-01-20,Spring,2012,Jan,10,0,Friday,1,Misty,0.22,0.2121,0.44,0.2836,1,96,97,346,97,97
9110,2012-01-20,Spring,2012,Jan,11,0,Friday,1,Misty,0.2,0.1818,0.32,0.3582,6,117,123,346,123,123
9111,2012-01-20,Spring,2012,Jan,12,0,Friday,1,Misty,0.2,0.1818,0.34,0.3284,5,119,124,346,124,124
9112,2012-01-20,Spring,2012,Jan,13,0,Friday,1,Clear,0.22,0.2121,0.32,0.2985,12,144,156,346,156,156
9113,2012-01-20,Spring,2012,Jan,14,0,Friday,1,Misty,0.22,0.2121,0.35,0.2985,8,107,115,346,115,115
9114,2012-01-20,Spring,2012,Jan,15,0,Friday,1,Misty,0.22,0.2273,0.35,0.194,12,144,156,346,156,156
9115,2012-01-20,Spring,2012,Jan,16,0,Friday,1,Misty,0.2,0.2121,0.37,0.1642,11,163,174,346,174,174
9116,2012-01-20,Spring,2012,Jan,17,0,Friday,1,Misty,0.22,0.2576,0.32,0.0896,9,340,349,346,349,349
9117,2012-01-20,Spring,2012,Jan,18,0,Friday,1,Misty,0.2,0.2273,0.34,0.0896,5,296,301,346,301,301
9118,2012-01-20,Spring,2012,Jan,19,0,Friday,1,Misty,0.2,0.2273,0.37,0.1045,6,186,192,346,192,192
9119,2012-01-20,Spring,2012,Jan,20,0,Friday,1,Misty,0.2,0.2273,0.34,0.0896,1,141,142,346,142,142
9120,2012-01-20,Spring,2012,Jan,21,0,Friday,1,Misty,0.2,0.2273,0.37,0.0896,5,99,104,346,104,104
9121,2012-01-20,Spring,2012,Jan,22,0,Friday,1,Misty,0.2,0.197,0.37,0.2239,1,71,72,346,72,72
9122,2012-01-20,Spring,2012,Jan,23,0,Friday,1,Light_rainsnow,0.16,0.1515,0.64,0.2239,3,35,38,346,38,38
9123,2012-01-21,Spring,2012,Jan,0,0,Saturday,0,Light_rainsnow,0.16,0.1515,0.64,0.2239,0,24,24,345,24,24
9124,2012-01-21,Spring,2012,Jan,1,0,Saturday,0,Heavy_rainsnow,0.14,0.1364,0.86,0.194,1,22,23,345,23,23
9125,2012-01-21,Spring,2012,Jan,2,0,Saturday,0,Light_rainsnow,0.14,0.2121,0.86,0.0,1,25,26,345,26,26
9126,2012-01-21,Spring,2012,Jan,3,0,Saturday,0,Light_rainsnow,0.14,0.1818,0.93,0.0896,0,13,13,345,13,13
9127,2012-01-21,Spring,2012,Jan,4,0,Saturday,0,Light_rainsnow,0.16,0.197,0.86,0.0896,0,1,1,345,1,1
9128,2012-01-21,Spring,2012,Jan,5,0,Saturday,0,Light_rainsnow,0.16,0.1818,0.86,0.1045,0,2,2,345,2,2
9129,2012-01-21,Spring,2012,Jan,6,0,Saturday,0,Light_rainsnow,0.16,0.1667,0.93,0.1642,0,1,1,345,1,1
9130,2012-01-21,Spring,2012,Jan,7,0,Saturday,0,Light_rainsnow,0.16,0.1667,0.93,0.1642,3,10,13,345,13,13
9131,2012-01-21,Spring,2012,Jan,8,0,Saturday,0,Misty,0.16,0.1515,0.93,0.2537,3,22,25,345,25,25
9132,2012-01-21,Spring,2012,Jan,9,0,Saturday,0,Misty,0.16,0.1515,0.93,0.2537,2,40,42,345,42,42
9133,2012-01-21,Spring,2012,Jan,10,0,Saturday,0,Light_rainsnow,0.16,0.1515,0.93,0.2537,0,45,45,345,45,45
9134,2012-01-21,Spring,2012,Jan,11,0,Saturday,0,Misty,0.18,0.2121,0.86,0.1045,1,62,63,345,63,63
9135,2012-01-21,Spring,2012,Jan,12,0,Saturday,0,Misty,0.2,0.2121,0.8,0.1642,5,62,67,345,67,67
9136,2012-01-21,Spring,2012,Jan,13,0,Saturday,0,Misty,0.2,0.197,0.8,0.2537,10,66,76,345,76,76
9137,2012-01-21,Spring,2012,Jan,14,0,Saturday,0,Light_rainsnow,0.2,0.197,0.8,0.194,6,89,95,345,95,95
9138,2012-01-21,Spring,2012,Jan,15,0,Saturday,0,Light_rainsnow,0.2,0.197,0.8,0.194,6,113,119,345,119,119
9139,2012-01-21,Spring,2012,Jan,16,0,Saturday,0,Misty,0.2,0.1818,0.8,0.2985,5,113,118,345,118,118
9140,2012-01-21,Spring,2012,Jan,17,0,Saturday,0,Misty,0.2,0.1818,0.8,0.3881,7,99,106,345,106,106
9141,2012-01-21,Spring,2012,Jan,18,0,Saturday,0,Misty,0.2,0.1818,0.75,0.3881,3,107,110,345,110,110
9142,2012-01-21,Spring,2012,Jan,19,0,Saturday,0,Misty,0.18,0.1515,0.8,0.3881,0,85,85,345,85,85
9143,2012-01-21,Spring,2012,Jan,20,0,Saturday,0,Misty,0.18,0.1667,0.8,0.2985,5,62,67,345,67,67
9144,2012-01-21,Spring,2012,Jan,21,0,Saturday,0,Clear,0.18,0.1515,0.74,0.3284,5,64,69,345,69,69
9145,2012-01-21,Spring,2012,Jan,22,0,Saturday,0,Misty,0.18,0.1667,0.74,0.2985,3,56,59,345,59,59
9146,2012-01-21,Spring,2012,Jan,23,0,Saturday,0,Misty,0.16,0.1515,0.8,0.2537,1,51,52,345,52,52
9147,2012-01-22,Spring,2012,Jan,0,0,Sunday,0,Clear,0.16,0.1364,0.8,0.2985,1,51,52,344,52,52
9148,2012-01-22,Spring,2012,Jan,1,0,Sunday,0,Misty,0.18,0.1667,0.74,0.2985,1,49,50,344,50,50
9149,2012-01-22,Spring,2012,Jan,2,0,Sunday,0,Misty,0.18,0.1667,0.74,0.2836,1,46,47,344,47,47
9150,2012-01-22,Spring,2012,Jan,3,0,Sunday,0,Misty,0.18,0.1667,0.69,0.2836,1,20,21,344,21,21
9151,2012-01-22,Spring,2012,Jan,4,0,Sunday,0,Light_rainsnow,0.16,0.1364,0.8,0.2836,1,1,2,344,2,2
9152,2012-01-22,Spring,2012,Jan,5,0,Sunday,0,Light_rainsnow,0.16,0.1515,0.74,0.2239,1,2,3,344,3,3
9153,2012-01-22,Spring,2012,Jan,6,0,Sunday,0,Misty,0.16,0.1515,0.74,0.2239,0,4,4,344,4,4
9154,2012-01-22,Spring,2012,Jan,7,0,Sunday,0,Misty,0.16,0.1515,0.74,0.2239,2,11,13,344,13,13
9155,2012-01-22,Spring,2012,Jan,8,0,Sunday,0,Misty,0.16,0.1515,0.74,0.2239,3,29,32,344,32,32
9156,2012-01-22,Spring,2012,Jan,9,0,Sunday,0,Misty,0.16,0.1515,0.74,0.2239,9,54,63,344,63,63
9157,2012-01-22,Spring,2012,Jan,10,0,Sunday,0,Misty,0.16,0.1364,0.74,0.2836,9,120,129,344,129,129
9158,2012-01-22,Spring,2012,Jan,11,0,Sunday,0,Light_rainsnow,0.16,0.1515,0.8,0.2537,18,115,133,344,133,133
9159,2012-01-22,Spring,2012,Jan,12,0,Sunday,0,Misty,0.16,0.1515,0.8,0.2239,24,161,185,344,185,185
9160,2012-01-22,Spring,2012,Jan,13,0,Sunday,0,Misty,0.16,0.1818,0.8,0.1343,24,175,199,344,199,199
9161,2012-01-22,Spring,2012,Jan,14,0,Sunday,0,Misty,0.16,0.1667,0.8,0.1642,19,163,182,344,182,182
9162,2012-01-22,Spring,2012,Jan,15,0,Sunday,0,Misty,0.16,0.1515,0.8,0.194,27,149,176,344,176,176
9163,2012-01-22,Spring,2012,Jan,16,0,Sunday,0,Misty,0.16,0.1515,0.8,0.194,12,143,155,344,155,155
9164,2012-01-22,Spring,2012,Jan,17,0,Sunday,0,Misty,0.16,0.1818,0.8,0.1045,8,100,108,344,108,108
9165,2012-01-22,Spring,2012,Jan,18,0,Sunday,0,Light_rainsnow,0.16,0.1818,0.86,0.1045,11,110,121,344,121,121
9166,2012-01-22,Spring,2012,Jan,19,0,Sunday,0,Light_rainsnow,0.16,0.1818,0.86,0.1045,9,80,89,344,89,89
9167,2012-01-22,Spring,2012,Jan,20,0,Sunday,0,Light_rainsnow,0.16,0.1667,0.86,0.1642,5,69,74,344,74,74
9168,2012-01-22,Spring,2012,Jan,21,0,Sunday,0,Light_rainsnow,0.16,0.1818,0.86,0.1045,8,36,44,344,44,44
9169,2012-01-22,Spring,2012,Jan,22,0,Sunday,0,Misty,0.16,0.197,0.93,0.0896,0,58,58,344,58,58
9170,2012-01-22,Spring,2012,Jan,23,0,Sunday,0,Misty,0.16,0.1818,0.93,0.1045,2,35,37,344,37,37
9171,2012-01-23,Spring,2012,Jan,0,0,Monday,1,Misty,0.18,0.2424,0.86,0.0,2,17,19,343,19,19
9172,2012-01-23,Spring,2012,Jan,1,0,Monday,1,Misty,0.18,0.2121,0.86,0.1045,0,4,4,343,4,4
9173,2012-01-23,Spring,2012,Jan,2,0,Monday,1,Misty,0.18,0.2121,0.86,0.1045,0,2,2,343,2,2
9174,2012-01-23,Spring,2012,Jan,3,0,Monday,1,Misty,0.18,0.2424,0.86,0.0,0,1,1,343,1,1
9175,2012-01-23,Spring,2012,Jan,4,0,Monday,1,Misty,0.2,0.2576,0.8,0.0,0,1,1,343,1,1
9176,2012-01-23,Spring,2012,Jan,5,0,Monday,1,Misty,0.2,0.2576,0.86,0.0,0,19,19,343,19,19
9177,2012-01-23,Spring,2012,Jan,6,0,Monday,1,Misty,0.2,0.2576,0.86,0.0,6,36,42,343,42,42
9178,2012-01-23,Spring,2012,Jan,7,0,Monday,1,Light_rainsnow,0.2,0.2576,0.86,0.0,8,114,122,343,122,122
9179,2012-01-23,Spring,2012,Jan,8,0,Monday,1,Light_rainsnow,0.2,0.2121,0.86,0.1343,5,267,272,343,272,272
9180,2012-01-23,Spring,2012,Jan,9,0,Monday,1,Misty,0.2,0.2273,0.86,0.0896,13,198,211,343,211,211
9181,2012-01-23,Spring,2012,Jan,10,0,Monday,1,Misty,0.2,0.2576,0.93,0.0,10,139,149,343,149,149
9182,2012-01-23,Spring,2012,Jan,11,0,Monday,1,Misty,0.2,0.2273,0.93,0.0896,5,57,62,343,62,62
9183,2012-01-23,Spring,2012,Jan,12,0,Monday,1,Misty,0.22,0.2727,0.93,0.0,10,52,62,343,62,62
9184,2012-01-23,Spring,2012,Jan,13,0,Monday,1,Light_rainsnow,0.22,0.2576,0.93,0.0896,5,32,37,343,37,37
9185,2012-01-23,Spring,2012,Jan,14,0,Monday,1,Light_rainsnow,0.22,0.2273,0.93,0.194,13,48,61,343,61,61
9186,2012-01-23,Spring,2012,Jan,15,0,Monday,1,Misty,0.22,0.2121,1.0,0.2239,10,64,74,343,74,74
9187,2012-01-23,Spring,2012,Jan,16,0,Monday,1,Misty,0.24,0.2424,0.93,0.1642,14,108,122,343,122,122
9188,2012-01-23,Spring,2012,Jan,17,0,Monday,1,Misty,0.24,0.2576,0.96,0.1045,6,270,276,343,276,276
9189,2012-01-23,Spring,2012,Jan,18,0,Monday,1,Misty,0.24,0.2424,0.93,0.1343,7,275,282,343,282,282
9190,2012-01-23,Spring,2012,Jan,19,0,Monday,1,Misty,0.26,0.2576,0.93,0.1642,9,211,220,343,220,220
9191,2012-01-23,Spring,2012,Jan,20,0,Monday,1,Misty,0.26,0.2576,1.0,0.1642,8,161,169,343,169,169
9192,2012-01-23,Spring,2012,Jan,21,0,Monday,1,Misty,0.26,0.2424,1.0,0.2836,8,112,120,343,120,120
9193,2012-01-23,Spring,2012,Jan,22,0,Monday,1,Misty,0.26,0.2424,1.0,0.2836,4,64,68,343,68,68
9194,2012-01-23,Spring,2012,Jan,23,0,Monday,1,Misty,0.28,0.2576,0.93,0.3284,2,35,37,343,37,37
9195,2012-01-24,Spring,2012,Jan,0,0,Tuesday,1,Misty,0.3,0.2879,1.0,0.2836,6,19,25,342,25,25
9196,2012-01-24,Spring,2012,Jan,1,0,Tuesday,1,Misty,0.32,0.303,0.93,0.2537,2,7,9,342,9,9
9197,2012-01-24,Spring,2012,Jan,2,0,Tuesday,1,Misty,0.32,0.303,0.93,0.2239,2,6,8,342,8,8
9198,2012-01-24,Spring,2012,Jan,3,0,Tuesday,1,Misty,0.32,0.3333,0.93,0.1343,0,3,3,342,3,3
9199,2012-01-24,Spring,2012,Jan,4,0,Tuesday,1,Misty,0.3,0.3182,1.0,0.0896,0,2,2,342,2,2
9200,2012-01-24,Spring,2012,Jan,5,0,Tuesday,1,Misty,0.3,0.3182,1.0,0.0896,0,26,26,342,26,26
9201,2012-01-24,Spring,2012,Jan,6,0,Tuesday,1,Misty,0.32,0.3182,0.93,0.194,1,88,89,342,89,89
9202,2012-01-24,Spring,2012,Jan,7,0,Tuesday,1,Misty,0.32,0.3333,0.93,0.1343,11,221,232,342,232,232
9203,2012-01-24,Spring,2012,Jan,8,0,Tuesday,1,Misty,0.32,0.3333,0.93,0.1343,11,479,490,342,490,490
9204,2012-01-24,Spring,2012,Jan,9,0,Tuesday,1,Misty,0.32,0.3333,0.87,0.0896,11,244,255,342,255,255
9205,2012-01-24,Spring,2012,Jan,10,0,Tuesday,1,Clear,0.32,0.3333,0.93,0.0896,23,93,116,342,116,116
9206,2012-01-24,Spring,2012,Jan,11,0,Tuesday,1,Clear,0.34,0.3333,0.87,0.1343,30,123,153,342,153,153
9207,2012-01-24,Spring,2012,Jan,12,0,Tuesday,1,Clear,0.34,0.3333,0.87,0.1642,25,150,175,342,175,175
9208,2012-01-24,Spring,2012,Jan,13,0,Tuesday,1,Clear,0.34,0.3333,0.87,0.1642,33,170,203,342,203,203
9209,2012-01-24,Spring,2012,Jan,14,0,Tuesday,1,Clear,0.36,0.3485,0.81,0.2239,35,138,173,342,173,173
9210,2012-01-24,Spring,2012,Jan,15,0,Tuesday,1,Misty,0.4,0.4091,0.71,0.1642,52,156,208,342,208,208
9211,2012-01-24,Spring,2012,Jan,16,0,Tuesday,1,Clear,0.4,0.4091,0.71,0.1343,35,243,278,342,278,278
9212,2012-01-24,Spring,2012,Jan,17,0,Tuesday,1,Clear,0.42,0.4242,0.67,0.0896,41,474,515,342,515,515
9213,2012-01-24,Spring,2012,Jan,18,0,Tuesday,1,Clear,0.4,0.4091,0.62,0.0896,32,391,423,342,423,423
9214,2012-01-24,Spring,2012,Jan,19,0,Tuesday,1,Clear,0.44,0.4394,0.51,0.0896,20,311,331,342,331,331
9215,2012-01-24,Spring,2012,Jan,20,0,Tuesday,1,Clear,0.32,0.3485,0.76,0.0,18,211,229,342,229,229
9216,2012-01-24,Spring,2012,Jan,21,0,Tuesday,1,Clear,0.36,0.3788,0.71,0.0,18,154,172,342,172,172
9217,2012-01-24,Spring,2012,Jan,22,0,Tuesday,1,Clear,0.32,0.3485,0.81,0.0,14,111,125,342,125,125
9218,2012-01-24,Spring,2012,Jan,23,0,Tuesday,1,Clear,0.32,0.3485,0.76,0.0,19,80,99,342,99,99
9219,2012-01-25,Spring,2012,Jan,0,0,Wednesday,1,Clear,0.26,0.303,0.93,0.0,6,25,31,341,31,31
9220,2012-01-25,Spring,2012,Jan,1,0,Wednesday,1,Clear,0.3,0.2879,0.7,0.2239,4,9,13,341,13,13
9221,2012-01-25,Spring,2012,Jan,2,0,Wednesday,1,Clear,0.28,0.2727,0.7,0.194,3,3,6,341,6,6
9222,2012-01-25,Spring,2012,Jan,3,0,Wednesday,1,Clear,0.26,0.2576,0.75,0.194,0,1,1,341,1,1
9223,2012-01-25,Spring,2012,Jan,4,0,Wednesday,1,Clear,0.26,0.2424,0.7,0.2836,0,4,4,341,4,4
9224,2012-01-25,Spring,2012,Jan,5,0,Wednesday,1,Clear,0.26,0.2424,0.7,0.2836,0,33,33,341,33,33
9225,2012-01-25,Spring,2012,Jan,6,0,Wednesday,1,Clear,0.24,0.2273,0.73,0.2239,1,87,88,341,88,88
9226,2012-01-25,Spring,2012,Jan,7,0,Wednesday,1,Clear,0.24,0.2273,0.75,0.2239,14,243,257,341,257,257
9227,2012-01-25,Spring,2012,Jan,8,0,Wednesday,1,Clear,0.24,0.2273,0.7,0.2537,18,495,513,341,513,513
9228,2012-01-25,Spring,2012,Jan,9,0,Wednesday,1,Clear,0.24,0.2273,0.7,0.2537,18,218,236,341,236,236
9229,2012-01-25,Spring,2012,Jan,10,0,Wednesday,1,Misty,0.26,0.2273,0.7,0.3284,30,111,141,341,141,141
9230,2012-01-25,Spring,2012,Jan,11,0,Wednesday,1,Misty,0.3,0.2727,0.61,0.2985,52,105,157,341,157,157
9231,2012-01-25,Spring,2012,Jan,12,0,Wednesday,1,Clear,0.32,0.3333,0.53,0.1343,46,147,193,341,193,193
9232,2012-01-25,Spring,2012,Jan,13,0,Wednesday,1,Clear,0.34,0.3333,0.49,0.1343,63,149,212,341,212,212
9233,2012-01-25,Spring,2012,Jan,14,0,Wednesday,1,Clear,0.34,0.3485,0.49,0.0896,53,107,160,341,160,160
9234,2012-01-25,Spring,2012,Jan,15,0,Wednesday,1,Clear,0.36,0.3788,0.46,0.0,30,125,155,341,155,155
9235,2012-01-25,Spring,2012,Jan,16,0,Wednesday,1,Clear,0.34,0.3333,0.53,0.1642,29,217,246,341,246,246
9236,2012-01-25,Spring,2012,Jan,17,0,Wednesday,1,Clear,0.36,0.3485,0.53,0.1642,27,443,470,341,470,470
9237,2012-01-25,Spring,2012,Jan,18,0,Wednesday,1,Clear,0.32,0.3333,0.66,0.1343,24,415,439,341,439,439
9238,2012-01-25,Spring,2012,Jan,19,0,Wednesday,1,Misty,0.34,0.3636,0.53,0.0,5,311,316,341,316,316
9239,2012-01-25,Spring,2012,Jan,20,0,Wednesday,1,Clear,0.32,0.3182,0.61,0.194,10,225,235,341,235,235
9240,2012-01-25,Spring,2012,Jan,21,0,Wednesday,1,Clear,0.3,0.3333,0.65,0.0,19,166,185,341,185,185
9241,2012-01-25,Spring,2012,Jan,22,0,Wednesday,1,Clear,0.3,0.3182,0.65,0.0896,12,101,113,341,113,113
9242,2012-01-25,Spring,2012,Jan,23,0,Wednesday,1,Misty,0.28,0.3182,0.65,0.0,3,63,66,341,66,66
9243,2012-01-26,Spring,2012,Jan,0,0,Thursday,1,Misty,0.28,0.2879,0.75,0.1045,3,22,25,340,25,25
9244,2012-01-26,Spring,2012,Jan,1,0,Thursday,1,Misty,0.28,0.3182,0.75,0.0,5,16,21,340,21,21
9245,2012-01-26,Spring,2012,Jan,2,0,Thursday,1,Misty,0.28,0.2727,0.75,0.1642,1,6,7,340,7,7
9246,2012-01-26,Spring,2012,Jan,3,0,Thursday,1,Misty,0.28,0.303,0.75,0.0896,1,5,6,340,6,6
9247,2012-01-26,Spring,2012,Jan,4,0,Thursday,1,Clear,0.28,0.3182,0.75,0.0,0,3,3,340,3,3
9248,2012-01-26,Spring,2012,Jan,5,0,Thursday,1,Misty,0.3,0.3182,0.75,0.1045,0,28,28,340,28,28
9249,2012-01-26,Spring,2012,Jan,6,0,Thursday,1,Misty,0.28,0.3182,0.81,0.0,0,88,88,340,88,88
9250,2012-01-26,Spring,2012,Jan,7,0,Thursday,1,Misty,0.28,0.303,0.81,0.0896,11,228,239,340,239,239
9251,2012-01-26,Spring,2012,Jan,8,0,Thursday,1,Misty,0.28,0.303,0.81,0.0896,16,514,530,340,530,530
9252,2012-01-26,Spring,2012,Jan,9,0,Thursday,1,Misty,0.3,0.3333,0.81,0.0,18,256,274,340,274,274
9253,2012-01-26,Spring,2012,Jan,10,0,Thursday,1,Misty,0.3,0.303,0.81,0.1343,16,92,108,340,108,108
9254,2012-01-26,Spring,2012,Jan,11,0,Thursday,1,Misty,0.3,0.3182,0.87,0.1045,11,100,111,340,111,111
9255,2012-01-26,Spring,2012,Jan,12,0,Thursday,1,Misty,0.34,0.3333,0.81,0.1343,29,136,165,340,165,165
9256,2012-01-26,Spring,2012,Jan,13,0,Thursday,1,Misty,0.38,0.3939,0.71,0.0,17,156,173,340,173,173
9257,2012-01-26,Spring,2012,Jan,14,0,Thursday,1,Misty,0.4,0.4091,0.71,0.1045,16,112,128,340,128,128
9258,2012-01-26,Spring,2012,Jan,15,0,Thursday,1,Misty,0.42,0.4242,0.71,0.1045,22,142,164,340,164,164
9259,2012-01-26,Spring,2012,Jan,16,0,Thursday,1,Misty,0.4,0.4091,0.71,0.0896,15,209,224,340,224,224
9260,2012-01-26,Spring,2012,Jan,17,0,Thursday,1,Misty,0.42,0.4242,0.71,0.0,16,397,413,340,413,413
9261,2012-01-26,Spring,2012,Jan,18,0,Thursday,1,Misty,0.42,0.4242,0.71,0.0,12,394,406,340,406,406
9262,2012-01-26,Spring,2012,Jan,19,0,Thursday,1,Misty,0.4,0.4091,0.76,0.1045,11,302,313,340,313,313
9263,2012-01-26,Spring,2012,Jan,20,0,Thursday,1,Misty,0.4,0.4091,0.82,0.1343,8,216,224,340,224,224
9264,2012-01-26,Spring,2012,Jan,21,0,Thursday,1,Misty,0.4,0.4091,0.76,0.1045,8,184,192,340,192,192
9265,2012-01-26,Spring,2012,Jan,22,0,Thursday,1,Clear,0.38,0.3939,0.82,0.1045,3,139,142,340,142,142
9266,2012-01-26,Spring,2012,Jan,23,0,Thursday,1,Misty,0.4,0.4091,0.82,0.0,5,86,91,340,91,91
9267,2012-01-27,Spring,2012,Jan,0,0,Friday,1,Misty,0.4,0.4091,0.82,0.2537,6,32,38,339,38,38
9268,2012-01-27,Spring,2012,Jan,1,0,Friday,1,Misty,0.4,0.4091,0.87,0.2239,6,23,29,339,29,29
9269,2012-01-27,Spring,2012,Jan,2,0,Friday,1,Clear,0.42,0.4242,0.94,0.1343,2,11,13,339,13,13
9270,2012-01-27,Spring,2012,Jan,3,0,Friday,1,Misty,0.42,0.4242,0.94,0.2836,3,5,8,339,8,8
9271,2012-01-27,Spring,2012,Jan,4,0,Friday,1,Misty,0.4,0.4091,1.0,0.2985,1,3,4,339,4,4
9272,2012-01-27,Spring,2012,Jan,5,0,Friday,1,Misty,0.42,0.4242,0.94,0.3284,0,24,24,339,24,24
9273,2012-01-27,Spring,2012,Jan,6,0,Friday,1,Misty,0.42,0.4242,1.0,0.3284,0,72,72,339,72,72
9274,2012-01-27,Spring,2012,Jan,7,0,Friday,1,Misty,0.42,0.4242,1.0,0.2985,6,128,134,339,134,134
9275,2012-01-27,Spring,2012,Jan,8,0,Friday,1,Light_rainsnow,0.5,0.4848,0.88,0.2836,14,206,220,339,220,220
9276,2012-01-27,Spring,2012,Jan,9,0,Friday,1,Light_rainsnow,0.5,0.4848,0.88,0.2836,6,101,107,339,107,107
9277,2012-01-27,Spring,2012,Jan,10,0,Friday,1,Light_rainsnow,0.48,0.4697,1.0,0.1642,9,117,126,339,126,126
9278,2012-01-27,Spring,2012,Jan,11,0,Friday,1,Misty,0.48,0.4697,0.94,0.1343,10,95,105,339,105,105
9279,2012-01-27,Spring,2012,Jan,12,0,Friday,1,Misty,0.5,0.4848,0.88,0.1642,25,155,180,339,180,180
9280,2012-01-27,Spring,2012,Jan,13,0,Friday,1,Clear,0.5,0.4848,0.59,0.4627,26,175,201,339,201,201
9281,2012-01-27,Spring,2012,Jan,14,0,Friday,1,Clear,0.5,0.4848,0.55,0.5522,23,153,176,339,176,176
9282,2012-01-27,Spring,2012,Jan,15,0,Friday,1,Clear,0.48,0.4697,0.51,0.3284,27,170,197,339,197,197
9283,2012-01-27,Spring,2012,Jan,16,0,Friday,1,Clear,0.44,0.4394,0.51,0.5522,26,241,267,339,267,267
9284,2012-01-27,Spring,2012,Jan,17,0,Friday,1,Clear,0.42,0.4242,0.5,0.5821,16,406,422,339,422,422
9285,2012-01-27,Spring,2012,Jan,18,0,Friday,1,Clear,0.4,0.4091,0.5,0.4925,20,363,383,339,383,383
9286,2012-01-27,Spring,2012,Jan,19,0,Friday,1,Clear,0.36,0.3333,0.5,0.3881,10,241,251,339,251,251
9287,2012-01-27,Spring,2012,Jan,20,0,Friday,1,Clear,0.34,0.303,0.53,0.3582,6,153,159,339,159,159
9288,2012-01-27,Spring,2012,Jan,21,0,Friday,1,Clear,0.34,0.2879,0.53,0.5224,8,127,135,339,135,135
9289,2012-01-27,Spring,2012,Jan,22,0,Friday,1,Clear,0.34,0.303,0.49,0.3881,11,108,119,339,119,119
9290,2012-01-27,Spring,2012,Jan,23,0,Friday,1,Clear,0.32,0.2879,0.49,0.4179,8,78,86,339,86,86
9291,2012-01-28,Spring,2012,Jan,0,0,Saturday,0,Clear,0.3,0.2879,0.52,0.2836,1,68,69,338,69,69
9292,2012-01-28,Spring,2012,Jan,1,0,Saturday,0,Clear,0.3,0.303,0.52,0.1642,1,57,58,338,58,58
9293,2012-01-28,Spring,2012,Jan,2,0,Saturday,0,Clear,0.26,0.303,0.6,0.0,3,38,41,338,41,41
9294,2012-01-28,Spring,2012,Jan,3,0,Saturday,0,Clear,0.26,0.2879,0.6,0.0896,1,16,17,338,17,17
9295,2012-01-28,Spring,2012,Jan,4,0,Saturday,0,Clear,0.26,0.2576,0.6,0.1642,0,8,8,338,8,8
9296,2012-01-28,Spring,2012,Jan,5,0,Saturday,0,Clear,0.24,0.2576,0.75,0.0896,0,10,10,338,10,10
9297,2012-01-28,Spring,2012,Jan,6,0,Saturday,0,Clear,0.24,0.2879,0.7,0.0,3,12,15,338,15,15
9298,2012-01-28,Spring,2012,Jan,7,0,Saturday,0,Clear,0.22,0.2727,0.75,0.0,3,28,31,338,31,31
9299,2012-01-28,Spring,2012,Jan,8,0,Saturday,0,Clear,0.2,0.2273,0.8,0.0896,9,82,91,338,91,91
9300,2012-01-28,Spring,2012,Jan,9,0,Saturday,0,Clear,0.22,0.2727,0.8,0.0,13,145,158,338,158,158
9301,2012-01-28,Spring,2012,Jan,10,0,Saturday,0,Clear,0.26,0.2727,0.7,0.1343,27,164,191,338,191,191
9302,2012-01-28,Spring,2012,Jan,11,0,Saturday,0,Clear,0.3,0.303,0.56,0.1343,55,241,296,338,296,296
9303,2012-01-28,Spring,2012,Jan,12,0,Saturday,0,Clear,0.3,0.2879,0.61,0.2836,70,244,314,338,314,314
9304,2012-01-28,Spring,2012,Jan,13,0,Saturday,0,Clear,0.34,0.3182,0.57,0.2537,80,293,373,338,373,373
9305,2012-01-28,Spring,2012,Jan,14,0,Saturday,0,Clear,0.38,0.3939,0.5,0.3881,123,239,362,338,362,362
9306,2012-01-28,Spring,2012,Jan,15,0,Saturday,0,Clear,0.4,0.4091,0.47,0.3284,90,320,410,338,410,410
9307,2012-01-28,Spring,2012,Jan,16,0,Saturday,0,Clear,0.42,0.4242,0.44,0.3582,131,276,407,338,407,407
9308,2012-01-28,Spring,2012,Jan,17,0,Saturday,0,Clear,0.42,0.4242,0.44,0.3881,57,233,290,338,290,290
9309,2012-01-28,Spring,2012,Jan,18,0,Saturday,0,Clear,0.42,0.4242,0.41,0.2239,40,201,241,338,241,241
9310,2012-01-28,Spring,2012,Jan,19,0,Saturday,0,Misty,0.42,0.4242,0.41,0.5522,33,173,206,338,206,206
9311,2012-01-28,Spring,2012,Jan,20,0,Saturday,0,Clear,0.4,0.4091,0.35,0.3881,5,115,120,338,120,120
9312,2012-01-28,Spring,2012,Jan,21,0,Saturday,0,Clear,0.36,0.3333,0.29,0.3582,18,109,127,338,127,127
9313,2012-01-28,Spring,2012,Jan,22,0,Saturday,0,Clear,0.34,0.3333,0.34,0.194,6,97,103,338,103,103
9314,2012-01-28,Spring,2012,Jan,23,0,Saturday,0,Clear,0.32,0.3182,0.31,0.194,6,79,85,338,85,85
9315,2012-01-29,Spring,2012,Jan,0,0,Sunday,0,Clear,0.3,0.2879,0.33,0.2239,15,81,96,337,96,96
9316,2012-01-29,Spring,2012,Jan,1,0,Sunday,0,Clear,0.3,0.2727,0.28,0.3582,5,68,73,337,73,73
9317,2012-01-29,Spring,2012,Jan,2,0,Sunday,0,Clear,0.28,0.2576,0.26,0.3284,3,48,51,337,51,51
9318,2012-01-29,Spring,2012,Jan,3,0,Sunday,0,Clear,0.26,0.2576,0.28,0.194,4,17,21,337,21,21
9319,2012-01-29,Spring,2012,Jan,4,0,Sunday,0,Clear,0.24,0.2576,0.3,0.0,0,5,5,337,5,5
9320,2012-01-29,Spring,2012,Jan,5,0,Sunday,0,Clear,0.2,0.2121,0.51,0.1343,1,6,7,337,7,7
9321,2012-01-29,Spring,2012,Jan,6,0,Sunday,0,Clear,0.2,0.2273,0.4,0.1045,1,4,5,337,5,5
9322,2012-01-29,Spring,2012,Jan,7,0,Sunday,0,Clear,0.2,0.2121,0.37,0.1343,0,12,12,337,12,12
9323,2012-01-29,Spring,2012,Jan,8,0,Sunday,0,Clear,0.18,0.197,0.4,0.1343,9,61,70,337,70,70
9324,2012-01-29,Spring,2012,Jan,9,0,Sunday,0,Clear,0.18,0.197,0.43,0.1343,13,98,111,337,111,111
9325,2012-01-29,Spring,2012,Jan,10,0,Sunday,0,Clear,0.24,0.2424,0.35,0.1343,38,153,191,337,191,191
9326,2012-01-29,Spring,2012,Jan,11,0,Sunday,0,Clear,0.28,0.2727,0.28,0.2239,57,198,255,337,255,255
9327,2012-01-29,Spring,2012,Jan,12,0,Sunday,0,Clear,0.32,0.303,0.26,0.2239,73,215,288,337,288,288
9328,2012-01-29,Spring,2012,Jan,13,0,Sunday,0,Clear,0.32,0.303,0.26,0.2239,78,238,316,337,316,316
9329,2012-01-29,Spring,2012,Jan,14,0,Sunday,0,Clear,0.32,0.303,0.26,0.2537,51,229,280,337,280,280
9330,2012-01-29,Spring,2012,Jan,15,0,Sunday,0,Clear,0.36,0.3333,0.25,0.2836,68,242,310,337,310,310
9331,2012-01-29,Spring,2012,Jan,16,0,Sunday,0,Clear,0.36,0.3333,0.21,0.4179,54,268,322,337,322,322
9332,2012-01-29,Spring,2012,Jan,17,0,Sunday,0,Clear,0.36,0.3333,0.21,0.4179,33,201,234,337,234,234
9333,2012-01-29,Spring,2012,Jan,18,0,Sunday,0,Clear,0.34,0.303,0.23,0.3582,17,151,168,337,168,168
9334,2012-01-29,Spring,2012,Jan,19,0,Sunday,0,Clear,0.32,0.303,0.29,0.2537,14,145,159,337,159,159
9335,2012-01-29,Spring,2012,Jan,20,0,Sunday,0,Clear,0.3,0.2879,0.39,0.2239,13,98,111,337,111,111
9336,2012-01-29,Spring,2012,Jan,21,0,Sunday,0,Clear,0.3,0.2879,0.33,0.2836,0,69,69,337,69,69
9337,2012-01-29,Spring,2012,Jan,22,0,Sunday,0,Clear,0.32,0.2879,0.26,0.3881,7,57,64,337,64,64
9338,2012-01-29,Spring,2012,Jan,23,0,Sunday,0,Clear,0.3,0.2727,0.33,0.3284,4,21,25,337,25,25
9339,2012-01-30,Spring,2012,Jan,0,0,Monday,1,Misty,0.32,0.2879,0.26,0.4179,0,10,10,336,10,10
9340,2012-01-30,Spring,2012,Jan,1,0,Monday,1,Clear,0.26,0.2273,0.6,0.3582,0,9,9,336,9,9
9341,2012-01-30,Spring,2012,Jan,2,0,Monday,1,Clear,0.24,0.2121,0.48,0.3582,1,6,7,336,7,7
9342,2012-01-30,Spring,2012,Jan,3,0,Monday,1,Clear,0.24,0.2273,0.48,0.194,0,4,4,336,4,4
9343,2012-01-30,Spring,2012,Jan,4,0,Monday,1,Clear,0.2,0.2121,0.51,0.1343,0,5,5,336,5,5
9344,2012-01-30,Spring,2012,Jan,5,0,Monday,1,Clear,0.2,0.2121,0.51,0.1343,0,26,26,336,26,26
9345,2012-01-30,Spring,2012,Jan,6,0,Monday,1,Clear,0.22,0.2121,0.44,0.2537,0,80,80,336,80,80
9346,2012-01-30,Spring,2012,Jan,7,0,Monday,1,Clear,0.22,0.2121,0.44,0.2836,4,221,225,336,225,225
9347,2012-01-30,Spring,2012,Jan,8,0,Monday,1,Clear,0.2,0.197,0.47,0.2239,12,481,493,336,493,493
9348,2012-01-30,Spring,2012,Jan,9,0,Monday,1,Clear,0.2,0.197,0.47,0.2239,5,193,198,336,198,198
9349,2012-01-30,Spring,2012,Jan,10,0,Monday,1,Clear,0.22,0.2121,0.41,0.2836,3,82,85,336,85,85
9350,2012-01-30,Spring,2012,Jan,11,0,Monday,1,Clear,0.26,0.2576,0.38,0.0,6,93,99,336,99,99
9351,2012-01-30,Spring,2012,Jan,12,0,Monday,1,Clear,0.26,0.2273,0.35,0.3881,5,129,134,336,134,134
9352,2012-01-30,Spring,2012,Jan,13,0,Monday,1,Clear,0.3,0.2879,0.31,0.194,15,117,132,336,132,132
9353,2012-01-30,Spring,2012,Jan,14,0,Monday,1,Clear,0.32,0.3333,0.24,0.1343,15,100,115,336,115,115
9354,2012-01-30,Spring,2012,Jan,15,0,Monday,1,Clear,0.32,0.3182,0.24,0.194,7,131,138,336,138,138
9355,2012-01-30,Spring,2012,Jan,16,0,Monday,1,Clear,0.34,0.3333,0.25,0.194,11,210,221,336,221,221
9356,2012-01-30,Spring,2012,Jan,17,0,Monday,1,Clear,0.36,0.3485,0.21,0.194,16,422,438,336,438,438
9357,2012-01-30,Spring,2012,Jan,18,0,Monday,1,Clear,0.34,0.3333,0.23,0.1642,11,399,410,336,410,410
9358,2012-01-30,Spring,2012,Jan,19,0,Monday,1,Clear,0.3,0.3182,0.45,0.1045,8,298,306,336,306,306
9359,2012-01-30,Spring,2012,Jan,20,0,Monday,1,Clear,0.3,0.303,0.39,0.1642,2,179,181,336,181,181
9360,2012-01-30,Spring,2012,Jan,21,0,Monday,1,Clear,0.3,0.303,0.42,0.1642,3,159,162,336,162,162
9361,2012-01-30,Spring,2012,Jan,22,0,Monday,1,Clear,0.28,0.2727,0.48,0.2239,2,92,94,336,94,94
9362,2012-01-30,Spring,2012,Jan,23,0,Monday,1,Clear,0.26,0.2576,0.6,0.194,0,52,52,336,52,52
9363,2012-01-31,Spring,2012,Jan,0,0,Tuesday,1,Clear,0.28,0.2727,0.52,0.2537,0,15,15,335,15,15
9364,2012-01-31,Spring,2012,Jan,1,0,Tuesday,1,Clear,0.3,0.2727,0.42,0.2985,1,7,8,335,8,8
9365,2012-01-31,Spring,2012,Jan,2,0,Tuesday,1,Clear,0.3,0.2879,0.42,0.2239,0,2,2,335,2,2
9366,2012-01-31,Spring,2012,Jan,3,0,Tuesday,1,Clear,0.3,0.2879,0.45,0.2239,0,2,2,335,2,2
9367,2012-01-31,Spring,2012,Jan,4,0,Tuesday,1,Clear,0.3,0.2879,0.49,0.194,0,1,1,335,1,1
9368,2012-01-31,Spring,2012,Jan,5,0,Tuesday,1,Clear,0.3,0.2879,0.49,0.194,0,22,22,335,22,22
9369,2012-01-31,Spring,2012,Jan,6,0,Tuesday,1,Clear,0.28,0.2727,0.52,0.1642,0,104,104,335,104,104
9370,2012-01-31,Spring,2012,Jan,7,0,Tuesday,1,Clear,0.26,0.2576,0.6,0.194,6,273,279,335,279,279
9371,2012-01-31,Spring,2012,Jan,8,0,Tuesday,1,Clear,0.26,0.2727,0.6,0.1045,14,498,512,335,512,512
9372,2012-01-31,Spring,2012,Jan,9,0,Tuesday,1,Clear,0.3,0.2879,0.52,0.194,30,231,261,335,261,261
9373,2012-01-31,Spring,2012,Jan,10,0,Tuesday,1,Misty,0.32,0.3182,0.57,0.194,34,110,144,335,144,144
9374,2012-01-31,Spring,2012,Jan,11,0,Tuesday,1,Clear,0.4,0.4091,0.37,0.2836,14,125,139,335,139,139
9375,2012-01-31,Spring,2012,Jan,12,0,Tuesday,1,Clear,0.4,0.4091,0.43,0.2985,13,181,194,335,194,194
9376,2012-01-31,Spring,2012,Jan,13,0,Tuesday,1,Clear,0.46,0.4545,0.36,0.2239,27,171,198,335,198,198
9377,2012-01-31,Spring,2012,Jan,14,0,Tuesday,1,Clear,0.5,0.4848,0.29,0.3284,18,142,160,335,160,160
9378,2012-01-31,Spring,2012,Jan,15,0,Tuesday,1,Clear,0.54,0.5152,0.26,0.4478,27,150,177,335,177,177
9379,2012-01-31,Spring,2012,Jan,16,0,Tuesday,1,Clear,0.54,0.5152,0.26,0.4478,30,277,307,335,307,307
9380,2012-01-31,Spring,2012,Jan,17,0,Tuesday,1,Clear,0.54,0.5152,0.26,0.4179,41,518,559,335,559,559
9381,2012-01-31,Spring,2012,Jan,18,0,Tuesday,1,Clear,0.54,0.5152,0.24,0.3582,16,486,502,335,502,502
9382,2012-01-31,Spring,2012,Jan,19,0,Tuesday,1,Clear,0.5,0.4848,0.29,0.2836,22,306,328,335,328,328
9383,2012-01-31,Spring,2012,Jan,20,0,Tuesday,1,Clear,0.4,0.4091,0.58,0.1045,15,223,238,335,238,238
9384,2012-01-31,Spring,2012,Jan,21,0,Tuesday,1,Clear,0.46,0.4545,0.33,0.2985,3,162,165,335,165,165
9385,2012-01-31,Spring,2012,Jan,22,0,Tuesday,1,Clear,0.44,0.4394,0.35,0.2985,11,118,129,335,129,129
9386,2012-01-31,Spring,2012,Jan,23,0,Tuesday,1,Clear,0.44,0.4394,0.38,0.2537,2,61,63,335,63,63
9387,2012-02-01,Spring,2012,Feb,0,0,Wednesday,1,Clear,0.44,0.4394,0.38,0.2836,0,31,31,334,31,31
9388,2012-02-01,Spring,2012,Feb,1,0,Wednesday,1,Clear,0.44,0.4394,0.41,0.2836,0,4,4,334,4,4
9389,2012-02-01,Spring,2012,Feb,2,0,Wednesday,1,Clear,0.44,0.4394,0.44,0.2836,1,6,7,334,7,7
9390,2012-02-01,Spring,2012,Feb,3,0,Wednesday,1,Clear,0.44,0.4394,0.44,0.194,0,3,3,334,3,3
9391,2012-02-01,Spring,2012,Feb,4,0,Wednesday,1,Clear,0.4,0.4091,0.5,0.1642,0,1,1,334,1,1
9392,2012-02-01,Spring,2012,Feb,5,0,Wednesday,1,Clear,0.4,0.4091,0.5,0.1642,0,18,18,334,18,18
9393,2012-02-01,Spring,2012,Feb,6,0,Wednesday,1,Light_rainsnow,0.4,0.4091,0.54,0.1642,0,67,67,334,67,67
9394,2012-02-01,Spring,2012,Feb,7,0,Wednesday,1,Light_rainsnow,0.38,0.3939,0.62,0.0896,7,201,208,334,208,208
9395,2012-02-01,Spring,2012,Feb,8,0,Wednesday,1,Light_rainsnow,0.36,0.3636,0.73,0.1045,15,505,520,334,520,520
9396,2012-02-01,Spring,2012,Feb,9,0,Wednesday,1,Misty,0.36,0.3485,0.71,0.194,9,267,276,334,276,276
9397,2012-02-01,Spring,2012,Feb,10,0,Wednesday,1,Clear,0.4,0.4091,0.62,0.1343,9,124,133,334,133,133
9398,2012-02-01,Spring,2012,Feb,11,0,Wednesday,1,Clear,0.4,0.4091,0.58,0.1642,27,116,143,334,143,143
9399,2012-02-01,Spring,2012,Feb,12,0,Wednesday,1,Clear,0.44,0.4394,0.54,0.1045,26,153,179,334,179,179
9400,2012-02-01,Spring,2012,Feb,13,0,Wednesday,1,Clear,0.46,0.4545,0.47,0.2239,12,174,186,334,186,186
9401,2012-02-01,Spring,2012,Feb,14,0,Wednesday,1,Clear,0.62,0.6212,0.33,0.2239,33,159,192,334,192,192
9402,2012-02-01,Spring,2012,Feb,15,0,Wednesday,1,Clear,0.6,0.6212,0.35,0.2836,25,169,194,334,194,194
9403,2012-02-01,Spring,2012,Feb,16,0,Wednesday,1,Clear,0.6,0.6212,0.4,0.2239,22,261,283,334,283,283
9404,2012-02-01,Spring,2012,Feb,17,0,Wednesday,1,Clear,0.58,0.5455,0.43,0.194,31,508,539,334,539,539
9405,2012-02-01,Spring,2012,Feb,18,0,Wednesday,1,Clear,0.56,0.5303,0.46,0.1642,12,514,526,334,526,526
9406,2012-02-01,Spring,2012,Feb,19,0,Wednesday,1,Clear,0.54,0.5152,0.52,0.2836,20,315,335,334,335,335
9407,2012-02-01,Spring,2012,Feb,20,0,Wednesday,1,Clear,0.52,0.5,0.52,0.1642,10,254,264,334,264,264
9408,2012-02-01,Spring,2012,Feb,21,0,Wednesday,1,Clear,0.52,0.5,0.52,0.1642,16,217,233,334,233,233
9409,2012-02-01,Spring,2012,Feb,22,0,Wednesday,1,Clear,0.5,0.4848,0.55,0.194,7,133,140,334,140,140
9410,2012-02-01,Spring,2012,Feb,23,0,Wednesday,1,Clear,0.46,0.4545,0.63,0.0896,22,75,97,334,97,97
9411,2012-02-02,Spring,2012,Feb,0,0,Thursday,1,Clear,0.46,0.4545,0.59,0.1343,7,24,31,333,31,31
9412,2012-02-02,Spring,2012,Feb,1,0,Thursday,1,Misty,0.46,0.4545,0.55,0.0,3,14,17,333,17,17
9413,2012-02-02,Spring,2012,Feb,2,0,Thursday,1,Misty,0.42,0.4242,0.67,0.1343,2,7,9,333,9,9
9414,2012-02-02,Spring,2012,Feb,3,0,Thursday,1,Misty,0.42,0.4242,0.67,0.1343,0,2,2,333,2,2
9415,2012-02-02,Spring,2012,Feb,4,0,Thursday,1,Light_rainsnow,0.4,0.4091,0.82,0.0896,0,1,1,333,1,1
9416,2012-02-02,Spring,2012,Feb,5,0,Thursday,1,Light_rainsnow,0.4,0.4091,0.82,0.0,0,19,19,333,19,19
9417,2012-02-02,Spring,2012,Feb,6,0,Thursday,1,Light_rainsnow,0.36,0.3788,0.9,0.0,1,73,74,333,74,74
9418,2012-02-02,Spring,2012,Feb,7,0,Thursday,1,Light_rainsnow,0.36,0.3788,0.93,0.0,4,201,205,333,205,205
9419,2012-02-02,Spring,2012,Feb,8,0,Thursday,1,Light_rainsnow,0.4,0.4091,0.87,0.0,9,436,445,333,445,445
9420,2012-02-02,Spring,2012,Feb,9,0,Thursday,1,Light_rainsnow,0.38,0.3939,0.87,0.0,15,213,228,333,228,228
9421,2012-02-02,Spring,2012,Feb,10,0,Thursday,1,Light_rainsnow,0.42,0.4242,0.77,0.1045,6,72,78,333,78,78
9422,2012-02-02,Spring,2012,Feb,11,0,Thursday,1,Light_rainsnow,0.4,0.4091,0.82,0.2537,6,99,105,333,105,105
9423,2012-02-02,Spring,2012,Feb,12,0,Thursday,1,Clear,0.42,0.4242,0.82,0.0,8,140,148,333,148,148
9424,2012-02-02,Spring,2012,Feb,13,0,Thursday,1,Misty,0.42,0.4242,0.77,0.0,13,124,137,333,137,137
9425,2012-02-02,Spring,2012,Feb,14,0,Thursday,1,Clear,0.4,0.4091,0.76,0.1045,12,129,141,333,141,141
9426,2012-02-02,Spring,2012,Feb,15,0,Thursday,1,Clear,0.46,0.4545,0.67,0.1642,24,150,174,333,174,174
9427,2012-02-02,Spring,2012,Feb,16,0,Thursday,1,Clear,0.46,0.4545,0.55,0.2836,18,211,229,333,229,229
9428,2012-02-02,Spring,2012,Feb,17,0,Thursday,1,Clear,0.42,0.4242,0.54,0.4925,13,437,450,333,450,450
9429,2012-02-02,Spring,2012,Feb,18,0,Thursday,1,Clear,0.4,0.4091,0.43,0.4627,17,393,410,333,410,410
9430,2012-02-02,Spring,2012,Feb,19,0,Thursday,1,Clear,0.38,0.3939,0.43,0.5224,16,311,327,333,327,327
9431,2012-02-02,Spring,2012,Feb,20,0,Thursday,1,Clear,0.36,0.3182,0.46,0.5224,9,204,213,333,213,213
9432,2012-02-02,Spring,2012,Feb,21,0,Thursday,1,Clear,0.34,0.303,0.46,0.4179,4,144,148,333,148,148
9433,2012-02-02,Spring,2012,Feb,22,0,Thursday,1,Clear,0.32,0.2879,0.49,0.4179,3,106,109,333,109,109
9434,2012-02-02,Spring,2012,Feb,23,0,Thursday,1,Clear,0.32,0.303,0.49,0.2537,0,61,61,333,61,61
9435,2012-02-03,Spring,2012,Feb,0,0,Friday,1,Clear,0.32,0.2879,0.53,0.3881,1,37,38,332,38,38
9436,2012-02-03,Spring,2012,Feb,1,0,Friday,1,Clear,0.3,0.2727,0.56,0.3284,3,19,22,332,22,22
9437,2012-02-03,Spring,2012,Feb,2,0,Friday,1,Clear,0.3,0.2879,0.52,0.2239,0,6,6,332,6,6
9438,2012-02-03,Spring,2012,Feb,3,0,Friday,1,Clear,0.28,0.2576,0.56,0.2985,0,4,4,332,4,4
9439,2012-02-03,Spring,2012,Feb,4,0,Friday,1,Clear,0.26,0.2576,0.6,0.2239,0,2,2,332,2,2
9440,2012-02-03,Spring,2012,Feb,5,0,Friday,1,Clear,0.26,0.2576,0.6,0.2239,0,17,17,332,17,17
9441,2012-02-03,Spring,2012,Feb,6,0,Friday,1,Clear,0.24,0.2424,0.65,0.1642,0,88,88,332,88,88
9442,2012-02-03,Spring,2012,Feb,7,0,Friday,1,Clear,0.24,0.2273,0.65,0.2239,10,216,226,332,226,226
9443,2012-02-03,Spring,2012,Feb,8,0,Friday,1,Clear,0.24,0.2273,0.65,0.2239,12,429,441,332,441,441
9444,2012-02-03,Spring,2012,Feb,9,0,Friday,1,Clear,0.24,0.2273,0.65,0.194,18,252,270,332,270,270
9445,2012-02-03,Spring,2012,Feb,10,0,Friday,1,Clear,0.28,0.2576,0.56,0.2836,15,114,129,332,129,129
9446,2012-02-03,Spring,2012,Feb,11,0,Friday,1,Clear,0.32,0.303,0.53,0.2985,15,149,164,332,164,164
9447,2012-02-03,Spring,2012,Feb,12,0,Friday,1,Clear,0.34,0.3333,0.46,0.1343,25,191,216,332,216,216
9448,2012-02-03,Spring,2012,Feb,13,0,Friday,1,Clear,0.36,0.3636,0.46,0.0,25,173,198,332,198,198
9449,2012-02-03,Spring,2012,Feb,14,0,Friday,1,Clear,0.36,0.3485,0.46,0.2239,22,148,170,332,170,170
9450,2012-02-03,Spring,2012,Feb,15,0,Friday,1,Clear,0.38,0.3939,0.4,0.0,48,168,216,332,216,216
9451,2012-02-03,Spring,2012,Feb,16,0,Friday,1,Clear,0.4,0.4091,0.37,0.1045,36,275,311,332,311,311
9452,2012-02-03,Spring,2012,Feb,17,0,Friday,1,Clear,0.4,0.4091,0.37,0.0896,30,458,488,332,488,488
9453,2012-02-03,Spring,2012,Feb,18,0,Friday,1,Clear,0.38,0.3939,0.4,0.1343,17,368,385,332,385,385
9454,2012-02-03,Spring,2012,Feb,19,0,Friday,1,Clear,0.34,0.3485,0.49,0.1045,11,256,267,332,267,267
9455,2012-02-03,Spring,2012,Feb,20,0,Friday,1,Clear,0.34,0.3485,0.49,0.1045,8,155,163,332,163,163
9456,2012-02-03,Spring,2012,Feb,21,0,Friday,1,Clear,0.34,0.3485,0.49,0.1045,8,126,134,332,134,134
9457,2012-02-03,Spring,2012,Feb,22,0,Friday,1,Clear,0.34,0.3485,0.49,0.1045,3,116,119,332,119,119
9458,2012-02-03,Spring,2012,Feb,23,0,Friday,1,Clear,0.26,0.2727,0.7,0.1045,3,74,77,332,77,77
9459,2012-02-04,Spring,2012,Feb,0,0,Saturday,0,Clear,0.26,0.2727,0.7,0.1045,10,76,86,331,86,86
9460,2012-02-04,Spring,2012,Feb,1,0,Saturday,0,Clear,0.26,0.2727,0.7,0.1045,0,43,43,331,43,43
9461,2012-02-04,Spring,2012,Feb,2,0,Saturday,0,Clear,0.24,0.2576,0.7,0.0896,6,38,44,331,44,44
9462,2012-02-04,Spring,2012,Feb,3,0,Saturday,0,Clear,0.24,0.2879,0.75,0.0,1,17,18,331,18,18
9463,2012-02-04,Spring,2012,Feb,4,0,Saturday,0,Clear,0.24,0.2576,0.81,0.0896,1,5,6,331,6,6
9464,2012-02-04,Spring,2012,Feb,5,0,Saturday,0,Clear,0.24,0.2576,0.81,0.0896,1,3,4,331,4,4
9465,2012-02-04,Spring,2012,Feb,6,0,Saturday,0,Clear,0.22,0.2273,0.87,0.1343,1,4,5,331,5,5
9466,2012-02-04,Spring,2012,Feb,7,0,Saturday,0,Misty,0.24,0.2424,0.87,0.1343,1,27,28,331,28,28
9467,2012-02-04,Spring,2012,Feb,8,0,Saturday,0,Clear,0.24,0.2879,0.87,0.0,4,86,90,331,90,90
9468,2012-02-04,Spring,2012,Feb,9,0,Saturday,0,Clear,0.24,0.2424,0.81,0.1343,16,141,157,331,157,157
9469,2012-02-04,Spring,2012,Feb,10,0,Saturday,0,Clear,0.24,0.2576,0.87,0.1045,31,193,224,331,224,224
9470,2012-02-04,Spring,2012,Feb,11,0,Saturday,0,Clear,0.3,0.3333,0.7,0.0,46,224,270,331,270,270
9471,2012-02-04,Spring,2012,Feb,12,0,Saturday,0,Misty,0.3,0.3182,0.7,0.0896,40,260,300,331,300,300
9472,2012-02-04,Spring,2012,Feb,13,0,Saturday,0,Misty,0.3,0.2879,0.7,0.194,58,244,302,331,302,302
9473,2012-02-04,Spring,2012,Feb,14,0,Saturday,0,Misty,0.32,0.303,0.66,0.2239,47,229,276,331,276,276
9474,2012-02-04,Spring,2012,Feb,15,0,Saturday,0,Misty,0.32,0.303,0.66,0.2239,61,244,305,331,305,305
9475,2012-02-04,Spring,2012,Feb,16,0,Saturday,0,Misty,0.34,0.3333,0.61,0.1642,20,123,143,331,143,143
9476,2012-02-04,Spring,2012,Feb,17,0,Saturday,0,Light_rainsnow,0.3,0.2879,0.7,0.194,13,54,67,331,67,67
9477,2012-02-04,Spring,2012,Feb,18,0,Saturday,0,Light_rainsnow,0.28,0.2727,0.75,0.1642,6,58,64,331,64,64
9478,2012-02-04,Spring,2012,Feb,19,0,Saturday,0,Light_rainsnow,0.26,0.2727,0.87,0.1343,5,75,80,331,80,80
9479,2012-02-04,Spring,2012,Feb,20,0,Saturday,0,Light_rainsnow,0.24,0.2273,0.93,0.194,4,73,77,331,77,77
9480,2012-02-04,Spring,2012,Feb,21,0,Saturday,0,Light_rainsnow,0.24,0.2424,0.93,0.1343,4,74,78,331,78,78
9481,2012-02-04,Spring,2012,Feb,22,0,Saturday,0,Misty,0.24,0.2576,0.87,0.0896,4,91,95,331,95,95
9482,2012-02-04,Spring,2012,Feb,23,0,Saturday,0,Misty,0.24,0.2424,0.87,0.1343,4,66,70,331,70,70
9483,2012-02-05,Spring,2012,Feb,0,0,Sunday,0,Misty,0.24,0.2424,0.87,0.1343,3,58,61,330,61,61
9484,2012-02-05,Spring,2012,Feb,1,0,Sunday,0,Misty,0.24,0.2576,0.93,0.1045,5,46,51,330,51,51
9485,2012-02-05,Spring,2012,Feb,2,0,Sunday,0,Misty,0.24,0.2576,0.93,0.1045,4,59,63,330,63,63
9486,2012-02-05,Spring,2012,Feb,3,0,Sunday,0,Light_rainsnow,0.24,0.2576,0.87,0.0896,4,13,17,330,17,17
9487,2012-02-05,Spring,2012,Feb,4,0,Sunday,0,Misty,0.24,0.2424,0.87,0.1343,0,9,9,330,9,9
9488,2012-02-05,Spring,2012,Feb,5,0,Sunday,0,Light_rainsnow,0.26,0.2576,0.81,0.194,0,4,4,330,4,4
9489,2012-02-05,Spring,2012,Feb,6,0,Sunday,0,Misty,0.26,0.2424,0.7,0.2537,0,4,4,330,4,4
9490,2012-02-05,Spring,2012,Feb,7,0,Sunday,0,Misty,0.24,0.2424,0.75,0.1642,0,16,16,330,16,16
9491,2012-02-05,Spring,2012,Feb,8,0,Sunday,0,Misty,0.24,0.2424,0.75,0.1642,4,58,62,330,62,62
9492,2012-02-05,Spring,2012,Feb,9,0,Sunday,0,Misty,0.24,0.2273,0.7,0.2239,9,83,92,330,92,92
9493,2012-02-05,Spring,2012,Feb,10,0,Sunday,0,Misty,0.26,0.2424,0.65,0.2836,10,138,148,330,148,148
9494,2012-02-05,Spring,2012,Feb,11,0,Sunday,0,Misty,0.26,0.2576,0.7,0.194,22,160,182,330,182,182
9495,2012-02-05,Spring,2012,Feb,12,0,Sunday,0,Misty,0.26,0.2576,0.65,0.194,25,223,248,330,248,248
9496,2012-02-05,Spring,2012,Feb,13,0,Sunday,0,Misty,0.28,0.2727,0.61,0.1642,33,241,274,330,274,274
9497,2012-02-05,Spring,2012,Feb,14,0,Sunday,0,Clear,0.3,0.303,0.61,0.1642,40,203,243,330,243,243
9498,2012-02-05,Spring,2012,Feb,15,0,Sunday,0,Misty,0.3,0.2879,0.56,0.2537,55,217,272,330,272,272
9499,2012-02-05,Spring,2012,Feb,16,0,Sunday,0,Clear,0.3,0.2879,0.56,0.2239,35,261,296,330,296,296
9500,2012-02-05,Spring,2012,Feb,17,0,Sunday,0,Clear,0.32,0.3182,0.53,0.1642,31,275,306,330,306,306
9501,2012-02-05,Spring,2012,Feb,18,0,Sunday,0,Clear,0.3,0.2879,0.52,0.2537,10,171,181,330,181,181
9502,2012-02-05,Spring,2012,Feb,19,0,Sunday,0,Clear,0.3,0.2879,0.52,0.2239,6,63,69,330,69,69
9503,2012-02-05,Spring,2012,Feb,20,0,Sunday,0,Clear,0.28,0.2727,0.56,0.194,3,47,50,330,50,50
9504,2012-02-05,Spring,2012,Feb,21,0,Sunday,0,Clear,0.28,0.2879,0.56,0.1045,6,60,66,330,66,66
9505,2012-02-05,Spring,2012,Feb,22,0,Sunday,0,Clear,0.26,0.2727,0.6,0.1045,9,182,191,330,191,191
9506,2012-02-05,Spring,2012,Feb,23,0,Sunday,0,Clear,0.24,0.2424,0.7,0.1343,4,38,42,330,42,42
9507,2012-02-06,Spring,2012,Feb,0,0,Monday,1,Clear,0.24,0.2424,0.65,0.1343,7,14,21,329,21,21
9508,2012-02-06,Spring,2012,Feb,1,0,Monday,1,Clear,0.22,0.2576,0.75,0.0896,0,6,6,329,6,6
9509,2012-02-06,Spring,2012,Feb,2,0,Monday,1,Clear,0.22,0.2727,0.75,0.0,0,3,3,329,3,3
9510,2012-02-06,Spring,2012,Feb,4,0,Monday,1,Clear,0.18,0.2121,0.8,0.1045,0,2,2,329,2,2
9511,2012-02-06,Spring,2012,Feb,5,0,Monday,1,Clear,0.18,0.2121,0.8,0.1045,0,17,17,329,17,17
9512,2012-02-06,Spring,2012,Feb,6,0,Monday,1,Clear,0.16,0.1818,0.86,0.1045,0,72,72,329,72,72
9513,2012-02-06,Spring,2012,Feb,7,0,Monday,1,Clear,0.16,0.1818,0.86,0.1045,5,229,234,329,234,234
9514,2012-02-06,Spring,2012,Feb,8,0,Monday,1,Clear,0.16,0.1818,0.86,0.1343,10,434,444,329,444,444
9515,2012-02-06,Spring,2012,Feb,9,0,Monday,1,Clear,0.18,0.2121,0.8,0.1045,8,269,277,329,277,277
9516,2012-02-06,Spring,2012,Feb,10,0,Monday,1,Clear,0.22,0.2424,0.75,0.1045,20,96,116,329,116,116
9517,2012-02-06,Spring,2012,Feb,11,0,Monday,1,Clear,0.26,0.2727,0.7,0.1343,12,104,116,329,116,116
9518,2012-02-06,Spring,2012,Feb,12,0,Monday,1,Clear,0.32,0.3182,0.61,0.1642,19,131,150,329,150,150
9519,2012-02-06,Spring,2012,Feb,13,0,Monday,1,Clear,0.38,0.3939,0.4,0.2239,17,124,141,329,141,141
9520,2012-02-06,Spring,2012,Feb,14,0,Monday,1,Clear,0.4,0.4091,0.35,0.1642,14,126,140,329,140,140
9521,2012-02-06,Spring,2012,Feb,15,0,Monday,1,Clear,0.42,0.4242,0.32,0.2836,25,146,171,329,171,171
9522,2012-02-06,Spring,2012,Feb,16,0,Monday,1,Clear,0.4,0.4091,0.43,0.2537,13,215,228,329,228,228
9523,2012-02-06,Spring,2012,Feb,17,0,Monday,1,Clear,0.4,0.4091,0.43,0.2537,13,417,430,329,430,430
9524,2012-02-06,Spring,2012,Feb,18,0,Monday,1,Clear,0.38,0.3939,0.43,0.2239,11,426,437,329,437,437
9525,2012-02-06,Spring,2012,Feb,19,0,Monday,1,Clear,0.36,0.3333,0.43,0.2537,7,284,291,329,291,291
9526,2012-02-06,Spring,2012,Feb,20,0,Monday,1,Clear,0.34,0.3333,0.46,0.1642,7,194,201,329,201,201
9527,2012-02-06,Spring,2012,Feb,21,0,Monday,1,Clear,0.32,0.3182,0.57,0.1642,11,143,154,329,154,154
9528,2012-02-06,Spring,2012,Feb,22,0,Monday,1,Clear,0.3,0.303,0.65,0.1343,4,83,87,329,87,87
9529,2012-02-06,Spring,2012,Feb,23,0,Monday,1,Clear,0.3,0.303,0.65,0.1343,3,43,46,329,46,46
9530,2012-02-07,Spring,2012,Feb,0,0,Tuesday,1,Clear,0.3,0.2879,0.7,0.194,1,22,23,328,23,23
9531,2012-02-07,Spring,2012,Feb,1,0,Tuesday,1,Clear,0.28,0.2879,0.61,0.1343,8,6,14,328,14,14
9532,2012-02-07,Spring,2012,Feb,2,0,Tuesday,1,Clear,0.3,0.3333,0.61,0.0,0,4,4,328,4,4
9533,2012-02-07,Spring,2012,Feb,3,0,Tuesday,1,Misty,0.3,0.3333,0.7,0.0,1,1,2,328,2,2
9534,2012-02-07,Spring,2012,Feb,4,0,Tuesday,1,Misty,0.3,0.3333,0.7,0.0,0,3,3,328,3,3
9535,2012-02-07,Spring,2012,Feb,5,0,Tuesday,1,Clear,0.32,0.3333,0.49,0.0896,0,15,15,328,15,15
9536,2012-02-07,Spring,2012,Feb,6,0,Tuesday,1,Clear,0.32,0.303,0.45,0.2985,2,98,100,328,100,100
9537,2012-02-07,Spring,2012,Feb,7,0,Tuesday,1,Clear,0.32,0.3485,0.45,0.0,6,293,299,328,299,299
9538,2012-02-07,Spring,2012,Feb,8,0,Tuesday,1,Clear,0.3,0.3182,0.49,0.0,7,522,529,328,529,529
9539,2012-02-07,Spring,2012,Feb,9,0,Tuesday,1,Clear,0.32,0.3333,0.49,0.0,11,278,289,328,289,289
9540,2012-02-07,Spring,2012,Feb,10,0,Tuesday,1,Clear,0.34,0.3333,0.46,0.1642,12,104,116,328,116,116
9541,2012-02-07,Spring,2012,Feb,11,0,Tuesday,1,Clear,0.36,0.3485,0.46,0.194,9,120,129,328,129,129
9542,2012-02-07,Spring,2012,Feb,12,0,Tuesday,1,Clear,0.4,0.4091,0.4,0.3284,9,163,172,328,172,172
9543,2012-02-07,Spring,2012,Feb,13,0,Tuesday,1,Clear,0.44,0.4394,0.38,0.2537,15,169,184,328,184,184
9544,2012-02-07,Spring,2012,Feb,14,0,Tuesday,1,Clear,0.44,0.4394,0.38,0.2537,11,127,138,328,138,138
9545,2012-02-07,Spring,2012,Feb,15,0,Tuesday,1,Clear,0.44,0.4394,0.38,0.194,13,133,146,328,146,146
9546,2012-02-07,Spring,2012,Feb,16,0,Tuesday,1,Clear,0.44,0.4394,0.35,0.2537,19,257,276,328,276,276
9547,2012-02-07,Spring,2012,Feb,17,0,Tuesday,1,Clear,0.44,0.4394,0.35,0.194,15,494,509,328,509,509
9548,2012-02-07,Spring,2012,Feb,18,0,Tuesday,1,Clear,0.42,0.4242,0.38,0.194,10,508,518,328,518,518
9549,2012-02-07,Spring,2012,Feb,19,0,Tuesday,1,Clear,0.38,0.3939,0.43,0.2239,11,327,338,328,338,338
9550,2012-02-07,Spring,2012,Feb,20,0,Tuesday,1,Clear,0.36,0.3485,0.5,0.1343,6,206,212,328,212,212
9551,2012-02-07,Spring,2012,Feb,21,0,Tuesday,1,Clear,0.34,0.3485,0.61,0.1045,20,170,190,328,190,190
9552,2012-02-07,Spring,2012,Feb,22,0,Tuesday,1,Clear,0.32,0.3182,0.57,0.194,11,107,118,328,118,118
9553,2012-02-07,Spring,2012,Feb,23,0,Tuesday,1,Clear,0.32,0.3333,0.57,0.1343,2,49,51,328,51,51
9554,2012-02-08,Spring,2012,Feb,0,0,Wednesday,1,Clear,0.3,0.2879,0.56,0.2239,2,21,23,327,23,23
9555,2012-02-08,Spring,2012,Feb,1,0,Wednesday,1,Clear,0.28,0.2727,0.61,0.1642,1,9,10,327,10,10
9556,2012-02-08,Spring,2012,Feb,2,0,Wednesday,1,Clear,0.26,0.303,0.65,0.0,0,1,1,327,1,1
9557,2012-02-08,Spring,2012,Feb,3,0,Wednesday,1,Clear,0.26,0.303,0.65,0.0,0,1,1,327,1,1
9558,2012-02-08,Spring,2012,Feb,4,0,Wednesday,1,Clear,0.24,0.2576,0.7,0.0896,0,1,1,327,1,1
9559,2012-02-08,Spring,2012,Feb,5,0,Wednesday,1,Clear,0.24,0.2576,0.7,0.0896,0,20,20,327,20,20
9560,2012-02-08,Spring,2012,Feb,6,0,Wednesday,1,Misty,0.24,0.2879,0.7,0.0,3,95,98,327,98,98
9561,2012-02-08,Spring,2012,Feb,7,0,Wednesday,1,Misty,0.24,0.2576,0.7,0.1045,5,276,281,327,281,281
9562,2012-02-08,Spring,2012,Feb,8,0,Wednesday,1,Misty,0.24,0.2273,0.7,0.2239,13,495,508,327,508,508
9563,2012-02-08,Spring,2012,Feb,9,0,Wednesday,1,Misty,0.24,0.2576,0.7,0.1642,8,245,253,327,253,253
9564,2012-02-08,Spring,2012,Feb,10,0,Wednesday,1,Misty,0.26,0.2576,0.7,0.2239,1,107,108,327,108,108
9565,2012-02-08,Spring,2012,Feb,11,0,Wednesday,1,Misty,0.26,0.2576,0.65,0.2239,5,97,102,327,102,102
9566,2012-02-08,Spring,2012,Feb,12,0,Wednesday,1,Misty,0.28,0.2576,0.65,0.2836,14,124,138,327,138,138
9567,2012-02-08,Spring,2012,Feb,13,0,Wednesday,1,Misty,0.28,0.2879,0.61,0.1045,15,111,126,327,126,126
9568,2012-02-08,Spring,2012,Feb,14,0,Wednesday,1,Misty,0.3,0.303,0.56,0.1642,8,100,108,327,108,108
9569,2012-02-08,Spring,2012,Feb,15,0,Wednesday,1,Light_rainsnow,0.3,0.3182,0.61,0.1045,5,49,54,327,54,54
9570,2012-02-08,Spring,2012,Feb,16,0,Wednesday,1,Light_rainsnow,0.26,0.2727,0.81,0.1045,2,73,75,327,75,75
9571,2012-02-08,Spring,2012,Feb,17,0,Wednesday,1,Light_rainsnow,0.24,0.2576,0.87,0.1045,8,147,155,327,155,155
9572,2012-02-08,Spring,2012,Feb,18,0,Wednesday,1,Light_rainsnow,0.24,0.2576,0.87,0.1045,4,163,167,327,167,167
9573,2012-02-08,Spring,2012,Feb,19,0,Wednesday,1,Light_rainsnow,0.24,0.2576,0.87,0.1045,3,158,161,327,161,161
9574,2012-02-08,Spring,2012,Feb,20,0,Wednesday,1,Light_rainsnow,0.24,0.2424,0.87,0.1343,3,122,125,327,125,125
9575,2012-02-08,Spring,2012,Feb,21,0,Wednesday,1,Light_rainsnow,0.24,0.2273,0.87,0.194,3,126,129,327,129,129
9576,2012-02-08,Spring,2012,Feb,22,0,Wednesday,1,Misty,0.24,0.2424,0.87,0.1343,3,95,98,327,98,98
9577,2012-02-08,Spring,2012,Feb,23,0,Wednesday,1,Misty,0.24,0.2424,0.87,0.1642,3,57,60,327,60,60
9578,2012-02-09,Spring,2012,Feb,0,0,Thursday,1,Misty,0.24,0.2424,0.87,0.1642,3,23,26,326,26,26
9579,2012-02-09,Spring,2012,Feb,1,0,Thursday,1,Misty,0.24,0.2424,0.87,0.1343,2,10,12,326,12,12
9580,2012-02-09,Spring,2012,Feb,2,0,Thursday,1,Clear,0.22,0.2273,0.8,0.1343,0,2,2,326,2,2
9581,2012-02-09,Spring,2012,Feb,3,0,Thursday,1,Clear,0.22,0.2121,0.8,0.2836,0,4,4,326,4,4
9582,2012-02-09,Spring,2012,Feb,4,0,Thursday,1,Misty,0.22,0.197,0.75,0.4478,0,1,1,326,1,1
9583,2012-02-09,Spring,2012,Feb,5,0,Thursday,1,Clear,0.2,0.1818,0.75,0.2836,0,18,18,326,18,18
9584,2012-02-09,Spring,2012,Feb,6,0,Thursday,1,Clear,0.2,0.1818,0.75,0.2836,1,75,76,326,76,76
9585,2012-02-09,Spring,2012,Feb,7,0,Thursday,1,Clear,0.2,0.197,0.69,0.2537,4,263,267,326,267,267
9586,2012-02-09,Spring,2012,Feb,8,0,Thursday,1,Clear,0.2,0.197,0.64,0.2537,11,473,484,326,484,484
9587,2012-02-09,Spring,2012,Feb,9,0,Thursday,1,Clear,0.2,0.197,0.59,0.2239,9,229,238,326,238,238
9588,2012-02-09,Spring,2012,Feb,10,0,Thursday,1,Clear,0.22,0.2121,0.51,0.2239,7,90,97,326,97,97
9589,2012-02-09,Spring,2012,Feb,11,0,Thursday,1,Clear,0.24,0.2273,0.52,0.2239,4,95,99,326,99,99
9590,2012-02-09,Spring,2012,Feb,12,0,Thursday,1,Clear,0.26,0.2273,0.48,0.3284,10,148,158,326,158,158
9591,2012-02-09,Spring,2012,Feb,13,0,Thursday,1,Clear,0.3,0.2727,0.42,0.3284,10,144,154,326,154,154
9592,2012-02-09,Spring,2012,Feb,14,0,Thursday,1,Clear,0.32,0.303,0.39,0.2985,18,126,144,326,144,144
9593,2012-02-09,Spring,2012,Feb,15,0,Thursday,1,Clear,0.32,0.303,0.36,0.2985,14,120,134,326,134,134
9594,2012-02-09,Spring,2012,Feb,16,0,Thursday,1,Clear,0.34,0.3333,0.36,0.0,15,223,238,326,238,238
9595,2012-02-09,Spring,2012,Feb,17,0,Thursday,1,Clear,0.34,0.3333,0.34,0.1343,12,387,399,326,399,399
9596,2012-02-09,Spring,2012,Feb,18,0,Thursday,1,Clear,0.34,0.3333,0.31,0.1642,13,404,417,326,417,417
9597,2012-02-09,Spring,2012,Feb,19,0,Thursday,1,Clear,0.32,0.3333,0.33,0.1045,8,287,295,326,295,295
9598,2012-02-09,Spring,2012,Feb,20,0,Thursday,1,Clear,0.32,0.3485,0.36,0.0,2,197,199,326,199,199
9599,2012-02-09,Spring,2012,Feb,21,0,Thursday,1,Clear,0.3,0.3182,0.52,0.0896,8,169,177,326,177,177
9600,2012-02-09,Spring,2012,Feb,22,0,Thursday,1,Misty,0.3,0.3333,0.56,0.0,3,104,107,326,107,107
9601,2012-02-09,Spring,2012,Feb,23,0,Thursday,1,Misty,0.3,0.3333,0.52,0.0,9,75,84,326,84,84
9602,2012-02-10,Spring,2012,Feb,0,0,Friday,1,Misty,0.28,0.303,0.65,0.0896,4,39,43,325,43,43
9603,2012-02-10,Spring,2012,Feb,1,0,Friday,1,Misty,0.28,0.303,0.61,0.0896,2,11,13,325,13,13
9604,2012-02-10,Spring,2012,Feb,2,0,Friday,1,Clear,0.26,0.2879,0.52,0.0896,7,9,16,325,16,16
9605,2012-02-10,Spring,2012,Feb,3,0,Friday,1,Clear,0.26,0.2879,0.56,0.0896,0,5,5,325,5,5
9606,2012-02-10,Spring,2012,Feb,4,0,Friday,1,Clear,0.26,0.2879,0.56,0.0896,0,2,2,325,2,2
9607,2012-02-10,Spring,2012,Feb,5,0,Friday,1,Clear,0.24,0.2273,0.52,0.2239,0,17,17,325,17,17
9608,2012-02-10,Spring,2012,Feb,6,0,Friday,1,Clear,0.2,0.197,0.59,0.194,3,61,64,325,64,64
9609,2012-02-10,Spring,2012,Feb,7,0,Friday,1,Clear,0.2,0.2121,0.59,0.1642,5,225,230,325,230,230
9610,2012-02-10,Spring,2012,Feb,8,0,Friday,1,Clear,0.2,0.2121,0.59,0.1642,1,447,448,325,448,448
9611,2012-02-10,Spring,2012,Feb,9,0,Friday,1,Clear,0.22,0.2273,0.55,0.1642,10,265,275,325,275,275
9612,2012-02-10,Spring,2012,Feb,10,0,Friday,1,Misty,0.26,0.2727,0.48,0.1343,5,119,124,325,124,124
9613,2012-02-10,Spring,2012,Feb,11,0,Friday,1,Misty,0.28,0.2879,0.45,0.1045,19,134,153,325,153,153
9614,2012-02-10,Spring,2012,Feb,12,0,Friday,1,Misty,0.3,0.303,0.42,0.1343,8,168,176,325,176,176
9615,2012-02-10,Spring,2012,Feb,13,0,Friday,1,Misty,0.3,0.3182,0.42,0.0896,22,170,192,325,192,192
9616,2012-02-10,Spring,2012,Feb,14,0,Friday,1,Misty,0.32,0.3333,0.39,0.0896,8,138,146,325,146,146
9617,2012-02-10,Spring,2012,Feb,15,0,Friday,1,Misty,0.32,0.3333,0.45,0.1343,27,164,191,325,191,191
9618,2012-02-10,Spring,2012,Feb,16,0,Friday,1,Misty,0.34,0.3182,0.42,0.2537,28,240,268,325,268,268
9619,2012-02-10,Spring,2012,Feb,17,0,Friday,1,Misty,0.34,0.3333,0.42,0.194,15,381,396,325,396,396
9620,2012-02-10,Spring,2012,Feb,18,0,Friday,1,Light_rainsnow,0.3,0.303,0.61,0.1343,14,345,359,325,359,359
9621,2012-02-10,Spring,2012,Feb,19,0,Friday,1,Misty,0.32,0.3485,0.57,0.0,16,246,262,325,262,262
9622,2012-02-10,Spring,2012,Feb,20,0,Friday,1,Misty,0.32,0.3485,0.57,0.0,7,144,151,325,151,151
9623,2012-02-10,Spring,2012,Feb,21,0,Friday,1,Misty,0.32,0.3333,0.66,0.0896,14,108,122,325,122,122
9624,2012-02-10,Spring,2012,Feb,22,0,Friday,1,Misty,0.32,0.3485,0.66,0.0,11,102,113,325,113,113
9625,2012-02-10,Spring,2012,Feb,23,0,Friday,1,Misty,0.3,0.3182,0.7,0.0896,1,64,65,325,65,65
9626,2012-02-11,Spring,2012,Feb,0,0,Saturday,0,Misty,0.3,0.303,0.7,0.1343,3,50,53,324,53,53
9627,2012-02-11,Spring,2012,Feb,1,0,Saturday,0,Light_rainsnow,0.28,0.2879,0.81,0.1343,2,43,45,324,45,45
9628,2012-02-11,Spring,2012,Feb,2,0,Saturday,0,Light_rainsnow,0.26,0.2576,0.81,0.194,2,24,26,324,26,26
9629,2012-02-11,Spring,2012,Feb,3,0,Saturday,0,Light_rainsnow,0.24,0.2273,0.87,0.2239,0,9,9,324,9,9
9630,2012-02-11,Spring,2012,Feb,4,0,Saturday,0,Light_rainsnow,0.24,0.2273,0.87,0.2239,0,4,4,324,4,4
9631,2012-02-11,Spring,2012,Feb,5,0,Saturday,0,Light_rainsnow,0.22,0.2273,0.93,0.1642,0,2,2,324,2,2
9632,2012-02-11,Spring,2012,Feb,6,0,Saturday,0,Light_rainsnow,0.22,0.2273,0.93,0.1343,1,8,9,324,9,9
9633,2012-02-11,Spring,2012,Feb,7,0,Saturday,0,Light_rainsnow,0.22,0.2273,0.93,0.1343,0,19,19,324,19,19
9634,2012-02-11,Spring,2012,Feb,8,0,Saturday,0,Light_rainsnow,0.22,0.2273,0.93,0.1343,1,77,78,324,78,78
9635,2012-02-11,Spring,2012,Feb,9,0,Saturday,0,Light_rainsnow,0.22,0.2424,0.93,0.1045,5,85,90,324,90,90
9636,2012-02-11,Spring,2012,Feb,10,0,Saturday,0,Light_rainsnow,0.22,0.2424,0.93,0.1045,23,143,166,324,166,166
9637,2012-02-11,Spring,2012,Feb,11,0,Saturday,0,Misty,0.24,0.2576,0.81,0.1045,26,157,183,324,183,183
9638,2012-02-11,Spring,2012,Feb,12,0,Saturday,0,Misty,0.26,0.2576,0.81,0.1642,25,196,221,324,221,221
9639,2012-02-11,Spring,2012,Feb,13,0,Saturday,0,Misty,0.26,0.2424,0.81,0.2836,18,217,235,324,235,235
9640,2012-02-11,Spring,2012,Feb,14,0,Saturday,0,Misty,0.26,0.2424,0.81,0.2537,38,205,243,324,243,243
9641,2012-02-11,Spring,2012,Feb,15,0,Saturday,0,Misty,0.3,0.2727,0.61,0.2985,12,112,124,324,124,124
9642,2012-02-11,Spring,2012,Feb,16,0,Saturday,0,Light_rainsnow,0.22,0.197,0.75,0.4179,12,134,146,324,146,146
9643,2012-02-11,Spring,2012,Feb,17,0,Saturday,0,Light_rainsnow,0.22,0.1818,0.69,0.4627,13,131,144,324,144,144
9644,2012-02-11,Spring,2012,Feb,18,0,Saturday,0,Misty,0.22,0.1818,0.47,0.6567,3,105,108,324,108,108
9645,2012-02-11,Spring,2012,Feb,19,0,Saturday,0,Misty,0.2,0.1515,0.4,0.5522,2,85,87,324,87,87
9646,2012-02-11,Spring,2012,Feb,20,0,Saturday,0,Misty,0.16,0.1212,0.43,0.5522,1,62,63,324,63,63
9647,2012-02-11,Spring,2012,Feb,21,0,Saturday,0,Clear,0.14,0.0758,0.43,0.6418,5,43,48,324,48,48
9648,2012-02-11,Spring,2012,Feb,22,0,Saturday,0,Misty,0.14,0.1061,0.39,0.3881,0,46,46,324,46,46
9649,2012-02-11,Spring,2012,Feb,23,0,Saturday,0,Light_rainsnow,0.12,0.0758,0.5,0.4925,0,20,20,324,20,20
9650,2012-02-12,Spring,2012,Feb,0,0,Sunday,0,Light_rainsnow,0.1,0.0758,0.68,0.3881,0,21,21,323,21,21
9651,2012-02-12,Spring,2012,Feb,1,0,Sunday,0,Light_rainsnow,0.08,0.0455,0.79,0.4627,0,24,24,323,24,24
9652,2012-02-12,Spring,2012,Feb,2,0,Sunday,0,Misty,0.1,0.0606,0.58,0.5821,1,26,27,323,27,27
9653,2012-02-12,Spring,2012,Feb,3,0,Sunday,0,Misty,0.1,0.0455,0.46,0.6866,0,14,14,323,14,14
9654,2012-02-12,Spring,2012,Feb,4,0,Sunday,0,Misty,0.1,0.0455,0.46,0.7164,0,1,1,323,1,1
9655,2012-02-12,Spring,2012,Feb,5,0,Sunday,0,Clear,0.1,0.0758,0.49,0.3881,0,3,3,323,3,3
9656,2012-02-12,Spring,2012,Feb,6,0,Sunday,0,Clear,0.1,0.0758,0.49,0.3881,0,2,2,323,2,2
9657,2012-02-12,Spring,2012,Feb,7,0,Sunday,0,Clear,0.08,0.0909,0.53,0.194,0,18,18,323,18,18
9658,2012-02-12,Spring,2012,Feb,8,0,Sunday,0,Clear,0.08,0.0758,0.53,0.2537,0,26,26,323,26,26
9659,2012-02-12,Spring,2012,Feb,9,0,Sunday,0,Clear,0.1,0.0909,0.49,0.2985,3,60,63,323,63,63
9660,2012-02-12,Spring,2012,Feb,10,0,Sunday,0,Clear,0.12,0.1061,0.42,0.3582,8,83,91,323,91,91
9661,2012-02-12,Spring,2012,Feb,11,0,Sunday,0,Clear,0.12,0.1061,0.42,0.2985,3,121,124,323,124,124
9662,2012-02-12,Spring,2012,Feb,12,0,Sunday,0,Clear,0.14,0.0758,0.39,0.6418,7,133,140,323,140,140
9663,2012-02-12,Spring,2012,Feb,13,0,Sunday,0,Clear,0.16,0.1212,0.4,0.4478,10,128,138,323,138,138
9664,2012-02-12,Spring,2012,Feb,14,0,Sunday,0,Clear,0.16,0.1212,0.4,0.5224,9,102,111,323,111,111
9665,2012-02-12,Spring,2012,Feb,15,0,Sunday,0,Clear,0.16,0.1212,0.4,0.5522,5,150,155,323,155,155
9666,2012-02-12,Spring,2012,Feb,16,0,Sunday,0,Clear,0.2,0.1667,0.34,0.4627,16,148,164,323,164,164
9667,2012-02-12,Spring,2012,Feb,17,0,Sunday,0,Clear,0.18,0.1515,0.37,0.4179,4,83,87,323,87,87
9668,2012-02-12,Spring,2012,Feb,18,0,Sunday,0,Clear,0.16,0.1212,0.4,0.4627,4,92,96,323,96,96
9669,2012-02-12,Spring,2012,Feb,19,0,Sunday,0,Clear,0.16,0.1364,0.4,0.2836,2,78,80,323,80,80
9670,2012-02-12,Spring,2012,Feb,20,0,Sunday,0,Clear,0.14,0.1212,0.42,0.3284,1,56,57,323,57,57
9671,2012-02-12,Spring,2012,Feb,21,0,Sunday,0,Clear,0.14,0.1212,0.43,0.2985,0,36,36,323,36,36
9672,2012-02-12,Spring,2012,Feb,22,0,Sunday,0,Clear,0.14,0.1515,0.43,0.1642,0,28,28,323,28,28
9673,2012-02-12,Spring,2012,Feb,23,0,Sunday,0,Clear,0.14,0.1364,0.43,0.2239,0,23,23,323,23,23
9674,2012-02-13,Spring,2012,Feb,0,0,Monday,1,Clear,0.14,0.1364,0.46,0.2239,0,9,9,322,9,9
9675,2012-02-13,Spring,2012,Feb,1,0,Monday,1,Clear,0.12,0.1212,0.5,0.2239,0,6,6,322,6,6
9676,2012-02-13,Spring,2012,Feb,2,0,Monday,1,Clear,0.14,0.1364,0.46,0.194,0,4,4,322,4,4
9677,2012-02-13,Spring,2012,Feb,3,0,Monday,1,Clear,0.12,0.1515,0.54,0.1045,0,1,1,322,1,1
9678,2012-02-13,Spring,2012,Feb,4,0,Monday,1,Clear,0.12,0.1667,0.54,0.0896,0,2,2,322,2,2
9679,2012-02-13,Spring,2012,Feb,5,0,Monday,1,Clear,0.1,0.1212,0.58,0.1343,0,17,17,322,17,17
9680,2012-02-13,Spring,2012,Feb,6,0,Monday,1,Clear,0.1,0.1061,0.54,0.2239,1,71,72,322,72,72
9681,2012-02-13,Spring,2012,Feb,7,0,Monday,1,Clear,0.1,0.1061,0.54,0.194,1,194,195,322,195,195
9682,2012-02-13,Spring,2012,Feb,8,0,Monday,1,Clear,0.1,0.1212,0.54,0.1343,4,413,417,322,417,417
9683,2012-02-13,Spring,2012,Feb,9,0,Monday,1,Clear,0.12,0.1364,0.5,0.194,7,198,205,322,205,205
9684,2012-02-13,Spring,2012,Feb,10,0,Monday,1,Clear,0.14,0.1515,0.5,0.1343,1,70,71,322,71,71
9685,2012-02-13,Spring,2012,Feb,11,0,Monday,1,Clear,0.22,0.2273,0.37,0.194,5,85,90,322,90,90
9686,2012-02-13,Spring,2012,Feb,12,0,Monday,1,Clear,0.28,0.2576,0.28,0.3284,7,111,118,322,118,118
9687,2012-02-13,Spring,2012,Feb,13,0,Monday,1,Clear,0.32,0.303,0.22,0.2239,11,129,140,322,140,140
9688,2012-02-13,Spring,2012,Feb,14,0,Monday,1,Clear,0.34,0.3485,0.23,0.1045,10,125,135,322,135,135
9689,2012-02-13,Spring,2012,Feb,15,0,Monday,1,Clear,0.36,0.3485,0.27,0.1343,10,145,155,322,155,155
9690,2012-02-13,Spring,2012,Feb,16,0,Monday,1,Clear,0.36,0.3485,0.23,0.194,5,206,211,322,211,211
9691,2012-02-13,Spring,2012,Feb,17,0,Monday,1,Clear,0.36,0.3485,0.23,0.194,8,399,407,322,407,407
9692,2012-02-13,Spring,2012,Feb,18,0,Monday,1,Clear,0.34,0.3182,0.25,0.2537,6,399,405,322,405,405
9693,2012-02-13,Spring,2012,Feb,19,0,Monday,1,Clear,0.34,0.3333,0.25,0.1343,7,256,263,322,263,263
9694,2012-02-13,Spring,2012,Feb,20,0,Monday,1,Clear,0.3,0.303,0.42,0.1642,4,210,214,322,214,214
9695,2012-02-13,Spring,2012,Feb,21,0,Monday,1,Clear,0.28,0.2879,0.45,0.1343,2,145,147,322,147,147
9696,2012-02-13,Spring,2012,Feb,22,0,Monday,1,Clear,0.26,0.2727,0.56,0.1045,3,99,102,322,102,102
9697,2012-02-13,Spring,2012,Feb,23,0,Monday,1,Clear,0.28,0.3182,0.41,0.0,2,34,36,322,36,36
9698,2012-02-14,Spring,2012,Feb,0,0,Tuesday,1,Misty,0.26,0.303,0.6,0.0,0,14,14,321,14,14
9699,2012-02-14,Spring,2012,Feb,1,0,Tuesday,1,Misty,0.26,0.303,0.56,0.0,0,6,6,321,6,6
9700,2012-02-14,Spring,2012,Feb,2,0,Tuesday,1,Misty,0.28,0.3182,0.41,0.0,0,3,3,321,3,3
9701,2012-02-14,Spring,2012,Feb,3,0,Tuesday,1,Misty,0.26,0.303,0.52,0.0,0,3,3,321,3,3
9702,2012-02-14,Spring,2012,Feb,4,0,Tuesday,1,Misty,0.26,0.2727,0.65,0.1045,0,2,2,321,2,2
9703,2012-02-14,Spring,2012,Feb,5,0,Tuesday,1,Misty,0.26,0.2727,0.65,0.1045,2,20,22,321,22,22
9704,2012-02-14,Spring,2012,Feb,6,0,Tuesday,1,Misty,0.26,0.303,0.56,0.0,1,89,90,321,90,90
9705,2012-02-14,Spring,2012,Feb,7,0,Tuesday,1,Misty,0.24,0.2576,0.6,0.0896,4,276,280,321,280,280
9706,2012-02-14,Spring,2012,Feb,8,0,Tuesday,1,Misty,0.24,0.2879,0.7,0.0,3,510,513,321,513,513
9707,2012-02-14,Spring,2012,Feb,9,0,Tuesday,1,Misty,0.26,0.2879,0.56,0.0896,6,256,262,321,262,262
9708,2012-02-14,Spring,2012,Feb,10,0,Tuesday,1,Misty,0.26,0.2727,0.6,0.1343,8,90,98,321,98,98
9709,2012-02-14,Spring,2012,Feb,11,0,Tuesday,1,Misty,0.3,0.303,0.45,0.1642,5,107,112,321,112,112
9710,2012-02-14,Spring,2012,Feb,12,0,Tuesday,1,Misty,0.3,0.2879,0.52,0.2239,10,162,172,321,172,172
9711,2012-02-14,Spring,2012,Feb,13,0,Tuesday,1,Misty,0.36,0.3333,0.4,0.2537,6,167,173,321,173,173
9712,2012-02-14,Spring,2012,Feb,14,0,Tuesday,1,Clear,0.4,0.4091,0.4,0.2239,13,111,124,321,124,124
9713,2012-02-14,Spring,2012,Feb,15,0,Tuesday,1,Misty,0.42,0.4242,0.38,0.4478,7,138,145,321,145,145
9714,2012-02-14,Spring,2012,Feb,16,0,Tuesday,1,Clear,0.42,0.4242,0.35,0.2985,15,251,266,321,266,266
9715,2012-02-14,Spring,2012,Feb,17,0,Tuesday,1,Clear,0.42,0.4242,0.38,0.3582,19,504,523,321,523,523
9716,2012-02-14,Spring,2012,Feb,18,0,Tuesday,1,Misty,0.38,0.3939,0.46,0.2985,8,398,406,321,406,406
9717,2012-02-14,Spring,2012,Feb,19,0,Tuesday,1,Misty,0.36,0.3485,0.5,0.1642,11,270,281,321,281,281
9718,2012-02-14,Spring,2012,Feb,20,0,Tuesday,1,Misty,0.38,0.3939,0.46,0.1343,6,178,184,321,184,184
9719,2012-02-14,Spring,2012,Feb,21,0,Tuesday,1,Misty,0.36,0.3636,0.5,0.1045,4,105,109,321,109,109
9720,2012-02-14,Spring,2012,Feb,22,0,Tuesday,1,Misty,0.36,0.3636,0.5,0.1045,5,72,77,321,77,77
9721,2012-02-14,Spring,2012,Feb,23,0,Tuesday,1,Misty,0.36,0.3636,0.5,0.0896,2,55,57,321,57,57
9722,2012-02-15,Spring,2012,Feb,0,0,Wednesday,1,Clear,0.32,0.3485,0.57,0.0,0,22,22,320,22,22
9723,2012-02-15,Spring,2012,Feb,1,0,Wednesday,1,Clear,0.34,0.3636,0.53,0.0,0,5,5,320,5,5
9724,2012-02-15,Spring,2012,Feb,2,0,Wednesday,1,Clear,0.3,0.3333,0.61,0.0,0,4,4,320,4,4
9725,2012-02-15,Spring,2012,Feb,3,0,Wednesday,1,Clear,0.28,0.3182,0.75,0.0,0,3,3,320,3,3
9726,2012-02-15,Spring,2012,Feb,4,0,Wednesday,1,Clear,0.28,0.2879,0.7,0.1045,0,1,1,320,1,1
9727,2012-02-15,Spring,2012,Feb,5,0,Wednesday,1,Clear,0.28,0.2879,0.7,0.1045,0,25,25,320,25,25
9728,2012-02-15,Spring,2012,Feb,6,0,Wednesday,1,Clear,0.3,0.303,0.61,0.1343,3,92,95,320,95,95
9729,2012-02-15,Spring,2012,Feb,7,0,Wednesday,1,Misty,0.3,0.2879,0.65,0.194,3,318,321,320,321,321
9730,2012-02-15,Spring,2012,Feb,8,0,Wednesday,1,Clear,0.32,0.2879,0.61,0.3582,7,508,515,320,515,515
9731,2012-02-15,Spring,2012,Feb,9,0,Wednesday,1,Clear,0.32,0.303,0.61,0.3284,5,226,231,320,231,231
9732,2012-02-15,Spring,2012,Feb,10,0,Wednesday,1,Clear,0.34,0.303,0.57,0.2985,12,108,120,320,120,120
9733,2012-02-15,Spring,2012,Feb,11,0,Wednesday,1,Clear,0.36,0.3333,0.53,0.2836,13,125,138,320,138,138
9734,2012-02-15,Spring,2012,Feb,12,0,Wednesday,1,Clear,0.38,0.3939,0.46,0.3881,11,152,163,320,163,163
9735,2012-02-15,Spring,2012,Feb,13,0,Wednesday,1,Clear,0.4,0.4091,0.43,0.2836,11,159,170,320,170,170
9736,2012-02-15,Spring,2012,Feb,14,0,Wednesday,1,Clear,0.42,0.4242,0.41,0.3582,6,128,134,320,134,134
9737,2012-02-15,Spring,2012,Feb,15,0,Wednesday,1,Clear,0.42,0.4242,0.41,0.2239,7,164,171,320,171,171
9738,2012-02-15,Spring,2012,Feb,16,0,Wednesday,1,Clear,0.42,0.4242,0.38,0.194,9,222,231,320,231,231
9739,2012-02-15,Spring,2012,Feb,17,0,Wednesday,1,Clear,0.42,0.4242,0.38,0.194,17,470,487,320,487,487
9740,2012-02-15,Spring,2012,Feb,18,0,Wednesday,1,Clear,0.4,0.4091,0.4,0.2239,9,459,468,320,468,468
9741,2012-02-15,Spring,2012,Feb,19,0,Wednesday,1,Clear,0.38,0.3939,0.43,0.1642,9,302,311,320,311,311
9742,2012-02-15,Spring,2012,Feb,20,0,Wednesday,1,Clear,0.36,0.3485,0.46,0.1642,4,207,211,320,211,211
9743,2012-02-15,Spring,2012,Feb,21,0,Wednesday,1,Clear,0.34,0.3333,0.53,0.1642,8,170,178,320,178,178
9744,2012-02-15,Spring,2012,Feb,22,0,Wednesday,1,Clear,0.34,0.3485,0.49,0.1045,3,104,107,320,107,107
9745,2012-02-15,Spring,2012,Feb,23,0,Wednesday,1,Clear,0.34,0.3485,0.53,0.0896,4,54,58,320,58,58
9746,2012-02-16,Spring,2012,Feb,0,0,Thursday,1,Misty,0.3,0.303,0.7,0.1343,1,22,23,319,23,23
9747,2012-02-16,Spring,2012,Feb,1,0,Thursday,1,Misty,0.3,0.3333,0.7,0.0,0,5,5,319,5,5
9748,2012-02-16,Spring,2012,Feb,2,0,Thursday,1,Misty,0.3,0.3182,0.7,0.0896,1,6,7,319,7,7
9749,2012-02-16,Spring,2012,Feb,3,0,Thursday,1,Misty,0.3,0.3333,0.61,0.0,0,1,1,319,1,1
9750,2012-02-16,Spring,2012,Feb,4,0,Thursday,1,Light_rainsnow,0.3,0.3182,0.7,0.0896,0,3,3,319,3,3
9751,2012-02-16,Spring,2012,Feb,5,0,Thursday,1,Misty,0.3,0.3333,0.7,0.0,0,20,20,319,20,20
9752,2012-02-16,Spring,2012,Feb,6,0,Thursday,1,Misty,0.3,0.3182,0.7,0.0896,4,83,87,319,87,87
9753,2012-02-16,Spring,2012,Feb,7,0,Thursday,1,Misty,0.3,0.303,0.7,0.1343,3,285,288,319,288,288
9754,2012-02-16,Spring,2012,Feb,8,0,Thursday,1,Misty,0.3,0.3182,0.7,0.0896,9,489,498,319,498,498
9755,2012-02-16,Spring,2012,Feb,9,0,Thursday,1,Misty,0.3,0.303,0.7,0.1642,3,199,202,319,202,202
9756,2012-02-16,Spring,2012,Feb,10,0,Thursday,1,Light_rainsnow,0.32,0.3333,0.7,0.1343,2,42,44,319,44,44
9757,2012-02-16,Spring,2012,Feb,11,0,Thursday,1,Light_rainsnow,0.32,0.3333,0.7,0.1045,2,69,71,319,71,71
9758,2012-02-16,Spring,2012,Feb,12,0,Thursday,1,Light_rainsnow,0.32,0.3333,0.76,0.0896,1,44,45,319,45,45
9759,2012-02-16,Spring,2012,Feb,13,0,Thursday,1,Light_rainsnow,0.34,0.3182,0.71,0.2537,2,62,64,319,64,64
9760,2012-02-16,Spring,2012,Feb,14,0,Thursday,1,Light_rainsnow,0.32,0.3182,0.81,0.194,1,30,31,319,31,31
9761,2012-02-16,Spring,2012,Feb,15,0,Thursday,1,Light_rainsnow,0.34,0.3636,0.76,0.0,3,50,53,319,53,53
9762,2012-02-16,Spring,2012,Feb,16,0,Thursday,1,Light_rainsnow,0.34,0.3636,0.81,0.0,8,110,118,319,118,118
9763,2012-02-16,Spring,2012,Feb,17,0,Thursday,1,Light_rainsnow,0.34,0.3636,0.87,0.0,8,281,289,319,289,289
9764,2012-02-16,Spring,2012,Feb,18,0,Thursday,1,Light_rainsnow,0.34,0.3333,0.87,0.1343,8,345,353,319,353,353
9765,2012-02-16,Spring,2012,Feb,19,0,Thursday,1,Misty,0.32,0.3182,0.87,0.1642,4,254,258,319,258,258
9766,2012-02-16,Spring,2012,Feb,20,0,Thursday,1,Misty,0.32,0.3333,0.87,0.1343,5,211,216,319,216,216
9767,2012-02-16,Spring,2012,Feb,21,0,Thursday,1,Misty,0.34,0.3485,0.81,0.1045,3,142,145,319,145,145
9768,2012-02-16,Spring,2012,Feb,22,0,Thursday,1,Misty,0.32,0.3485,0.81,0.0,3,108,111,319,111,111
9769,2012-02-16,Spring,2012,Feb,23,0,Thursday,1,Clear,0.32,0.3333,0.81,0.0896,3,70,73,319,73,73
9770,2012-02-17,Spring,2012,Feb,0,0,Friday,1,Misty,0.3,0.3333,0.87,0.0,2,32,34,318,34,34
9771,2012-02-17,Spring,2012,Feb,1,0,Friday,1,Misty,0.3,0.3333,0.93,0.0,2,16,18,318,18,18
9772,2012-02-17,Spring,2012,Feb,2,0,Friday,1,Misty,0.3,0.3182,0.93,0.1045,1,11,12,318,12,12
9773,2012-02-17,Spring,2012,Feb,3,0,Friday,1,Misty,0.28,0.2879,0.93,0.1045,0,1,1,318,1,1
9774,2012-02-17,Spring,2012,Feb,4,0,Friday,1,Misty,0.28,0.2727,0.93,0.194,0,1,1,318,1,1
9775,2012-02-17,Spring,2012,Feb,5,0,Friday,1,Misty,0.28,0.2727,0.93,0.1642,0,16,16,318,16,16
9776,2012-02-17,Spring,2012,Feb,6,0,Friday,1,Misty,0.28,0.2879,0.96,0.1343,1,70,71,318,71,71
9777,2012-02-17,Spring,2012,Feb,7,0,Friday,1,Misty,0.28,0.2879,0.93,0.1045,4,222,226,318,226,226
9778,2012-02-17,Spring,2012,Feb,8,0,Friday,1,Misty,0.26,0.303,1.0,0.0,4,516,520,318,520,520
9779,2012-02-17,Spring,2012,Feb,9,0,Friday,1,Misty,0.26,0.303,1.0,0.0,8,275,283,318,283,283
9780,2012-02-17,Spring,2012,Feb,10,0,Friday,1,Clear,0.34,0.3182,0.71,0.2836,13,103,116,318,116,116
9781,2012-02-17,Spring,2012,Feb,11,0,Friday,1,Clear,0.36,0.3333,0.62,0.4179,9,133,142,318,142,142
9782,2012-02-17,Spring,2012,Feb,12,0,Friday,1,Clear,0.38,0.3939,0.46,0.3881,21,177,198,318,198,198
9783,2012-02-17,Spring,2012,Feb,13,0,Friday,1,Clear,0.4,0.4091,0.43,0.3582,34,171,205,318,205,205
9784,2012-02-17,Spring,2012,Feb,14,0,Friday,1,Clear,0.4,0.4091,0.37,0.3582,33,137,170,318,170,170
9785,2012-02-17,Spring,2012,Feb,15,0,Friday,1,Clear,0.42,0.4242,0.35,0.4179,41,180,221,318,221,221
9786,2012-02-17,Spring,2012,Feb,16,0,Friday,1,Clear,0.42,0.4242,0.32,0.2985,56,251,307,318,307,307
9787,2012-02-17,Spring,2012,Feb,17,0,Friday,1,Clear,0.42,0.4242,0.32,0.3284,36,429,465,318,465,465
9788,2012-02-17,Spring,2012,Feb,18,0,Friday,1,Clear,0.4,0.4091,0.35,0.2537,15,362,377,318,377,377
9789,2012-02-17,Spring,2012,Feb,19,0,Friday,1,Clear,0.38,0.3939,0.37,0.2239,16,266,282,318,282,282
9790,2012-02-17,Spring,2012,Feb,20,0,Friday,1,Clear,0.4,0.4091,0.35,0.194,13,158,171,318,171,171
9791,2012-02-17,Spring,2012,Feb,21,0,Friday,1,Clear,0.38,0.3939,0.37,0.194,15,114,129,318,129,129
9792,2012-02-17,Spring,2012,Feb,22,0,Friday,1,Clear,0.36,0.3485,0.4,0.2239,15,92,107,318,107,107
9793,2012-02-17,Spring,2012,Feb,23,0,Friday,1,Clear,0.36,0.3485,0.4,0.194,10,72,82,318,82,82
9794,2012-02-18,Spring,2012,Feb,0,0,Saturday,0,Clear,0.34,0.3333,0.42,0.1642,5,81,86,317,86,86
9795,2012-02-18,Spring,2012,Feb,1,0,Saturday,0,Clear,0.32,0.3182,0.49,0.1642,7,38,45,317,45,45
9796,2012-02-18,Spring,2012,Feb,2,0,Saturday,0,Clear,0.3,0.2879,0.61,0.2537,6,39,45,317,45,45
9797,2012-02-18,Spring,2012,Feb,3,0,Saturday,0,Clear,0.28,0.2879,0.65,0.1045,3,15,18,317,18,18
9798,2012-02-18,Spring,2012,Feb,4,0,Saturday,0,Clear,0.26,0.303,0.7,0.0,3,4,7,317,7,7
9799,2012-02-18,Spring,2012,Feb,5,0,Saturday,0,Clear,0.24,0.2576,0.7,0.0896,0,1,1,317,1,1
9800,2012-02-18,Spring,2012,Feb,6,0,Saturday,0,Clear,0.24,0.2879,0.7,0.0,1,8,9,317,9,9
9801,2012-02-18,Spring,2012,Feb,7,0,Saturday,0,Clear,0.24,0.2879,0.7,0.0,8,33,41,317,41,41
9802,2012-02-18,Spring,2012,Feb,8,0,Saturday,0,Clear,0.22,0.2727,0.87,0.0,10,92,102,317,102,102
9803,2012-02-18,Spring,2012,Feb,9,0,Saturday,0,Clear,0.22,0.2424,0.8,0.1045,22,116,138,317,138,138
9804,2012-02-18,Spring,2012,Feb,10,0,Saturday,0,Clear,0.26,0.2727,0.81,0.1045,48,157,205,317,205,205
9805,2012-02-18,Spring,2012,Feb,11,0,Saturday,0,Clear,0.32,0.3333,0.57,0.1343,102,184,286,317,286,286
9806,2012-02-18,Spring,2012,Feb,12,0,Saturday,0,Clear,0.36,0.3485,0.43,0.194,128,241,369,317,369,369
9807,2012-02-18,Spring,2012,Feb,13,0,Saturday,0,Clear,0.4,0.4091,0.43,0.2836,165,219,384,317,384,384
9808,2012-02-18,Spring,2012,Feb,14,0,Saturday,0,Clear,0.44,0.4394,0.35,0.3582,183,244,427,317,427,427
9809,2012-02-18,Spring,2012,Feb,15,0,Saturday,0,Clear,0.42,0.4242,0.41,0.2537,229,270,499,317,499,499
9810,2012-02-18,Spring,2012,Feb,16,0,Saturday,0,Clear,0.44,0.4394,0.44,0.3284,186,218,404,317,404,404
9811,2012-02-18,Spring,2012,Feb,17,0,Saturday,0,Clear,0.48,0.4697,0.36,0.2836,142,222,364,317,364,364
9812,2012-02-18,Spring,2012,Feb,18,0,Saturday,0,Clear,0.46,0.4545,0.38,0.2985,70,176,246,317,246,246
9813,2012-02-18,Spring,2012,Feb,19,0,Saturday,0,Clear,0.44,0.4394,0.44,0.1642,38,150,188,317,188,188
9814,2012-02-18,Spring,2012,Feb,20,0,Saturday,0,Clear,0.44,0.4394,0.44,0.1642,25,123,148,317,148,148
9815,2012-02-18,Spring,2012,Feb,21,0,Saturday,0,Clear,0.44,0.4394,0.33,0.2985,25,89,114,317,114,114
9816,2012-02-18,Spring,2012,Feb,22,0,Saturday,0,Clear,0.4,0.4091,0.4,0.4478,17,101,118,317,118,118
9817,2012-02-18,Spring,2012,Feb,23,0,Saturday,0,Misty,0.36,0.3333,0.4,0.3881,12,62,74,317,74,74
9818,2012-02-19,Spring,2012,Feb,0,0,Sunday,0,Misty,0.34,0.303,0.39,0.3582,9,65,74,316,74,74
9819,2012-02-19,Spring,2012,Feb,1,0,Sunday,0,Misty,0.32,0.303,0.39,0.2537,10,62,72,316,72,72
9820,2012-02-19,Spring,2012,Feb,2,0,Sunday,0,Misty,0.3,0.2879,0.36,0.2836,3,45,48,316,48,48
9821,2012-02-19,Spring,2012,Feb,3,0,Sunday,0,Misty,0.3,0.2879,0.36,0.2239,3,12,15,316,15,15
9822,2012-02-19,Spring,2012,Feb,4,0,Sunday,0,Misty,0.28,0.2576,0.41,0.3881,0,3,3,316,3,3
9823,2012-02-19,Spring,2012,Feb,5,0,Sunday,0,Misty,0.26,0.2273,0.48,0.2985,1,1,2,316,2,2
9824,2012-02-19,Spring,2012,Feb,6,0,Sunday,0,Clear,0.24,0.2121,0.52,0.3284,0,5,5,316,5,5
9825,2012-02-19,Spring,2012,Feb,7,0,Sunday,0,Misty,0.24,0.2121,0.52,0.2836,2,12,14,316,14,14
9826,2012-02-19,Spring,2012,Feb,8,0,Sunday,0,Misty,0.24,0.2273,0.56,0.194,8,48,56,316,56,56
9827,2012-02-19,Spring,2012,Feb,9,0,Sunday,0,Misty,0.24,0.2273,0.56,0.2537,20,73,93,316,93,93
9828,2012-02-19,Spring,2012,Feb,10,0,Sunday,0,Misty,0.26,0.2424,0.52,0.2537,49,142,191,316,191,191
9829,2012-02-19,Spring,2012,Feb,11,0,Sunday,0,Misty,0.26,0.2273,0.56,0.3284,82,144,226,316,226,226
9830,2012-02-19,Spring,2012,Feb,12,0,Sunday,0,Misty,0.28,0.2727,0.52,0.2537,71,184,255,316,255,255
9831,2012-02-19,Spring,2012,Feb,13,0,Sunday,0,Clear,0.3,0.303,0.49,0.1642,64,197,261,316,261,261
9832,2012-02-19,Spring,2012,Feb,14,0,Sunday,0,Misty,0.32,0.3182,0.45,0.194,48,189,237,316,237,237
9833,2012-02-19,Spring,2012,Feb,15,0,Sunday,0,Misty,0.3,0.2879,0.49,0.194,85,168,253,316,253,253
9834,2012-02-19,Spring,2012,Feb,16,0,Sunday,0,Misty,0.32,0.303,0.45,0.2836,62,150,212,316,212,212
9835,2012-02-19,Spring,2012,Feb,17,0,Sunday,0,Misty,0.3,0.2879,0.49,0.2537,22,135,157,316,157,157
9836,2012-02-19,Spring,2012,Feb,18,0,Sunday,0,Misty,0.3,0.2727,0.49,0.3284,23,144,167,316,167,167
9837,2012-02-19,Spring,2012,Feb,19,0,Sunday,0,Misty,0.3,0.2879,0.52,0.2537,18,101,119,316,119,119
9838,2012-02-19,Spring,2012,Feb,20,0,Sunday,0,Misty,0.3,0.2879,0.52,0.2836,22,81,103,316,103,103
9839,2012-02-19,Spring,2012,Feb,21,0,Sunday,0,Light_rainsnow,0.26,0.2576,0.65,0.1642,3,33,36,316,36,36
9840,2012-02-19,Spring,2012,Feb,22,0,Sunday,0,Light_rainsnow,0.24,0.2576,0.75,0.0896,8,47,55,316,55,55
9841,2012-02-19,Spring,2012,Feb,23,0,Sunday,0,Misty,0.22,0.2273,0.93,0.1642,5,30,35,316,35,35
9842,2012-02-20,Spring,2012,Feb,0,1,Monday,0,Misty,0.24,0.2576,0.87,0.0896,5,36,41,315,41,41
9843,2012-02-20,Spring,2012,Feb,1,1,Monday,0,Misty,0.24,0.2576,0.87,0.0896,3,12,15,315,15,15
9844,2012-02-20,Spring,2012,Feb,2,1,Monday,0,Misty,0.24,0.2576,0.87,0.0896,1,19,20,315,20,20
9845,2012-02-20,Spring,2012,Feb,3,1,Monday,0,Misty,0.24,0.2273,0.81,0.194,0,8,8,315,8,8
9846,2012-02-20,Spring,2012,Feb,5,1,Monday,0,Misty,0.24,0.2121,0.6,0.3582,0,6,6,315,6,6
9847,2012-02-20,Spring,2012,Feb,6,1,Monday,0,Clear,0.24,0.197,0.52,0.4179,1,9,10,315,10,10
9848,2012-02-20,Spring,2012,Feb,7,1,Monday,0,Misty,0.22,0.197,0.55,0.3284,2,42,44,315,44,44
9849,2012-02-20,Spring,2012,Feb,8,1,Monday,0,Clear,0.2,0.1818,0.59,0.3582,9,111,120,315,120,120
9850,2012-02-20,Spring,2012,Feb,9,1,Monday,0,Clear,0.2,0.1818,0.59,0.3582,12,98,110,315,110,110
9851,2012-02-20,Spring,2012,Feb,10,1,Monday,0,Clear,0.22,0.197,0.55,0.4478,30,113,143,315,143,143
9852,2012-02-20,Spring,2012,Feb,11,1,Monday,0,Clear,0.26,0.2273,0.48,0.3582,45,163,208,315,208,208
9853,2012-02-20,Spring,2012,Feb,12,1,Monday,0,Clear,0.28,0.2727,0.45,0.2239,65,216,281,315,281,281
9854,2012-02-20,Spring,2012,Feb,13,1,Monday,0,Clear,0.3,0.2879,0.42,0.2836,66,246,312,315,312,312
9855,2012-02-20,Spring,2012,Feb,14,1,Monday,0,Clear,0.32,0.3182,0.36,0.194,57,206,263,315,263,263
9856,2012-02-20,Spring,2012,Feb,15,1,Monday,0,Clear,0.34,0.3182,0.34,0.2239,54,235,289,315,289,289
9857,2012-02-20,Spring,2012,Feb,16,1,Monday,0,Clear,0.36,0.3788,0.29,0.1045,64,216,280,315,280,280
9858,2012-02-20,Spring,2012,Feb,17,1,Monday,0,Clear,0.38,0.3939,0.27,0.2537,27,226,253,315,253,253
9859,2012-02-20,Spring,2012,Feb,18,1,Monday,0,Clear,0.34,0.3182,0.34,0.2239,27,215,242,315,242,242
9860,2012-02-20,Spring,2012,Feb,19,1,Monday,0,Clear,0.34,0.3182,0.34,0.2239,8,164,172,315,172,172
9861,2012-02-20,Spring,2012,Feb,20,1,Monday,0,Clear,0.34,0.3333,0.34,0.194,9,117,126,315,126,126
9862,2012-02-20,Spring,2012,Feb,21,1,Monday,0,Clear,0.3,0.303,0.39,0.1642,8,90,98,315,98,98
9863,2012-02-20,Spring,2012,Feb,22,1,Monday,0,Clear,0.3,0.3182,0.45,0.0896,9,53,62,315,62,62
9864,2012-02-20,Spring,2012,Feb,23,1,Monday,0,Clear,0.3,0.3333,0.39,0.0,0,26,26,315,26,26
9865,2012-02-21,Spring,2012,Feb,0,0,Tuesday,1,Clear,0.26,0.303,0.65,0.0,1,11,12,314,12,12
9866,2012-02-21,Spring,2012,Feb,1,0,Tuesday,1,Clear,0.26,0.303,0.56,0.0,0,7,7,314,7,7
9867,2012-02-21,Spring,2012,Feb,2,0,Tuesday,1,Clear,0.24,0.2879,0.6,0.0,0,3,3,314,3,3
9868,2012-02-21,Spring,2012,Feb,4,0,Tuesday,1,Clear,0.22,0.2727,0.64,0.0,0,2,2,314,2,2
9869,2012-02-21,Spring,2012,Feb,5,0,Tuesday,1,Clear,0.2,0.2576,0.69,0.0,0,15,15,314,15,15
9870,2012-02-21,Spring,2012,Feb,6,0,Tuesday,1,Clear,0.2,0.2576,0.75,0.0,3,83,86,314,86,86
9871,2012-02-21,Spring,2012,Feb,7,0,Tuesday,1,Clear,0.22,0.2727,0.64,0.0,6,273,279,314,279,279
9872,2012-02-21,Spring,2012,Feb,8,0,Tuesday,1,Clear,0.2,0.2273,0.69,0.0896,5,459,464,314,464,464
9873,2012-02-21,Spring,2012,Feb,9,0,Tuesday,1,Clear,0.2,0.2273,0.75,0.1045,6,211,217,314,217,217
9874,2012-02-21,Spring,2012,Feb,10,0,Tuesday,1,Clear,0.24,0.2273,0.7,0.194,8,77,85,314,85,85
9875,2012-02-21,Spring,2012,Feb,11,0,Tuesday,1,Misty,0.26,0.2424,0.7,0.2836,5,81,86,314,86,86
9876,2012-02-21,Spring,2012,Feb,12,0,Tuesday,1,Misty,0.3,0.2727,0.56,0.3881,16,147,163,314,163,163
9877,2012-02-21,Spring,2012,Feb,13,0,Tuesday,1,Clear,0.34,0.303,0.49,0.4179,8,123,131,314,131,131
9878,2012-02-21,Spring,2012,Feb,14,0,Tuesday,1,Misty,0.32,0.2879,0.53,0.3881,16,108,124,314,124,124
9879,2012-02-21,Spring,2012,Feb,15,0,Tuesday,1,Clear,0.34,0.303,0.49,0.4179,23,137,160,314,160,160
9880,2012-02-21,Spring,2012,Feb,16,0,Tuesday,1,Clear,0.36,0.3333,0.46,0.4179,14,240,254,314,254,254
9881,2012-02-21,Spring,2012,Feb,17,0,Tuesday,1,Clear,0.38,0.3939,0.4,0.4478,21,411,432,314,432,432
9882,2012-02-21,Spring,2012,Feb,18,0,Tuesday,1,Clear,0.38,0.3939,0.4,0.4478,11,414,425,314,425,425
9883,2012-02-21,Spring,2012,Feb,19,0,Tuesday,1,Clear,0.36,0.3333,0.46,0.2985,5,299,304,314,304,304
9884,2012-02-21,Spring,2012,Feb,20,0,Tuesday,1,Clear,0.34,0.3182,0.53,0.2537,4,223,227,314,227,227
9885,2012-02-21,Spring,2012,Feb,21,0,Tuesday,1,Clear,0.34,0.3333,0.61,0.1642,7,147,154,314,154,154
9886,2012-02-21,Spring,2012,Feb,22,0,Tuesday,1,Misty,0.34,0.3333,0.71,0.194,3,97,100,314,100,100
9887,2012-02-21,Spring,2012,Feb,23,0,Tuesday,1,Clear,0.32,0.303,0.66,0.2239,1,46,47,314,47,47
9888,2012-02-22,Spring,2012,Feb,0,0,Wednesday,1,Clear,0.32,0.303,0.66,0.2239,5,19,24,313,24,24
9889,2012-02-22,Spring,2012,Feb,1,0,Wednesday,1,Clear,0.32,0.3333,0.7,0.1343,3,4,7,313,7,7
9890,2012-02-22,Spring,2012,Feb,2,0,Wednesday,1,Clear,0.34,0.3182,0.66,0.2836,1,5,6,313,6,6
9891,2012-02-22,Spring,2012,Feb,3,0,Wednesday,1,Misty,0.34,0.3182,0.71,0.2239,1,3,4,313,4,4
9892,2012-02-22,Spring,2012,Feb,4,0,Wednesday,1,Clear,0.34,0.3333,0.71,0.1642,0,2,2,313,2,2
9893,2012-02-22,Spring,2012,Feb,5,0,Wednesday,1,Clear,0.32,0.3333,0.7,0.1045,1,29,30,313,30,30
9894,2012-02-22,Spring,2012,Feb,6,0,Wednesday,1,Clear,0.32,0.3182,0.76,0.1642,5,85,90,313,90,90
9895,2012-02-22,Spring,2012,Feb,7,0,Wednesday,1,Clear,0.32,0.3333,0.76,0.0896,10,292,302,313,302,302
9896,2012-02-22,Spring,2012,Feb,8,0,Wednesday,1,Clear,0.3,0.3182,0.75,0.0896,9,567,576,313,576,576
9897,2012-02-22,Spring,2012,Feb,9,0,Wednesday,1,Clear,0.32,0.3333,0.7,0.0896,11,241,252,313,252,252
9898,2012-02-22,Spring,2012,Feb,10,0,Wednesday,1,Clear,0.34,0.3485,0.71,0.0896,17,122,139,313,139,139
9899,2012-02-22,Spring,2012,Feb,11,0,Wednesday,1,Clear,0.36,0.3485,0.66,0.1642,22,149,171,313,171,171
9900,2012-02-22,Spring,2012,Feb,12,0,Wednesday,1,Clear,0.4,0.4091,0.62,0.2836,21,186,207,313,207,207
9901,2012-02-22,Spring,2012,Feb,13,0,Wednesday,1,Clear,0.42,0.4242,0.54,0.2985,15,175,190,313,190,190
9902,2012-02-22,Spring,2012,Feb,14,0,Wednesday,1,Clear,0.44,0.4394,0.54,0.3284,35,142,177,313,177,177
9903,2012-02-22,Spring,2012,Feb,15,0,Wednesday,1,Clear,0.5,0.4848,0.31,0.4179,34,161,195,313,195,195
9904,2012-02-22,Spring,2012,Feb,16,0,Wednesday,1,Clear,0.52,0.5,0.29,0.4627,30,268,298,313,298,298
9905,2012-02-22,Spring,2012,Feb,17,0,Wednesday,1,Clear,0.52,0.5,0.32,0.3881,43,486,529,313,529,529
9906,2012-02-22,Spring,2012,Feb,18,0,Wednesday,1,Misty,0.48,0.4697,0.41,0.3284,42,483,525,313,525,525
9907,2012-02-22,Spring,2012,Feb,19,0,Wednesday,1,Misty,0.46,0.4545,0.44,0.2836,22,305,327,313,327,327
9908,2012-02-22,Spring,2012,Feb,20,0,Wednesday,1,Misty,0.44,0.4394,0.47,0.194,25,249,274,313,274,274
9909,2012-02-22,Spring,2012,Feb,21,0,Wednesday,1,Misty,0.48,0.4697,0.33,0.2836,19,220,239,313,239,239
9910,2012-02-22,Spring,2012,Feb,22,0,Wednesday,1,Misty,0.44,0.4394,0.47,0.2537,18,129,147,313,147,147
9911,2012-02-22,Spring,2012,Feb,23,0,Wednesday,1,Misty,0.46,0.4545,0.41,0.2836,5,57,62,313,62,62
9912,2012-02-23,Spring,2012,Feb,0,0,Thursday,1,Misty,0.44,0.4394,0.47,0.2537,12,30,42,312,42,42
9913,2012-02-23,Spring,2012,Feb,1,0,Thursday,1,Misty,0.44,0.4394,0.58,0.2836,3,12,15,312,15,15
9914,2012-02-23,Spring,2012,Feb,2,0,Thursday,1,Misty,0.44,0.4394,0.62,0.2239,5,4,9,312,9,9
9915,2012-02-23,Spring,2012,Feb,3,0,Thursday,1,Light_rainsnow,0.44,0.4394,0.67,0.194,2,4,6,312,6,6
9916,2012-02-23,Spring,2012,Feb,4,0,Thursday,1,Clear,0.4,0.4091,0.76,0.2239,0,1,1,312,1,1
9917,2012-02-23,Spring,2012,Feb,5,0,Thursday,1,Clear,0.4,0.4091,0.76,0.2239,2,30,32,312,32,32
9918,2012-02-23,Spring,2012,Feb,6,0,Thursday,1,Clear,0.36,0.3485,0.87,0.194,3,88,91,312,91,91
9919,2012-02-23,Spring,2012,Feb,7,0,Thursday,1,Clear,0.36,0.3485,0.81,0.2239,9,317,326,312,326,326
9920,2012-02-23,Spring,2012,Feb,8,0,Thursday,1,Clear,0.34,0.3333,0.87,0.194,11,549,560,312,560,560
9921,2012-02-23,Spring,2012,Feb,9,0,Thursday,1,Clear,0.36,0.3333,0.81,0.2537,14,228,242,312,242,242
9922,2012-02-23,Spring,2012,Feb,10,0,Thursday,1,Clear,0.42,0.4242,0.67,0.194,41,107,148,312,148,148
9923,2012-02-23,Spring,2012,Feb,11,0,Thursday,1,Clear,0.48,0.4697,0.48,0.2836,54,128,182,312,182,182
9924,2012-02-23,Spring,2012,Feb,12,0,Thursday,1,Clear,0.5,0.4848,0.42,0.2537,25,199,224,312,224,224
9925,2012-02-23,Spring,2012,Feb,13,0,Thursday,1,Clear,0.52,0.5,0.39,0.194,30,188,218,312,218,218
9926,2012-02-23,Spring,2012,Feb,14,0,Thursday,1,Clear,0.54,0.5152,0.37,0.2537,36,156,192,312,192,192
9927,2012-02-23,Spring,2012,Feb,15,0,Thursday,1,Clear,0.54,0.5152,0.33,0.1343,46,171,217,312,217,217
9928,2012-02-23,Spring,2012,Feb,16,0,Thursday,1,Clear,0.56,0.5303,0.32,0.0,45,298,343,312,343,343
9929,2012-02-23,Spring,2012,Feb,17,0,Thursday,1,Clear,0.54,0.5152,0.32,0.1642,49,561,610,312,610,610
9930,2012-02-23,Spring,2012,Feb,18,0,Thursday,1,Clear,0.54,0.5152,0.37,0.1343,36,486,522,312,522,522
9931,2012-02-23,Spring,2012,Feb,19,0,Thursday,1,Clear,0.5,0.4848,0.39,0.0896,20,349,369,312,369,369
9932,2012-02-23,Spring,2012,Feb,20,0,Thursday,1,Clear,0.46,0.4545,0.44,0.1343,23,246,269,312,269,269
9933,2012-02-23,Spring,2012,Feb,21,0,Thursday,1,Clear,0.44,0.4394,0.51,0.2239,17,205,222,312,222,222
9934,2012-02-23,Spring,2012,Feb,22,0,Thursday,1,Clear,0.44,0.4394,0.54,0.2537,19,118,137,312,137,137
9935,2012-02-23,Spring,2012,Feb,23,0,Thursday,1,Clear,0.44,0.4394,0.54,0.0,14,71,85,312,85,85
9936,2012-02-24,Spring,2012,Feb,0,0,Friday,1,Misty,0.44,0.4394,0.58,0.0896,12,34,46,311,46,46
9937,2012-02-24,Spring,2012,Feb,1,0,Friday,1,Clear,0.44,0.4394,0.62,0.194,3,15,18,311,18,18
9938,2012-02-24,Spring,2012,Feb,2,0,Friday,1,Light_rainsnow,0.42,0.4242,0.77,0.2836,1,4,5,311,5,5
9939,2012-02-24,Spring,2012,Feb,3,0,Friday,1,Clear,0.42,0.4242,0.82,0.1343,0,5,5,311,5,5
9940,2012-02-24,Spring,2012,Feb,4,0,Friday,1,Clear,0.4,0.4091,0.87,0.1343,0,2,2,311,2,2
9941,2012-02-24,Spring,2012,Feb,5,0,Friday,1,Misty,0.4,0.4091,0.87,0.194,1,25,26,311,26,26
9942,2012-02-24,Spring,2012,Feb,6,0,Friday,1,Misty,0.4,0.4091,0.87,0.1642,2,80,82,311,82,82
9943,2012-02-24,Spring,2012,Feb,7,0,Friday,1,Misty,0.4,0.4091,0.76,0.2239,7,265,272,311,272,272
9944,2012-02-24,Spring,2012,Feb,8,0,Friday,1,Misty,0.38,0.3939,0.76,0.3284,17,452,469,311,469,469
9945,2012-02-24,Spring,2012,Feb,9,0,Friday,1,Light_rainsnow,0.36,0.3333,0.81,0.2537,15,229,244,311,244,244
9946,2012-02-24,Spring,2012,Feb,10,0,Friday,1,Light_rainsnow,0.36,0.3485,0.81,0.1642,22,119,141,311,141,141
9947,2012-02-24,Spring,2012,Feb,11,0,Friday,1,Misty,0.36,0.3636,0.81,0.1045,27,136,163,311,163,163
9948,2012-02-24,Spring,2012,Feb,12,0,Friday,1,Misty,0.4,0.4091,0.76,0.1343,27,201,228,311,228,228
9949,2012-02-24,Spring,2012,Feb,13,0,Friday,1,Misty,0.42,0.4242,0.71,0.1045,30,153,183,311,183,183
9950,2012-02-24,Spring,2012,Feb,14,0,Friday,1,Misty,0.46,0.4545,0.67,0.1045,5,26,31,311,31,31
9951,2012-02-24,Spring,2012,Feb,15,0,Friday,1,Light_rainsnow,0.4,0.4091,0.87,0.194,11,83,94,311,94,94
9952,2012-02-24,Spring,2012,Feb,16,0,Friday,1,Light_rainsnow,0.4,0.4091,0.87,0.194,12,166,178,311,178,178
9953,2012-02-24,Spring,2012,Feb,17,0,Friday,1,Light_rainsnow,0.42,0.4242,0.94,0.1045,14,242,256,311,256,256
9954,2012-02-24,Spring,2012,Feb,18,0,Friday,1,Misty,0.42,0.4242,0.94,0.0,11,289,300,311,300,300
9955,2012-02-24,Spring,2012,Feb,19,0,Friday,1,Misty,0.44,0.4394,0.88,0.1045,6,227,233,311,233,233
9956,2012-02-24,Spring,2012,Feb,20,0,Friday,1,Clear,0.44,0.4394,0.62,0.4179,8,159,167,311,167,167
9957,2012-02-24,Spring,2012,Feb,21,0,Friday,1,Clear,0.42,0.4242,0.35,0.806,1,151,152,311,152,152
9958,2012-02-24,Spring,2012,Feb,22,0,Friday,1,Clear,0.4,0.4091,0.37,0.5821,4,102,106,311,106,106
9959,2012-02-24,Spring,2012,Feb,23,0,Friday,1,Clear,0.38,0.3939,0.37,0.6866,10,76,86,311,86,86
9960,2012-02-25,Spring,2012,Feb,0,0,Saturday,0,Clear,0.36,0.3333,0.43,0.3881,5,56,61,310,61,61
9961,2012-02-25,Spring,2012,Feb,1,0,Saturday,0,Clear,0.34,0.303,0.42,0.3582,4,42,46,310,46,46
9962,2012-02-25,Spring,2012,Feb,2,0,Saturday,0,Clear,0.32,0.303,0.45,0.2537,1,37,38,310,38,38
9963,2012-02-25,Spring,2012,Feb,3,0,Saturday,0,Clear,0.3,0.2727,0.45,0.2985,0,7,7,310,7,7
9964,2012-02-25,Spring,2012,Feb,4,0,Saturday,0,Clear,0.3,0.2727,0.42,0.3284,0,2,2,310,2,2
9965,2012-02-25,Spring,2012,Feb,5,0,Saturday,0,Misty,0.3,0.2727,0.42,0.2985,0,3,3,310,3,3
9966,2012-02-25,Spring,2012,Feb,6,0,Saturday,0,Misty,0.3,0.2727,0.42,0.2985,1,12,13,310,13,13
9967,2012-02-25,Spring,2012,Feb,7,0,Saturday,0,Clear,0.28,0.2424,0.45,0.4478,3,20,23,310,23,23
9968,2012-02-25,Spring,2012,Feb,8,0,Saturday,0,Clear,0.26,0.2273,0.48,0.2985,3,90,93,310,93,93
9969,2012-02-25,Spring,2012,Feb,9,0,Saturday,0,Light_rainsnow,0.22,0.197,0.75,0.3284,15,107,122,310,122,122
9970,2012-02-25,Spring,2012,Feb,10,0,Saturday,0,Clear,0.26,0.2273,0.6,0.3582,24,159,183,310,183,183
9971,2012-02-25,Spring,2012,Feb,11,0,Saturday,0,Clear,0.3,0.2576,0.39,0.6119,23,187,210,310,210,210
9972,2012-02-25,Spring,2012,Feb,12,0,Saturday,0,Clear,0.32,0.2727,0.29,0.6567,41,217,258,310,258,258
9973,2012-02-25,Spring,2012,Feb,13,0,Saturday,0,Clear,0.32,0.2879,0.31,0.4925,48,178,226,310,226,226
9974,2012-02-25,Spring,2012,Feb,14,0,Saturday,0,Clear,0.32,0.2727,0.29,0.5522,35,181,216,310,216,216
9975,2012-02-25,Spring,2012,Feb,15,0,Saturday,0,Clear,0.32,0.2879,0.29,0.4179,21,211,232,310,232,232
9976,2012-02-25,Spring,2012,Feb,16,0,Saturday,0,Clear,0.32,0.2727,0.26,0.5821,32,163,195,310,195,195
9977,2012-02-25,Spring,2012,Feb,17,0,Saturday,0,Clear,0.3,0.2727,0.33,0.3582,16,143,159,310,159,159
9978,2012-02-25,Spring,2012,Feb,18,0,Saturday,0,Clear,0.3,0.2576,0.28,0.5821,7,126,133,310,133,133
9979,2012-02-25,Spring,2012,Feb,19,0,Saturday,0,Clear,0.26,0.2121,0.33,0.4478,12,137,149,310,149,149
9980,2012-02-25,Spring,2012,Feb,20,0,Saturday,0,Clear,0.26,0.2121,0.3,0.5522,10,95,105,310,105,105
9981,2012-02-25,Spring,2012,Feb,21,0,Saturday,0,Clear,0.24,0.2121,0.35,0.3284,5,80,85,310,85,85
9982,2012-02-25,Spring,2012,Feb,22,0,Saturday,0,Clear,0.24,0.197,0.38,0.4627,4,78,82,310,82,82
9983,2012-02-25,Spring,2012,Feb,23,0,Saturday,0,Clear,0.24,0.197,0.41,0.4179,7,84,91,310,91,91
9984,2012-02-26,Spring,2012,Feb,0,0,Sunday,0,Clear,0.24,0.2121,0.41,0.3582,7,63,70,309,70,70
9985,2012-02-26,Spring,2012,Feb,1,0,Sunday,0,Clear,0.24,0.2121,0.44,0.3284,5,50,55,309,55,55
9986,2012-02-26,Spring,2012,Feb,2,0,Sunday,0,Clear,0.24,0.2121,0.44,0.3284,5,37,42,309,42,42
9987,2012-02-26,Spring,2012,Feb,3,0,Sunday,0,Clear,0.24,0.2273,0.41,0.194,0,21,21,309,21,21
9988,2012-02-26,Spring,2012,Feb,4,0,Sunday,0,Clear,0.24,0.2273,0.41,0.194,1,5,6,309,6,6
9989,2012-02-26,Spring,2012,Feb,5,0,Sunday,0,Clear,0.22,0.2121,0.44,0.2239,0,5,5,309,5,5
9990,2012-02-26,Spring,2012,Feb,6,0,Sunday,0,Clear,0.22,0.197,0.44,0.3284,0,2,2,309,2,2
9991,2012-02-26,Spring,2012,Feb,7,0,Sunday,0,Clear,0.2,0.1818,0.51,0.2985,2,20,22,309,22,22
9992,2012-02-26,Spring,2012,Feb,8,0,Sunday,0,Clear,0.2,0.197,0.51,0.2537,2,57,59,309,59,59
9993,2012-02-26,Spring,2012,Feb,9,0,Sunday,0,Clear,0.22,0.2121,0.47,0.2239,11,76,87,309,87,87
9994,2012-02-26,Spring,2012,Feb,10,0,Sunday,0,Clear,0.26,0.2576,0.41,0.1642,27,161,188,309,188,188
9995,2012-02-26,Spring,2012,Feb,11,0,Sunday,0,Clear,0.28,0.2576,0.41,0.2836,43,184,227,309,227,227
9996,2012-02-26,Spring,2012,Feb,12,0,Sunday,0,Clear,0.3,0.303,0.39,0.1343,49,256,305,309,305,305
9997,2012-02-26,Spring,2012,Feb,13,0,Sunday,0,Clear,0.32,0.3333,0.36,0.0,58,267,325,309,325,325
9998,2012-02-26,Spring,2012,Feb,14,0,Sunday,0,Clear,0.34,0.3485,0.31,0.0,68,263,331,309,331,331
9999,2012-02-26,Spring,2012,Feb,15,0,Sunday,0,Clear,0.36,0.3485,0.29,0.0,72,281,353,309,353,353
10000,2012-02-26,Spring,2012,Feb,16,0,Sunday,0,Clear,0.36,0.3333,0.32,0.2537,64,275,339,309,339,339
10001,2012-02-26,Spring,2012,Feb,17,0,Sunday,0,Clear,0.36,0.3485,0.32,0.2239,46,241,287,309,287,287
10002,2012-02-26,Spring,2012,Feb,18,0,Sunday,0,Clear,0.34,0.3182,0.36,0.2836,17,199,216,309,216,216
10003,2012-02-26,Spring,2012,Feb,19,0,Sunday,0,Clear,0.34,0.3333,0.34,0.1642,13,130,143,309,143,143
10004,2012-02-26,Spring,2012,Feb,20,0,Sunday,0,Clear,0.32,0.3182,0.42,0.1642,9,79,88,309,88,88
10005,2012-02-26,Spring,2012,Feb,21,0,Sunday,0,Clear,0.3,0.303,0.45,0.1343,8,75,83,309,83,83
10006,2012-02-26,Spring,2012,Feb,22,0,Sunday,0,Clear,0.3,0.2879,0.42,0.2239,3,68,71,309,71,71
10007,2012-02-26,Spring,2012,Feb,23,0,Sunday,0,Clear,0.26,0.2576,0.56,0.1642,5,59,64,309,64,64
10008,2012-02-27,Spring,2012,Feb,0,0,Monday,1,Clear,0.26,0.2424,0.6,0.2537,2,27,29,308,29,29
10009,2012-02-27,Spring,2012,Feb,1,0,Monday,1,Clear,0.26,0.2576,0.65,0.2239,0,6,6,308,6,6
10010,2012-02-27,Spring,2012,Feb,2,0,Monday,1,Clear,0.26,0.2273,0.7,0.2985,0,4,4,308,4,4
10011,2012-02-27,Spring,2012,Feb,3,0,Monday,1,Clear,0.24,0.2424,0.75,0.1642,0,2,2,308,2,2
10012,2012-02-27,Spring,2012,Feb,4,0,Monday,1,Clear,0.22,0.2273,0.8,0.1343,0,1,1,308,1,1
10013,2012-02-27,Spring,2012,Feb,5,0,Monday,1,Clear,0.22,0.2273,0.8,0.1343,0,16,16,308,16,16
10014,2012-02-27,Spring,2012,Feb,6,0,Monday,1,Clear,0.24,0.2273,0.7,0.2537,1,89,90,308,90,90
10015,2012-02-27,Spring,2012,Feb,7,0,Monday,1,Clear,0.24,0.2273,0.6,0.2239,2,278,280,308,280,280
10016,2012-02-27,Spring,2012,Feb,8,0,Monday,1,Clear,0.24,0.2424,0.6,0.0,14,514,528,308,528,528
10017,2012-02-27,Spring,2012,Feb,9,0,Monday,1,Clear,0.26,0.2576,0.6,0.194,11,219,230,308,230,230
10018,2012-02-27,Spring,2012,Feb,10,0,Monday,1,Clear,0.32,0.303,0.45,0.2537,16,88,104,308,104,104
10019,2012-02-27,Spring,2012,Feb,11,0,Monday,1,Clear,0.36,0.3333,0.43,0.2537,11,92,103,308,103,103
10020,2012-02-27,Spring,2012,Feb,12,0,Monday,1,Clear,0.4,0.4091,0.37,0.2985,13,164,177,308,177,177
10021,2012-02-27,Spring,2012,Feb,13,0,Monday,1,Clear,0.4,0.4091,0.43,0.2836,23,159,182,308,182,182
10022,2012-02-27,Spring,2012,Feb,14,0,Monday,1,Clear,0.46,0.4545,0.36,0.2836,24,134,158,308,158,158
10023,2012-02-27,Spring,2012,Feb,15,0,Monday,1,Clear,0.52,0.5,0.25,0.4179,24,150,174,308,174,174
10024,2012-02-27,Spring,2012,Feb,16,0,Monday,1,Clear,0.54,0.5152,0.26,0.4478,20,266,286,308,286,286
10025,2012-02-27,Spring,2012,Feb,17,0,Monday,1,Clear,0.54,0.5152,0.24,0.4478,26,503,529,308,529,529
10026,2012-02-27,Spring,2012,Feb,18,0,Monday,1,Clear,0.52,0.5,0.27,0.4179,10,517,527,308,527,527
10027,2012-02-27,Spring,2012,Feb,19,0,Monday,1,Clear,0.5,0.4848,0.29,0.3881,16,318,334,308,334,334
10028,2012-02-27,Spring,2012,Feb,20,0,Monday,1,Clear,0.48,0.4697,0.33,0.3582,11,208,219,308,219,219
10029,2012-02-27,Spring,2012,Feb,21,0,Monday,1,Clear,0.46,0.4545,0.36,0.2836,14,181,195,308,195,195
10030,2012-02-27,Spring,2012,Feb,22,0,Monday,1,Clear,0.44,0.4394,0.44,0.2537,9,83,92,308,92,92
10031,2012-02-27,Spring,2012,Feb,23,0,Monday,1,Clear,0.42,0.4242,0.5,0.1642,6,50,56,308,56,56
10032,2012-02-28,Spring,2012,Feb,0,0,Tuesday,1,Clear,0.42,0.4242,0.54,0.1343,0,10,10,307,10,10
10033,2012-02-28,Spring,2012,Feb,1,0,Tuesday,1,Clear,0.38,0.3939,0.62,0.1642,0,6,6,307,6,6
10034,2012-02-28,Spring,2012,Feb,2,0,Tuesday,1,Clear,0.4,0.4091,0.54,0.1045,1,2,3,307,3,3
10035,2012-02-28,Spring,2012,Feb,3,0,Tuesday,1,Clear,0.4,0.4091,0.32,0.3582,0,6,6,307,6,6
10036,2012-02-28,Spring,2012,Feb,4,0,Tuesday,1,Clear,0.32,0.2879,0.42,0.3582,0,2,2,307,2,2
10037,2012-02-28,Spring,2012,Feb,5,0,Tuesday,1,Clear,0.32,0.2879,0.42,0.3582,1,20,21,307,21,21
10038,2012-02-28,Spring,2012,Feb,6,0,Tuesday,1,Clear,0.3,0.2727,0.45,0.3284,1,100,101,307,101,101
10039,2012-02-28,Spring,2012,Feb,7,0,Tuesday,1,Clear,0.28,0.2576,0.45,0.2985,12,313,325,307,325,325
10040,2012-02-28,Spring,2012,Feb,8,0,Tuesday,1,Clear,0.26,0.2424,0.48,0.2836,16,543,559,307,559,559
10041,2012-02-28,Spring,2012,Feb,9,0,Tuesday,1,Clear,0.28,0.2576,0.45,0.3582,7,225,232,307,232,232
10042,2012-02-28,Spring,2012,Feb,10,0,Tuesday,1,Clear,0.3,0.2727,0.42,0.2985,14,118,132,307,132,132
10043,2012-02-28,Spring,2012,Feb,11,0,Tuesday,1,Clear,0.34,0.3182,0.36,0.2537,8,155,163,307,163,163
10044,2012-02-28,Spring,2012,Feb,12,0,Tuesday,1,Clear,0.36,0.3485,0.34,0.1343,19,164,183,307,183,183
10045,2012-02-28,Spring,2012,Feb,13,0,Tuesday,1,Clear,0.36,0.3636,0.32,0.1045,16,174,190,307,190,190
10046,2012-02-28,Spring,2012,Feb,14,0,Tuesday,1,Clear,0.4,0.4091,0.28,0.1045,13,121,134,307,134,134
10047,2012-02-28,Spring,2012,Feb,15,0,Tuesday,1,Clear,0.42,0.4242,0.26,0.0896,17,149,166,307,166,166
10048,2012-02-28,Spring,2012,Feb,16,0,Tuesday,1,Clear,0.42,0.4242,0.28,0.0896,17,270,287,307,287,287
10049,2012-02-28,Spring,2012,Feb,17,0,Tuesday,1,Clear,0.42,0.4242,0.26,0.0896,33,497,530,307,530,530
10050,2012-02-28,Spring,2012,Feb,18,0,Tuesday,1,Clear,0.42,0.4242,0.28,0.1642,17,432,449,307,449,449
10051,2012-02-28,Spring,2012,Feb,19,0,Tuesday,1,Clear,0.42,0.4242,0.26,0.0,15,291,306,307,306,306
10052,2012-02-28,Spring,2012,Feb,20,0,Tuesday,1,Clear,0.4,0.4091,0.3,0.1343,2,202,204,307,204,204
10053,2012-02-28,Spring,2012,Feb,21,0,Tuesday,1,Clear,0.34,0.3485,0.46,0.1045,10,178,188,307,188,188
10054,2012-02-28,Spring,2012,Feb,22,0,Tuesday,1,Clear,0.34,0.3485,0.46,0.1045,6,95,101,307,101,101
10055,2012-02-28,Spring,2012,Feb,23,0,Tuesday,1,Clear,0.32,0.303,0.53,0.2239,4,61,65,307,65,65
10056,2012-02-29,Spring,2012,Feb,0,0,Wednesday,1,Clear,0.32,0.3333,0.53,0.1045,2,30,32,306,32,32
10057,2012-02-29,Spring,2012,Feb,1,0,Wednesday,1,Clear,0.32,0.3333,0.49,0.1045,0,6,6,306,6,6
10058,2012-02-29,Spring,2012,Feb,2,0,Wednesday,1,Clear,0.3,0.2879,0.56,0.2239,0,4,4,306,4,4
10059,2012-02-29,Spring,2012,Feb,3,0,Wednesday,1,Clear,0.28,0.303,0.7,0.0896,0,2,2,306,2,2
10060,2012-02-29,Spring,2012,Feb,5,0,Wednesday,1,Clear,0.26,0.2879,0.75,0.0896,0,29,29,306,29,29
10061,2012-02-29,Spring,2012,Feb,6,0,Wednesday,1,Misty,0.28,0.303,0.75,0.0896,4,100,104,306,104,104
10062,2012-02-29,Spring,2012,Feb,7,0,Wednesday,1,Misty,0.26,0.2727,0.81,0.1343,11,242,253,306,253,253
10063,2012-02-29,Spring,2012,Feb,8,0,Wednesday,1,Misty,0.28,0.2879,0.75,0.1045,2,114,116,306,116,116
10064,2012-02-29,Spring,2012,Feb,9,0,Wednesday,1,Light_rainsnow,0.3,0.303,0.81,0.1642,5,33,38,306,38,38
10065,2012-02-29,Spring,2012,Feb,10,0,Wednesday,1,Light_rainsnow,0.3,0.303,0.81,0.1642,0,10,10,306,10,10
10066,2012-02-29,Spring,2012,Feb,11,0,Wednesday,1,Light_rainsnow,0.3,0.2879,0.87,0.194,1,9,10,306,10,10
10067,2012-02-29,Spring,2012,Feb,12,0,Wednesday,1,Light_rainsnow,0.32,0.303,0.93,0.3284,1,69,70,306,70,70
10068,2012-02-29,Spring,2012,Feb,13,0,Wednesday,1,Misty,0.36,0.3333,0.93,0.3582,4,72,76,306,76,76
10069,2012-02-29,Spring,2012,Feb,14,0,Wednesday,1,Misty,0.36,0.3333,0.93,0.3582,2,54,56,306,56,56
10070,2012-02-29,Spring,2012,Feb,15,0,Wednesday,1,Misty,0.4,0.4091,0.82,0.2836,3,87,90,306,90,90
10071,2012-02-29,Spring,2012,Feb,16,0,Wednesday,1,Light_rainsnow,0.4,0.4091,0.82,0.2239,5,162,167,306,167,167
10072,2012-02-29,Spring,2012,Feb,17,0,Wednesday,1,Misty,0.4,0.4091,0.87,0.1642,7,246,253,306,253,253
10073,2012-02-29,Spring,2012,Feb,18,0,Wednesday,1,Light_rainsnow,0.4,0.4091,0.87,0.0,11,181,192,306,192,192
10074,2012-02-29,Spring,2012,Feb,19,0,Wednesday,1,Misty,0.4,0.4091,0.87,0.1045,0,102,102,306,102,102
10075,2012-02-29,Spring,2012,Feb,20,0,Wednesday,1,Light_rainsnow,0.42,0.4242,0.88,0.1642,2,95,97,306,97,97
10076,2012-02-29,Spring,2012,Feb,21,0,Wednesday,1,Light_rainsnow,0.42,0.4242,0.88,0.1642,0,39,39,306,39,39
10077,2012-02-29,Spring,2012,Feb,22,0,Wednesday,1,Light_rainsnow,0.42,0.4242,0.94,0.2537,2,53,55,306,55,55
10078,2012-02-29,Spring,2012,Feb,23,0,Wednesday,1,Light_rainsnow,0.42,0.4242,0.94,0.2537,3,30,33,306,33,33
10079,2012-03-01,Spring,2012,Mar,0,0,Thursday,1,Misty,0.42,0.4242,0.94,0.0,1,10,11,305,11,11
10080,2012-03-01,Spring,2012,Mar,1,0,Thursday,1,Light_rainsnow,0.46,0.4545,0.94,0.1045,0,12,12,305,12,12
10081,2012-03-01,Spring,2012,Mar,2,0,Thursday,1,Misty,0.46,0.4545,0.94,0.2836,0,6,6,305,6,6
10082,2012-03-01,Spring,2012,Mar,3,0,Thursday,1,Clear,0.46,0.4545,0.94,0.2239,0,3,3,305,3,3
10083,2012-03-01,Spring,2012,Mar,4,0,Thursday,1,Clear,0.48,0.4697,0.88,0.194,0,5,5,305,5,5
10084,2012-03-01,Spring,2012,Mar,5,0,Thursday,1,Clear,0.48,0.4697,0.88,0.1642,0,18,18,305,18,18
10085,2012-03-01,Spring,2012,Mar,6,0,Thursday,1,Misty,0.42,0.4242,0.94,0.0,2,107,109,305,109,109
10086,2012-03-01,Spring,2012,Mar,7,0,Thursday,1,Misty,0.44,0.4394,0.94,0.1343,8,296,304,305,304,304
10087,2012-03-01,Spring,2012,Mar,8,0,Thursday,1,Clear,0.42,0.4242,0.94,0.1343,15,579,594,305,594,594
10088,2012-03-01,Spring,2012,Mar,9,0,Thursday,1,Clear,0.46,0.4545,0.77,0.2537,5,281,286,305,286,286
10089,2012-03-01,Spring,2012,Mar,10,0,Thursday,1,Clear,0.52,0.5,0.55,0.1642,11,122,133,305,133,133
10090,2012-03-01,Spring,2012,Mar,11,0,Thursday,1,Clear,0.56,0.5303,0.43,0.194,19,149,168,305,168,168
10091,2012-03-01,Spring,2012,Mar,12,0,Thursday,1,Clear,0.56,0.5303,0.37,0.2239,16,204,220,305,220,220
10092,2012-03-01,Spring,2012,Mar,13,0,Thursday,1,Clear,0.58,0.5455,0.32,0.2537,24,187,211,305,211,211
10093,2012-03-01,Spring,2012,Mar,14,0,Thursday,1,Clear,0.58,0.5455,0.35,0.2239,37,174,211,305,211,211
10094,2012-03-01,Spring,2012,Mar,15,0,Thursday,1,Clear,0.6,0.6212,0.31,0.2537,31,192,223,305,223,223
10095,2012-03-01,Spring,2012,Mar,16,0,Thursday,1,Clear,0.58,0.5455,0.32,0.2985,38,323,361,305,361,361
10096,2012-03-01,Spring,2012,Mar,17,0,Thursday,1,Clear,0.56,0.5303,0.35,0.2985,49,551,600,305,600,600
10097,2012-03-01,Spring,2012,Mar,18,0,Thursday,1,Clear,0.54,0.5152,0.34,0.3582,27,498,525,305,525,525
10098,2012-03-01,Spring,2012,Mar,19,0,Thursday,1,Clear,0.48,0.4697,0.41,0.3284,11,317,328,305,328,328
10099,2012-03-01,Spring,2012,Mar,20,0,Thursday,1,Clear,0.44,0.4394,0.44,0.4179,12,242,254,305,254,254
10100,2012-03-01,Spring,2012,Mar,21,0,Thursday,1,Clear,0.42,0.4242,0.47,0.4627,7,190,197,305,197,197
10101,2012-03-01,Spring,2012,Mar,22,0,Thursday,1,Clear,0.38,0.3939,0.5,0.2537,3,123,126,305,126,126
10102,2012-03-01,Spring,2012,Mar,23,0,Thursday,1,Clear,0.36,0.3485,0.5,0.2239,9,76,85,305,85,85
10103,2012-03-02,Spring,2012,Mar,0,0,Friday,1,Clear,0.34,0.3333,0.53,0.1642,1,45,46,304,46,46
10104,2012-03-02,Spring,2012,Mar,1,0,Friday,1,Clear,0.34,0.3182,0.49,0.2239,2,18,20,304,20,20
10105,2012-03-02,Spring,2012,Mar,2,0,Friday,1,Clear,0.34,0.3182,0.53,0.2836,2,4,6,304,6,6
10106,2012-03-02,Spring,2012,Mar,3,0,Friday,1,Clear,0.32,0.3182,0.57,0.194,0,3,3,304,3,3
10107,2012-03-02,Spring,2012,Mar,4,0,Friday,1,Clear,0.32,0.3485,0.61,0.0,0,2,2,304,2,2
10108,2012-03-02,Spring,2012,Mar,5,0,Friday,1,Clear,0.3,0.3333,0.7,0.0,0,24,24,304,24,24
10109,2012-03-02,Spring,2012,Mar,6,0,Friday,1,Clear,0.3,0.3333,0.7,0.0,4,88,92,304,92,92
10110,2012-03-02,Spring,2012,Mar,7,0,Friday,1,Clear,0.3,0.3333,0.7,0.0,4,258,262,304,262,262
10111,2012-03-02,Spring,2012,Mar,8,0,Friday,1,Clear,0.28,0.303,0.75,0.0896,16,533,549,304,549,549
10112,2012-03-02,Spring,2012,Mar,9,0,Friday,1,Clear,0.3,0.3333,0.81,0.0,15,299,314,304,314,314
10113,2012-03-02,Spring,2012,Mar,10,0,Friday,1,Clear,0.36,0.3485,0.5,0.1642,14,118,132,304,132,132
10114,2012-03-02,Spring,2012,Mar,11,0,Friday,1,Clear,0.38,0.3939,0.46,0.194,40,154,194,304,194,194
10115,2012-03-02,Spring,2012,Mar,12,0,Friday,1,Clear,0.4,0.4091,0.43,0.1642,40,194,234,304,234,234
10116,2012-03-02,Spring,2012,Mar,13,0,Friday,1,Clear,0.42,0.4242,0.44,0.2239,31,191,222,304,222,222
10117,2012-03-02,Spring,2012,Mar,14,0,Friday,1,Misty,0.44,0.4394,0.44,0.2836,29,176,205,304,205,205
10118,2012-03-02,Spring,2012,Mar,15,0,Friday,1,Misty,0.42,0.4242,0.5,0.2985,5,73,78,304,78,78
10119,2012-03-02,Spring,2012,Mar,16,0,Friday,1,Light_rainsnow,0.4,0.4091,0.58,0.2985,1,49,50,304,50,50
10120,2012-03-02,Spring,2012,Mar,17,0,Friday,1,Light_rainsnow,0.36,0.3485,0.81,0.2239,5,123,128,304,128,128
10121,2012-03-02,Spring,2012,Mar,18,0,Friday,1,Light_rainsnow,0.36,0.3485,0.87,0.194,6,154,160,304,160,160
10122,2012-03-02,Spring,2012,Mar,19,0,Friday,1,Light_rainsnow,0.36,0.3485,0.87,0.194,12,162,174,304,174,174
10123,2012-03-02,Spring,2012,Mar,20,0,Friday,1,Misty,0.36,0.3485,0.87,0.194,7,93,100,304,100,100
10124,2012-03-02,Spring,2012,Mar,21,0,Friday,1,Light_rainsnow,0.36,0.3636,0.87,0.0896,2,99,101,304,101,101
10125,2012-03-02,Spring,2012,Mar,22,0,Friday,1,Misty,0.36,0.3788,0.87,0.0,6,69,75,304,75,75
10126,2012-03-02,Spring,2012,Mar,23,0,Friday,1,Misty,0.36,0.3788,0.87,0.0,4,19,23,304,23,23
10127,2012-03-03,Spring,2012,Mar,0,0,Saturday,0,Light_rainsnow,0.36,0.3636,0.93,0.0896,1,21,22,303,22,22
10128,2012-03-03,Spring,2012,Mar,1,0,Saturday,0,Light_rainsnow,0.36,0.3788,0.93,0.0,0,44,44,303,44,44
10129,2012-03-03,Spring,2012,Mar,2,0,Saturday,0,Light_rainsnow,0.36,0.3636,0.93,0.0896,4,34,38,303,38,38
10130,2012-03-03,Spring,2012,Mar,3,0,Saturday,0,Misty,0.36,0.3485,0.93,0.1642,1,20,21,303,21,21
10131,2012-03-03,Spring,2012,Mar,4,0,Saturday,0,Misty,0.36,0.3485,0.93,0.194,0,2,2,303,2,2
10132,2012-03-03,Spring,2012,Mar,5,0,Saturday,0,Misty,0.36,0.3636,0.93,0.0896,1,1,2,303,2,2
10133,2012-03-03,Spring,2012,Mar,6,0,Saturday,0,Misty,0.36,0.3636,0.93,0.0896,1,6,7,303,7,7
10134,2012-03-03,Spring,2012,Mar,7,0,Saturday,0,Misty,0.36,0.3485,0.93,0.1343,2,14,16,303,16,16
10135,2012-03-03,Spring,2012,Mar,8,0,Saturday,0,Light_rainsnow,0.36,0.3788,0.93,0.0,2,46,48,303,48,48
10136,2012-03-03,Spring,2012,Mar,9,0,Saturday,0,Light_rainsnow,0.38,0.3939,0.87,0.0896,7,87,94,303,94,94
10137,2012-03-03,Spring,2012,Mar,10,0,Saturday,0,Misty,0.4,0.4091,0.87,0.0,31,137,168,303,168,168
10138,2012-03-03,Spring,2012,Mar,11,0,Saturday,0,Misty,0.4,0.4091,0.87,0.0896,33,181,214,303,214,214
10139,2012-03-03,Spring,2012,Mar,12,0,Saturday,0,Misty,0.42,0.4242,0.67,0.2537,47,252,299,303,299,299
10140,2012-03-03,Spring,2012,Mar,13,0,Saturday,0,Clear,0.44,0.4394,0.51,0.2836,87,252,339,303,339,339
10141,2012-03-03,Spring,2012,Mar,14,0,Saturday,0,Misty,0.46,0.4545,0.44,0.3582,151,279,430,303,430,430
10142,2012-03-03,Spring,2012,Mar,15,0,Saturday,0,Clear,0.48,0.4697,0.29,0.2985,145,254,399,303,399,399
10143,2012-03-03,Spring,2012,Mar,16,0,Saturday,0,Clear,0.5,0.4848,0.27,0.2985,167,300,467,303,467,467
10144,2012-03-03,Spring,2012,Mar,17,0,Saturday,0,Clear,0.5,0.4848,0.23,0.3284,106,279,385,303,385,385
10145,2012-03-03,Spring,2012,Mar,18,0,Saturday,0,Clear,0.5,0.4848,0.25,0.2537,53,250,303,303,303,303
10146,2012-03-03,Spring,2012,Mar,19,0,Saturday,0,Clear,0.46,0.4545,0.33,0.1642,34,191,225,303,225,225
10147,2012-03-03,Spring,2012,Mar,20,0,Saturday,0,Clear,0.44,0.4394,0.3,0.1343,28,121,149,303,149,149
10148,2012-03-03,Spring,2012,Mar,21,0,Saturday,0,Clear,0.46,0.4545,0.19,0.3284,24,130,154,303,154,154
10149,2012-03-03,Spring,2012,Mar,22,0,Saturday,0,Clear,0.44,0.4394,0.21,0.1343,19,115,134,303,134,134
10150,2012-03-03,Spring,2012,Mar,23,0,Saturday,0,Clear,0.42,0.4242,0.24,0.0,12,94,106,303,106,106
10151,2012-03-04,Spring,2012,Mar,0,0,Sunday,0,Misty,0.4,0.4091,0.3,0.3582,5,67,72,302,72,72
10152,2012-03-04,Spring,2012,Mar,1,0,Sunday,0,Misty,0.38,0.3939,0.34,0.194,16,60,76,302,76,76
10153,2012-03-04,Spring,2012,Mar,2,0,Sunday,0,Misty,0.36,0.3485,0.4,0.1642,14,66,80,302,80,80
10154,2012-03-04,Spring,2012,Mar,3,0,Sunday,0,Misty,0.36,0.3485,0.43,0.1343,5,21,26,302,26,26
10155,2012-03-04,Spring,2012,Mar,4,0,Sunday,0,Misty,0.34,0.3333,0.46,0.194,3,11,14,302,14,14
10156,2012-03-04,Spring,2012,Mar,5,0,Sunday,0,Misty,0.34,0.3182,0.46,0.2239,0,5,5,302,5,5
10157,2012-03-04,Spring,2012,Mar,6,0,Sunday,0,Misty,0.3,0.2727,0.52,0.2985,0,5,5,302,5,5
10158,2012-03-04,Spring,2012,Mar,7,0,Sunday,0,Misty,0.3,0.2727,0.52,0.2985,2,21,23,302,23,23
10159,2012-03-04,Spring,2012,Mar,8,0,Sunday,0,Clear,0.3,0.2727,0.52,0.3284,12,54,66,302,66,66
10160,2012-03-04,Spring,2012,Mar,9,0,Sunday,0,Clear,0.3,0.2727,0.49,0.4478,14,104,118,302,118,118
10161,2012-03-04,Spring,2012,Mar,10,0,Sunday,0,Clear,0.3,0.2727,0.49,0.3284,31,161,192,302,192,192
10162,2012-03-04,Spring,2012,Mar,11,0,Sunday,0,Clear,0.32,0.2879,0.45,0.3881,64,192,256,302,256,256
10163,2012-03-04,Spring,2012,Mar,12,0,Sunday,0,Clear,0.34,0.303,0.42,0.3582,71,256,327,302,327,327
10164,2012-03-04,Spring,2012,Mar,13,0,Sunday,0,Clear,0.36,0.3333,0.37,0.3582,108,256,364,302,364,364
10165,2012-03-04,Spring,2012,Mar,14,0,Sunday,0,Clear,0.36,0.3333,0.34,0.3582,106,226,332,302,332,332
10166,2012-03-04,Spring,2012,Mar,15,0,Sunday,0,Clear,0.36,0.3182,0.32,0.5224,82,252,334,302,334,334
10167,2012-03-04,Spring,2012,Mar,16,0,Sunday,0,Clear,0.36,0.3182,0.29,0.4925,68,231,299,302,299,299
10168,2012-03-04,Spring,2012,Mar,17,0,Sunday,0,Clear,0.34,0.2879,0.31,0.5522,49,214,263,302,263,263
10169,2012-03-04,Spring,2012,Mar,18,0,Sunday,0,Clear,0.32,0.2727,0.33,0.6119,20,164,184,302,184,184
10170,2012-03-04,Spring,2012,Mar,19,0,Sunday,0,Clear,0.3,0.2576,0.36,0.4925,12,120,132,302,132,132
10171,2012-03-04,Spring,2012,Mar,20,0,Sunday,0,Clear,0.28,0.2727,0.38,0.2537,8,80,88,302,88,88
10172,2012-03-04,Spring,2012,Mar,21,0,Sunday,0,Clear,0.28,0.2727,0.36,0.2239,9,70,79,302,79,79
10173,2012-03-04,Spring,2012,Mar,22,0,Sunday,0,Clear,0.26,0.2424,0.41,0.2537,9,53,62,302,62,62
10174,2012-03-04,Spring,2012,Mar,23,0,Sunday,0,Clear,0.26,0.2576,0.41,0.194,2,24,26,302,26,26
10175,2012-03-05,Spring,2012,Mar,0,0,Monday,1,Clear,0.24,0.2273,0.44,0.194,2,15,17,301,17,17
10176,2012-03-05,Spring,2012,Mar,1,0,Monday,1,Clear,0.24,0.2424,0.48,0.1343,3,3,6,301,6,6
10177,2012-03-05,Spring,2012,Mar,2,0,Monday,1,Clear,0.24,0.2424,0.48,0.1343,1,3,4,301,4,4
10178,2012-03-05,Spring,2012,Mar,3,0,Monday,1,Clear,0.22,0.2273,0.51,0.1642,0,1,1,301,1,1
10179,2012-03-05,Spring,2012,Mar,4,0,Monday,1,Clear,0.2,0.2273,0.55,0.0896,0,1,1,301,1,1
10180,2012-03-05,Spring,2012,Mar,5,0,Monday,1,Clear,0.2,0.2273,0.55,0.0896,1,17,18,301,18,18
10181,2012-03-05,Spring,2012,Mar,6,0,Monday,1,Clear,0.18,0.197,0.59,0.1343,2,89,91,301,91,91
10182,2012-03-05,Spring,2012,Mar,7,0,Monday,1,Clear,0.18,0.197,0.59,0.1343,7,253,260,301,260,260
10183,2012-03-05,Spring,2012,Mar,8,0,Monday,1,Clear,0.2,0.2273,0.59,0.1045,13,415,428,301,428,428
10184,2012-03-05,Spring,2012,Mar,9,0,Monday,1,Misty,0.22,0.2576,0.6,0.0896,11,186,197,301,197,197
10185,2012-03-05,Spring,2012,Mar,10,0,Monday,1,Misty,0.24,0.2576,0.6,0.0,12,74,86,301,86,86
10186,2012-03-05,Spring,2012,Mar,11,0,Monday,1,Misty,0.26,0.2727,0.56,0.1343,17,86,103,301,103,103
10187,2012-03-05,Spring,2012,Mar,12,0,Monday,1,Misty,0.26,0.303,0.52,0.0,15,122,137,301,137,137
10188,2012-03-05,Spring,2012,Mar,13,0,Monday,1,Misty,0.26,0.2576,0.55,0.2985,11,109,120,301,120,120
10189,2012-03-05,Spring,2012,Mar,14,0,Monday,1,Misty,0.28,0.2576,0.57,0.3582,13,115,128,301,128,128
10190,2012-03-05,Spring,2012,Mar,15,0,Monday,1,Misty,0.3,0.2879,0.53,0.194,20,110,130,301,130,130
10191,2012-03-05,Spring,2012,Mar,16,0,Monday,1,Clear,0.3,0.2727,0.45,0.2985,30,180,210,301,210,210
10192,2012-03-05,Spring,2012,Mar,17,0,Monday,1,Light_rainsnow,0.3,0.2727,0.45,0.2985,11,376,387,301,387,387
10193,2012-03-05,Spring,2012,Mar,18,0,Monday,1,Light_rainsnow,0.28,0.2273,0.55,0.6567,12,363,375,301,375,375
10194,2012-03-05,Spring,2012,Mar,19,0,Monday,1,Clear,0.26,0.2576,0.53,0.2239,6,220,226,301,226,226
10195,2012-03-05,Spring,2012,Mar,20,0,Monday,1,Clear,0.26,0.2273,0.37,0.4627,8,171,179,301,179,179
10196,2012-03-05,Spring,2012,Mar,21,0,Monday,1,Clear,0.26,0.2273,0.37,0.3881,4,116,120,301,120,120
10197,2012-03-05,Spring,2012,Mar,22,0,Monday,1,Clear,0.24,0.2121,0.35,0.3284,2,76,78,301,78,78
10198,2012-03-05,Spring,2012,Mar,23,0,Monday,1,Clear,0.22,0.1818,0.37,0.5821,2,29,31,301,31,31
10199,2012-03-06,Spring,2012,Mar,0,0,Tuesday,1,Clear,0.22,0.2121,0.37,0.2985,0,8,8,300,8,8
10200,2012-03-06,Spring,2012,Mar,1,0,Tuesday,1,Clear,0.2,0.197,0.44,0.2537,0,6,6,300,6,6
10201,2012-03-06,Spring,2012,Mar,2,0,Tuesday,1,Clear,0.2,0.197,0.44,0.2239,0,4,4,300,4,4
10202,2012-03-06,Spring,2012,Mar,3,0,Tuesday,1,Clear,0.18,0.1667,0.51,0.2836,0,1,1,300,1,1
10203,2012-03-06,Spring,2012,Mar,4,0,Tuesday,1,Clear,0.18,0.1667,0.51,0.2985,0,3,3,300,3,3
10204,2012-03-06,Spring,2012,Mar,5,0,Tuesday,1,Clear,0.18,0.1818,0.51,0.2239,0,25,25,300,25,25
10205,2012-03-06,Spring,2012,Mar,6,0,Tuesday,1,Clear,0.18,0.2121,0.51,0.1045,3,99,102,300,102,102
10206,2012-03-06,Spring,2012,Mar,7,0,Tuesday,1,Clear,0.16,0.1818,0.55,0.1343,5,270,275,300,275,275
10207,2012-03-06,Spring,2012,Mar,8,0,Tuesday,1,Clear,0.16,0.1818,0.59,0.1045,14,487,501,300,501,501
10208,2012-03-06,Spring,2012,Mar,9,0,Tuesday,1,Clear,0.22,0.2727,0.47,0.0,11,222,233,300,233,233
10209,2012-03-06,Spring,2012,Mar,10,0,Tuesday,1,Clear,0.24,0.2576,0.44,0.0,16,113,129,300,129,129
10210,2012-03-06,Spring,2012,Mar,11,0,Tuesday,1,Clear,0.26,0.2576,0.41,0.1642,20,110,130,300,130,130
10211,2012-03-06,Spring,2012,Mar,12,0,Tuesday,1,Clear,0.26,0.2727,0.41,0.1045,9,129,138,300,138,138
10212,2012-03-06,Spring,2012,Mar,13,0,Tuesday,1,Clear,0.3,0.303,0.39,0.1343,16,148,164,300,164,164
10213,2012-03-06,Spring,2012,Mar,14,0,Tuesday,1,Clear,0.32,0.303,0.36,0.2239,20,116,136,300,136,136
10214,2012-03-06,Spring,2012,Mar,15,0,Tuesday,1,Clear,0.34,0.303,0.36,0.2985,24,142,166,300,166,166
10215,2012-03-06,Spring,2012,Mar,16,0,Tuesday,1,Clear,0.36,0.3333,0.32,0.2836,22,228,250,300,250,250
10216,2012-03-06,Spring,2012,Mar,17,0,Tuesday,1,Clear,0.36,0.3333,0.34,0.2836,21,425,446,300,446,446
10217,2012-03-06,Spring,2012,Mar,18,0,Tuesday,1,Clear,0.34,0.303,0.42,0.3284,15,442,457,300,457,457
10218,2012-03-06,Spring,2012,Mar,19,0,Tuesday,1,Clear,0.34,0.303,0.46,0.2985,9,278,287,300,287,287
10219,2012-03-06,Spring,2012,Mar,20,0,Tuesday,1,Clear,0.32,0.3182,0.49,0.194,3,184,187,300,187,187
10220,2012-03-06,Spring,2012,Mar,21,0,Tuesday,1,Clear,0.32,0.3182,0.49,0.194,5,143,148,300,148,148
10221,2012-03-06,Spring,2012,Mar,22,0,Tuesday,1,Clear,0.28,0.2727,0.56,0.1642,5,101,106,300,106,106
10222,2012-03-06,Spring,2012,Mar,23,0,Tuesday,1,Clear,0.28,0.2727,0.61,0.2239,3,51,54,300,54,54
10223,2012-03-07,Spring,2012,Mar,0,0,Wednesday,1,Clear,0.28,0.2576,0.65,0.2836,3,12,15,299,15,15
10224,2012-03-07,Spring,2012,Mar,1,0,Wednesday,1,Clear,0.3,0.2727,0.61,0.2985,1,4,5,299,5,5
10225,2012-03-07,Spring,2012,Mar,2,0,Wednesday,1,Clear,0.3,0.2879,0.56,0.2836,0,4,4,299,4,4
10226,2012-03-07,Spring,2012,Mar,3,0,Wednesday,1,Clear,0.3,0.2727,0.56,0.3582,1,2,3,299,3,3
10227,2012-03-07,Spring,2012,Mar,4,0,Wednesday,1,Clear,0.28,0.2576,0.61,0.3284,0,3,3,299,3,3
10228,2012-03-07,Spring,2012,Mar,5,0,Wednesday,1,Clear,0.28,0.2576,0.56,0.2985,0,18,18,299,18,18
10229,2012-03-07,Spring,2012,Mar,6,0,Wednesday,1,Clear,0.28,0.2576,0.61,0.3881,4,104,108,299,108,108
10230,2012-03-07,Spring,2012,Mar,7,0,Wednesday,1,Clear,0.26,0.2273,0.65,0.3881,12,332,344,299,344,344
10231,2012-03-07,Spring,2012,Mar,8,0,Wednesday,1,Clear,0.28,0.2576,0.61,0.2985,12,554,566,299,566,566
10232,2012-03-07,Spring,2012,Mar,9,0,Wednesday,1,Clear,0.3,0.2727,0.61,0.3284,12,252,264,299,264,264
10233,2012-03-07,Spring,2012,Mar,10,0,Wednesday,1,Clear,0.36,0.3333,0.5,0.2985,20,127,147,299,147,147
10234,2012-03-07,Spring,2012,Mar,11,0,Wednesday,1,Clear,0.42,0.4242,0.38,0.2985,33,128,161,299,161,161
10235,2012-03-07,Spring,2012,Mar,12,0,Wednesday,1,Clear,0.44,0.4394,0.38,0.3881,40,175,215,299,215,215
10236,2012-03-07,Spring,2012,Mar,13,0,Wednesday,1,Clear,0.5,0.4848,0.34,0.4179,26,179,205,299,205,205
10237,2012-03-07,Spring,2012,Mar,14,0,Wednesday,1,Clear,0.52,0.5,0.36,0.3284,38,137,175,299,175,175
10238,2012-03-07,Spring,2012,Mar,15,0,Wednesday,1,Clear,0.54,0.5152,0.37,0.4478,44,165,209,299,209,209
10239,2012-03-07,Spring,2012,Mar,16,0,Wednesday,1,Clear,0.56,0.5303,0.37,0.4179,34,254,288,299,288,288
10240,2012-03-07,Spring,2012,Mar,17,0,Wednesday,1,Clear,0.56,0.5303,0.43,0.4925,58,554,612,299,612,612
10241,2012-03-07,Spring,2012,Mar,18,0,Wednesday,1,Clear,0.56,0.5303,0.4,0.4627,35,509,544,299,544,544
10242,2012-03-07,Spring,2012,Mar,19,0,Wednesday,1,Clear,0.54,0.5152,0.42,0.3582,16,345,361,299,361,361
10243,2012-03-07,Spring,2012,Mar,20,0,Wednesday,1,Clear,0.5,0.4848,0.51,0.2537,18,242,260,299,260,260
10244,2012-03-07,Spring,2012,Mar,21,0,Wednesday,1,Clear,0.44,0.4394,0.62,0.2537,11,177,188,299,188,188
10245,2012-03-07,Spring,2012,Mar,22,0,Wednesday,1,Clear,0.46,0.4545,0.59,0.2985,10,149,159,299,159,159
10246,2012-03-07,Spring,2012,Mar,23,0,Wednesday,1,Clear,0.44,0.4394,0.62,0.3284,4,58,62,299,62,62
10247,2012-03-08,Spring,2012,Mar,0,0,Thursday,1,Clear,0.44,0.4394,0.62,0.3284,11,35,46,298,46,46
10248,2012-03-08,Spring,2012,Mar,1,0,Thursday,1,Clear,0.46,0.4545,0.63,0.3284,4,17,21,298,21,21
10249,2012-03-08,Spring,2012,Mar,2,0,Thursday,1,Clear,0.46,0.4545,0.63,0.3881,6,5,11,298,11,11
10250,2012-03-08,Spring,2012,Mar,3,0,Thursday,1,Clear,0.46,0.4545,0.63,0.3881,0,3,3,298,3,3
10251,2012-03-08,Spring,2012,Mar,4,0,Thursday,1,Clear,0.44,0.4394,0.72,0.2836,0,2,2,298,2,2
10252,2012-03-08,Spring,2012,Mar,5,0,Thursday,1,Clear,0.42,0.4242,0.77,0.2239,1,28,29,298,29,29
10253,2012-03-08,Spring,2012,Mar,6,0,Thursday,1,Clear,0.42,0.4242,0.77,0.2537,4,105,109,298,109,109
10254,2012-03-08,Spring,2012,Mar,7,0,Thursday,1,Clear,0.42,0.4242,0.77,0.3582,8,326,334,298,334,334
10255,2012-03-08,Spring,2012,Mar,8,0,Thursday,1,Clear,0.44,0.4394,0.77,0.3881,12,573,585,298,585,585
10256,2012-03-08,Spring,2012,Mar,9,0,Thursday,1,Clear,0.46,0.4545,0.72,0.4627,19,282,301,298,301,301
10257,2012-03-08,Spring,2012,Mar,10,0,Thursday,1,Clear,0.5,0.4848,0.68,0.4627,19,119,138,298,138,138
10258,2012-03-08,Spring,2012,Mar,11,0,Thursday,1,Misty,0.54,0.5152,0.6,0.4627,48,156,204,298,204,204
10259,2012-03-08,Spring,2012,Mar,12,0,Thursday,1,Misty,0.56,0.5303,0.6,0.4478,27,224,251,298,251,251
10260,2012-03-08,Spring,2012,Mar,13,0,Thursday,1,Misty,0.6,0.6212,0.49,0.6418,35,198,233,298,233,233
10261,2012-03-08,Spring,2012,Mar,14,0,Thursday,1,Misty,0.62,0.6212,0.43,0.6418,48,155,203,298,203,203
10262,2012-03-08,Spring,2012,Mar,15,0,Thursday,1,Clear,0.64,0.6212,0.38,0.6866,24,161,185,298,185,185
10263,2012-03-08,Spring,2012,Mar,16,0,Thursday,1,Misty,0.62,0.6212,0.41,0.6418,37,305,342,298,342,342
10264,2012-03-08,Spring,2012,Mar,17,0,Thursday,1,Clear,0.62,0.6212,0.38,0.6567,52,545,597,298,597,597
10265,2012-03-08,Spring,2012,Mar,18,0,Thursday,1,Misty,0.62,0.6212,0.38,0.5522,45,545,590,298,590,590
10266,2012-03-08,Spring,2012,Mar,19,0,Thursday,1,Misty,0.6,0.6212,0.4,0.4478,21,395,416,298,416,416
10267,2012-03-08,Spring,2012,Mar,20,0,Thursday,1,Misty,0.6,0.6212,0.43,0.3881,20,282,302,298,302,302
10268,2012-03-08,Spring,2012,Mar,21,0,Thursday,1,Clear,0.6,0.6212,0.43,0.3881,27,206,233,298,233,233
10269,2012-03-08,Spring,2012,Mar,22,0,Thursday,1,Clear,0.56,0.5303,0.49,0.3284,12,141,153,298,153,153
10270,2012-03-08,Spring,2012,Mar,23,0,Thursday,1,Misty,0.56,0.5303,0.49,0.4478,6,88,94,298,94,94
10271,2012-03-09,Spring,2012,Mar,0,0,Friday,1,Misty,0.58,0.5455,0.49,0.4627,3,51,54,297,54,54
10272,2012-03-09,Spring,2012,Mar,1,0,Friday,1,Light_rainsnow,0.56,0.5303,0.52,0.4925,4,22,26,297,26,26
10273,2012-03-09,Spring,2012,Mar,2,0,Friday,1,Light_rainsnow,0.48,0.4697,0.77,0.4179,2,9,11,297,11,11
10274,2012-03-09,Spring,2012,Mar,3,0,Friday,1,Clear,0.46,0.4545,0.77,0.5224,0,7,7,297,7,7
10275,2012-03-09,Spring,2012,Mar,4,0,Friday,1,Light_rainsnow,0.4,0.4091,0.66,0.2836,0,1,1,297,1,1
10276,2012-03-09,Spring,2012,Mar,5,0,Friday,1,Light_rainsnow,0.4,0.4091,0.66,0.2836,2,27,29,297,29,29
10277,2012-03-09,Spring,2012,Mar,6,0,Friday,1,Misty,0.4,0.4091,0.5,0.3582,2,83,85,297,85,85
10278,2012-03-09,Spring,2012,Mar,7,0,Friday,1,Misty,0.38,0.3939,0.4,0.2985,6,262,268,297,268,268
10279,2012-03-09,Spring,2012,Mar,8,0,Friday,1,Misty,0.34,0.2879,0.42,0.5224,17,484,501,297,501,501
10280,2012-03-09,Spring,2012,Mar,9,0,Friday,1,Misty,0.34,0.2879,0.42,0.5224,17,267,284,297,284,284
10281,2012-03-09,Spring,2012,Mar,10,0,Friday,1,Misty,0.34,0.2879,0.36,0.4925,14,145,159,297,159,159
10282,2012-03-09,Spring,2012,Mar,11,0,Friday,1,Misty,0.36,0.3333,0.34,0.3582,17,170,187,297,187,187
10283,2012-03-09,Spring,2012,Mar,12,0,Friday,1,Clear,0.36,0.3333,0.34,0.4179,27,174,201,297,201,201
10284,2012-03-09,Spring,2012,Mar,13,0,Friday,1,Misty,0.38,0.3939,0.29,0.3881,49,175,224,297,224,224
10285,2012-03-09,Spring,2012,Mar,14,0,Friday,1,Clear,0.42,0.4242,0.28,0.4627,49,129,178,297,178,178
10286,2012-03-09,Spring,2012,Mar,15,0,Friday,1,Clear,0.46,0.4545,0.24,0.2537,50,188,238,297,238,238
10287,2012-03-09,Spring,2012,Mar,16,0,Friday,1,Clear,0.48,0.4697,0.23,0.4179,51,292,343,297,343,343
10288,2012-03-09,Spring,2012,Mar,17,0,Friday,1,Clear,0.46,0.4545,0.24,0.3881,68,498,566,297,566,566
10289,2012-03-09,Spring,2012,Mar,18,0,Friday,1,Clear,0.44,0.4394,0.26,0.5224,30,440,470,297,470,470
10290,2012-03-09,Spring,2012,Mar,19,0,Friday,1,Clear,0.42,0.4242,0.28,0.6119,12,232,244,297,244,244
10291,2012-03-09,Spring,2012,Mar,20,0,Friday,1,Clear,0.38,0.3939,0.32,0.3582,3,156,159,297,159,159
10292,2012-03-09,Spring,2012,Mar,21,0,Friday,1,Clear,0.36,0.3333,0.34,0.3284,8,133,141,297,141,141
10293,2012-03-09,Spring,2012,Mar,22,0,Friday,1,Clear,0.34,0.2879,0.31,0.4925,7,100,107,297,107,107
10294,2012-03-09,Spring,2012,Mar,23,0,Friday,1,Clear,0.32,0.303,0.33,0.2985,9,77,86,297,86,86
10295,2012-03-10,Spring,2012,Mar,0,0,Saturday,0,Clear,0.3,0.2727,0.36,0.3582,9,68,77,296,77,77
10296,2012-03-10,Spring,2012,Mar,1,0,Saturday,0,Clear,0.3,0.2879,0.36,0.2537,1,50,51,296,51,51
10297,2012-03-10,Spring,2012,Mar,2,0,Saturday,0,Clear,0.26,0.2424,0.41,0.2537,12,30,42,296,42,42
10298,2012-03-10,Spring,2012,Mar,3,0,Saturday,0,Clear,0.26,0.2273,0.41,0.2985,0,16,16,296,16,16
10299,2012-03-10,Spring,2012,Mar,4,0,Saturday,0,Clear,0.24,0.2121,0.41,0.3582,1,3,4,296,4,4
10300,2012-03-10,Spring,2012,Mar,5,0,Saturday,0,Clear,0.22,0.2121,0.42,0.2836,3,7,10,296,10,10
10301,2012-03-10,Spring,2012,Mar,6,0,Saturday,0,Clear,0.22,0.2121,0.44,0.2836,1,11,12,296,12,12
10302,2012-03-10,Spring,2012,Mar,7,0,Saturday,0,Clear,0.22,0.2121,0.44,0.2537,4,36,40,296,40,40
10303,2012-03-10,Spring,2012,Mar,8,0,Saturday,0,Clear,0.22,0.2121,0.44,0.2985,15,96,111,296,111,111
10304,2012-03-10,Spring,2012,Mar,9,0,Saturday,0,Clear,0.24,0.2121,0.41,0.3284,21,127,148,296,148,148
10305,2012-03-10,Spring,2012,Mar,10,0,Saturday,0,Clear,0.26,0.2273,0.35,0.4179,47,176,223,296,223,223
10306,2012-03-10,Spring,2012,Mar,11,0,Saturday,0,Clear,0.3,0.2727,0.33,0.3284,56,218,274,296,274,274
10307,2012-03-10,Spring,2012,Mar,12,0,Saturday,0,Clear,0.3,0.2727,0.33,0.3284,88,241,329,296,329,329
10308,2012-03-10,Spring,2012,Mar,13,0,Saturday,0,Clear,0.32,0.303,0.29,0.2836,89,268,357,296,357,357
10309,2012-03-10,Spring,2012,Mar,14,0,Saturday,0,Clear,0.34,0.3182,0.27,0.2836,117,262,379,296,379,379
10310,2012-03-10,Spring,2012,Mar,15,0,Saturday,0,Clear,0.34,0.3636,0.25,0.0,132,274,406,296,406,406
10311,2012-03-10,Spring,2012,Mar,16,0,Saturday,0,Clear,0.36,0.3636,0.23,0.0,115,275,390,296,390,390
10312,2012-03-10,Spring,2012,Mar,17,0,Saturday,0,Clear,0.36,0.3788,0.23,0.0,104,250,354,296,354,354
10313,2012-03-10,Spring,2012,Mar,18,0,Saturday,0,Clear,0.36,0.3636,0.21,0.0896,67,230,297,296,297,297
10314,2012-03-10,Spring,2012,Mar,19,0,Saturday,0,Clear,0.34,0.3636,0.25,0.0,25,159,184,296,184,184
10315,2012-03-10,Spring,2012,Mar,20,0,Saturday,0,Clear,0.32,0.3333,0.33,0.1343,20,101,121,296,121,121
10316,2012-03-10,Spring,2012,Mar,21,0,Saturday,0,Clear,0.3,0.2879,0.39,0.2239,16,94,110,296,110,110
10317,2012-03-10,Spring,2012,Mar,22,0,Saturday,0,Clear,0.26,0.2576,0.44,0.1642,19,81,100,296,100,100
10318,2012-03-10,Spring,2012,Mar,23,0,Saturday,0,Clear,0.26,0.2576,0.41,0.194,6,77,83,296,83,83
10319,2012-03-11,Spring,2012,Mar,0,0,Sunday,0,Clear,0.26,0.2879,0.44,0.0896,7,62,69,295,69,69
10320,2012-03-11,Spring,2012,Mar,1,0,Sunday,0,Clear,0.24,0.2424,0.52,0.1642,4,57,61,295,61,61
10321,2012-03-11,Spring,2012,Mar,3,0,Sunday,0,Clear,0.24,0.2424,0.6,0.1343,15,51,66,295,66,66
10322,2012-03-11,Spring,2012,Mar,4,0,Sunday,0,Clear,0.24,0.2424,0.6,0.1343,7,15,22,295,22,22
10323,2012-03-11,Spring,2012,Mar,5,0,Sunday,0,Clear,0.24,0.2424,0.6,0.1642,2,5,7,295,7,7
10324,2012-03-11,Spring,2012,Mar,6,0,Sunday,0,Clear,0.24,0.2424,0.7,0.1642,2,8,10,295,10,10
10325,2012-03-11,Spring,2012,Mar,7,0,Sunday,0,Clear,0.22,0.2273,0.69,0.1343,2,15,17,295,17,17
10326,2012-03-11,Spring,2012,Mar,8,0,Sunday,0,Clear,0.22,0.2273,0.69,0.1343,4,68,72,295,72,72
10327,2012-03-11,Spring,2012,Mar,9,0,Sunday,0,Clear,0.26,0.2576,0.6,0.2239,20,70,90,295,90,90
10328,2012-03-11,Spring,2012,Mar,10,0,Sunday,0,Clear,0.32,0.303,0.49,0.2836,71,147,218,295,218,218
10329,2012-03-11,Spring,2012,Mar,11,0,Sunday,0,Clear,0.36,0.3333,0.43,0.2836,90,209,299,295,299,299
10330,2012-03-11,Spring,2012,Mar,12,0,Sunday,0,Clear,0.4,0.4091,0.37,0.2985,146,264,410,295,410,410
10331,2012-03-11,Spring,2012,Mar,13,0,Sunday,0,Clear,0.42,0.4242,0.41,0.2985,176,288,464,295,464,464
10332,2012-03-11,Spring,2012,Mar,14,0,Sunday,0,Clear,0.46,0.4545,0.31,0.2836,212,289,501,295,501,501
10333,2012-03-11,Spring,2012,Mar,15,0,Sunday,0,Clear,0.5,0.4848,0.29,0.2985,201,286,487,295,487,487
10334,2012-03-11,Spring,2012,Mar,16,0,Sunday,0,Clear,0.5,0.4848,0.31,0.3582,208,301,509,295,509,509
10335,2012-03-11,Spring,2012,Mar,17,0,Sunday,0,Clear,0.52,0.5,0.27,0.2985,199,299,498,295,498,498
10336,2012-03-11,Spring,2012,Mar,18,0,Sunday,0,Clear,0.52,0.5,0.29,0.2836,133,256,389,295,389,389
10337,2012-03-11,Spring,2012,Mar,19,0,Sunday,0,Clear,0.5,0.4848,0.31,0.2836,55,203,258,295,258,258
10338,2012-03-11,Spring,2012,Mar,20,0,Sunday,0,Clear,0.44,0.4394,0.47,0.2239,42,129,171,295,171,171
10339,2012-03-11,Spring,2012,Mar,21,0,Sunday,0,Clear,0.42,0.4242,0.54,0.2239,37,110,147,295,147,147
10340,2012-03-11,Spring,2012,Mar,22,0,Sunday,0,Clear,0.4,0.4091,0.54,0.194,13,81,94,295,94,94
10341,2012-03-11,Spring,2012,Mar,23,0,Sunday,0,Clear,0.4,0.4091,0.5,0.1642,12,40,52,295,52,52
10342,2012-03-12,Spring,2012,Mar,0,0,Monday,1,Clear,0.38,0.3939,0.54,0.194,4,20,24,294,24,24
10343,2012-03-12,Spring,2012,Mar,1,0,Monday,1,Clear,0.38,0.3939,0.5,0.1343,1,9,10,294,10,10
10344,2012-03-12,Spring,2012,Mar,2,0,Monday,1,Clear,0.38,0.3939,0.54,0.1045,4,5,9,294,9,9
10345,2012-03-12,Spring,2012,Mar,3,0,Monday,1,Clear,0.36,0.3485,0.5,0.1343,0,2,2,294,2,2
10346,2012-03-12,Spring,2012,Mar,4,0,Monday,1,Clear,0.34,0.3333,0.61,0.194,0,3,3,294,3,3
10347,2012-03-12,Spring,2012,Mar,5,0,Monday,1,Clear,0.34,0.3333,0.61,0.194,1,15,16,294,16,16
10348,2012-03-12,Spring,2012,Mar,6,0,Monday,1,Clear,0.34,0.3485,0.57,0.1045,2,86,88,294,88,88
10349,2012-03-12,Spring,2012,Mar,7,0,Monday,1,Clear,0.34,0.3485,0.53,0.1045,9,259,268,294,268,268
10350,2012-03-12,Spring,2012,Mar,8,0,Monday,1,Clear,0.34,0.3333,0.61,0.1343,17,547,564,294,564,564
10351,2012-03-12,Spring,2012,Mar,9,0,Monday,1,Clear,0.38,0.3939,0.54,0.1642,21,260,281,294,281,281
10352,2012-03-12,Spring,2012,Mar,10,0,Monday,1,Clear,0.4,0.4091,0.5,0.2239,39,98,137,294,137,137
10353,2012-03-12,Spring,2012,Mar,11,0,Monday,1,Clear,0.44,0.4394,0.44,0.2239,39,111,150,294,150,150
10354,2012-03-12,Spring,2012,Mar,12,0,Monday,1,Clear,0.48,0.4697,0.39,0.2239,59,162,221,294,221,221
10355,2012-03-12,Spring,2012,Mar,13,0,Monday,1,Misty,0.54,0.5152,0.32,0.2537,74,176,250,294,250,250
10356,2012-03-12,Spring,2012,Mar,14,0,Monday,1,Misty,0.58,0.5455,0.32,0.2836,76,145,221,294,221,221
10357,2012-03-12,Spring,2012,Mar,15,0,Monday,1,Clear,0.56,0.5303,0.4,0.1343,74,159,233,294,233,233
10358,2012-03-12,Spring,2012,Mar,16,0,Monday,1,Clear,0.62,0.6212,0.35,0.4478,77,255,332,294,332,332
10359,2012-03-12,Spring,2012,Mar,17,0,Monday,1,Misty,0.62,0.6212,0.38,0.4179,87,557,644,294,644,644
10360,2012-03-12,Spring,2012,Mar,18,0,Monday,1,Misty,0.6,0.6212,0.43,0.194,89,623,712,294,712,712
10361,2012-03-12,Spring,2012,Mar,19,0,Monday,1,Misty,0.56,0.5303,0.49,0.2239,67,379,446,294,446,446
10362,2012-03-12,Spring,2012,Mar,20,0,Monday,1,Misty,0.56,0.5303,0.49,0.2239,49,237,286,294,286,286
10363,2012-03-12,Spring,2012,Mar,21,0,Monday,1,Misty,0.54,0.5152,0.56,0.2239,22,183,205,294,205,205
10364,2012-03-12,Spring,2012,Mar,22,0,Monday,1,Misty,0.56,0.5303,0.56,0.2239,17,116,133,294,133,133
10365,2012-03-12,Spring,2012,Mar,23,0,Monday,1,Clear,0.56,0.5303,0.56,0.2239,10,53,63,294,63,63
10366,2012-03-13,Spring,2012,Mar,0,0,Tuesday,1,Misty,0.56,0.5303,0.52,0.194,5,21,26,293,26,26
10367,2012-03-13,Spring,2012,Mar,1,0,Tuesday,1,Misty,0.52,0.5,0.59,0.2239,2,14,16,293,16,16
10368,2012-03-13,Spring,2012,Mar,2,0,Tuesday,1,Light_rainsnow,0.52,0.5,0.72,0.2985,0,1,1,293,1,1
10369,2012-03-13,Spring,2012,Mar,3,0,Tuesday,1,Light_rainsnow,0.52,0.5,0.72,0.2985,0,2,2,293,2,2
10370,2012-03-13,Spring,2012,Mar,4,0,Tuesday,1,Misty,0.46,0.4545,0.82,0.194,0,1,1,293,1,1
10371,2012-03-13,Spring,2012,Mar,5,0,Tuesday,1,Misty,0.46,0.4545,0.82,0.194,0,24,24,293,24,24
10372,2012-03-13,Spring,2012,Mar,6,0,Tuesday,1,Light_rainsnow,0.46,0.4545,0.82,0.194,5,108,113,293,113,113
10373,2012-03-13,Spring,2012,Mar,7,0,Tuesday,1,Misty,0.46,0.4545,0.82,0.2836,16,292,308,293,308,308
10374,2012-03-13,Spring,2012,Mar,8,0,Tuesday,1,Clear,0.46,0.4545,0.82,0.2836,22,571,593,293,593,593
10375,2012-03-13,Spring,2012,Mar,9,0,Tuesday,1,Clear,0.48,0.4697,0.82,0.2836,18,324,342,293,342,342
10376,2012-03-13,Spring,2012,Mar,10,0,Tuesday,1,Clear,0.52,0.5,0.77,0.2239,28,115,143,293,143,143
10377,2012-03-13,Spring,2012,Mar,11,0,Tuesday,1,Clear,0.54,0.5152,0.73,0.2836,64,155,219,293,219,219
10378,2012-03-13,Spring,2012,Mar,12,0,Tuesday,1,Clear,0.6,0.6061,0.6,0.2836,47,197,244,293,244,244
10379,2012-03-13,Spring,2012,Mar,13,0,Tuesday,1,Clear,0.6,0.6061,0.6,0.3881,53,180,233,293,233,233
10380,2012-03-13,Spring,2012,Mar,14,0,Tuesday,1,Clear,0.64,0.6212,0.53,0.3284,52,160,212,293,212,212
10381,2012-03-13,Spring,2012,Mar,15,0,Tuesday,1,Clear,0.7,0.6364,0.39,0.2239,68,196,264,293,264,264
10382,2012-03-13,Spring,2012,Mar,16,0,Tuesday,1,Clear,0.72,0.6515,0.34,0.3881,53,312,365,293,365,365
10383,2012-03-13,Spring,2012,Mar,17,0,Tuesday,1,Clear,0.7,0.6364,0.37,0.1045,62,614,676,293,676,676
10384,2012-03-13,Spring,2012,Mar,18,0,Tuesday,1,Clear,0.7,0.6364,0.34,0.2985,96,638,734,293,734,734
10385,2012-03-13,Spring,2012,Mar,19,0,Tuesday,1,Clear,0.64,0.6212,0.47,0.2239,50,429,479,293,479,479
10386,2012-03-13,Spring,2012,Mar,20,0,Tuesday,1,Clear,0.6,0.6212,0.49,0.1642,45,306,351,293,351,351
10387,2012-03-13,Spring,2012,Mar,21,0,Tuesday,1,Clear,0.58,0.5455,0.56,0.1045,44,200,244,293,244,244
10388,2012-03-13,Spring,2012,Mar,22,0,Tuesday,1,Clear,0.56,0.5303,0.6,0.0896,24,146,170,293,170,170
10389,2012-03-13,Spring,2012,Mar,23,0,Tuesday,1,Clear,0.56,0.5303,0.56,0.1343,8,79,87,293,87,87
10390,2012-03-14,Spring,2012,Mar,0,0,Wednesday,1,Clear,0.54,0.5152,0.6,0.1045,5,34,39,292,39,39
10391,2012-03-14,Spring,2012,Mar,1,0,Wednesday,1,Clear,0.52,0.5,0.63,0.0896,2,25,27,292,27,27
10392,2012-03-14,Spring,2012,Mar,2,0,Wednesday,1,Clear,0.5,0.4848,0.68,0.194,0,2,2,292,2,2
10393,2012-03-14,Spring,2012,Mar,3,0,Wednesday,1,Clear,0.48,0.4697,0.72,0.194,1,3,4,292,4,4
10394,2012-03-14,Spring,2012,Mar,4,0,Wednesday,1,Clear,0.48,0.4697,0.67,0.0896,1,4,5,292,5,5
10395,2012-03-14,Spring,2012,Mar,5,0,Wednesday,1,Clear,0.44,0.4394,0.82,0.1343,2,25,27,292,27,27
10396,2012-03-14,Spring,2012,Mar,6,0,Wednesday,1,Clear,0.44,0.4394,0.82,0.0896,1,120,121,292,121,121
10397,2012-03-14,Spring,2012,Mar,7,0,Wednesday,1,Clear,0.44,0.4394,0.82,0.1045,20,348,368,292,368,368
10398,2012-03-14,Spring,2012,Mar,8,0,Wednesday,1,Clear,0.44,0.4394,0.82,0.0,34,628,662,292,662,662
10399,2012-03-14,Spring,2012,Mar,9,0,Wednesday,1,Clear,0.52,0.5,0.68,0.0,26,325,351,292,351,351
10400,2012-03-14,Spring,2012,Mar,10,0,Wednesday,1,Clear,0.56,0.5303,0.56,0.1045,38,150,188,292,188,188
10401,2012-03-14,Spring,2012,Mar,11,0,Wednesday,1,Misty,0.62,0.6212,0.41,0.1642,65,155,220,292,220,220
10402,2012-03-14,Spring,2012,Mar,12,0,Wednesday,1,Misty,0.64,0.6212,0.29,0.0,55,212,267,292,267,267
10403,2012-03-14,Spring,2012,Mar,13,0,Wednesday,1,Clear,0.66,0.6212,0.27,0.2239,57,197,254,292,254,254
10404,2012-03-14,Spring,2012,Mar,14,0,Wednesday,1,Clear,0.7,0.6364,0.23,0.3284,61,163,224,292,224,224
10405,2012-03-14,Spring,2012,Mar,15,0,Wednesday,1,Clear,0.7,0.6364,0.24,0.0,86,197,283,292,283,283
10406,2012-03-14,Spring,2012,Mar,16,0,Wednesday,1,Clear,0.72,0.6364,0.25,0.194,78,278,356,292,356,356
10407,2012-03-14,Spring,2012,Mar,17,0,Wednesday,1,Clear,0.7,0.6364,0.28,0.0896,140,642,782,292,782,782
10408,2012-03-14,Spring,2012,Mar,18,0,Wednesday,1,Clear,0.7,0.6364,0.32,0.0,102,647,749,292,749,749
10409,2012-03-14,Spring,2012,Mar,19,0,Wednesday,1,Clear,0.64,0.6212,0.33,0.1642,70,402,472,292,472,472
10410,2012-03-14,Spring,2012,Mar,20,0,Wednesday,1,Clear,0.62,0.6212,0.35,0.1045,44,286,330,292,330,330
10411,2012-03-14,Spring,2012,Mar,21,0,Wednesday,1,Clear,0.6,0.6212,0.4,0.0896,47,241,288,292,288,288
10412,2012-03-14,Spring,2012,Mar,22,0,Wednesday,1,Clear,0.52,0.5,0.55,0.1343,43,159,202,292,202,202
10413,2012-03-14,Spring,2012,Mar,23,0,Wednesday,1,Clear,0.56,0.5303,0.43,0.1642,19,72,91,292,91,91
10414,2012-03-15,Spring,2012,Mar,0,0,Thursday,1,Clear,0.54,0.5152,0.49,0.1343,14,46,60,291,60,60
10415,2012-03-15,Spring,2012,Mar,1,0,Thursday,1,Clear,0.5,0.4848,0.59,0.1045,15,8,23,291,23,23
10416,2012-03-15,Spring,2012,Mar,2,0,Thursday,1,Clear,0.5,0.4848,0.59,0.0,14,5,19,291,19,19
10417,2012-03-15,Spring,2012,Mar,3,0,Thursday,1,Clear,0.5,0.4848,0.63,0.0,0,7,7,291,7,7
10418,2012-03-15,Spring,2012,Mar,4,0,Thursday,1,Clear,0.44,0.4394,0.77,0.1045,11,3,14,291,14,14
10419,2012-03-15,Spring,2012,Mar,5,0,Thursday,1,Clear,0.46,0.4545,0.67,0.0,2,24,26,291,26,26
10420,2012-03-15,Spring,2012,Mar,6,0,Thursday,1,Clear,0.44,0.4394,0.72,0.0896,4,113,117,291,117,117
10421,2012-03-15,Spring,2012,Mar,7,0,Thursday,1,Clear,0.44,0.4394,0.72,0.0896,14,367,381,291,381,381
10422,2012-03-15,Spring,2012,Mar,8,0,Thursday,1,Clear,0.44,0.4394,0.77,0.1045,21,602,623,291,623,623
10423,2012-03-15,Spring,2012,Mar,9,0,Thursday,1,Clear,0.48,0.4697,0.77,0.0896,30,285,315,291,315,315
10424,2012-03-15,Spring,2012,Mar,10,0,Thursday,1,Clear,0.52,0.5,0.68,0.1045,34,130,164,291,164,164
10425,2012-03-15,Spring,2012,Mar,11,0,Thursday,1,Clear,0.56,0.5303,0.6,0.1343,60,151,211,291,211,211
10426,2012-03-15,Spring,2012,Mar,12,0,Thursday,1,Misty,0.62,0.6212,0.5,0.1343,59,206,265,291,265,265
10427,2012-03-15,Spring,2012,Mar,13,0,Thursday,1,Misty,0.66,0.6212,0.41,0.0896,62,211,273,291,273,273
10428,2012-03-15,Spring,2012,Mar,14,0,Thursday,1,Misty,0.72,0.6515,0.3,0.1045,81,177,258,291,258,258
10429,2012-03-15,Spring,2012,Mar,15,0,Thursday,1,Clear,0.72,0.6515,0.32,0.2239,100,187,287,291,287,287
10430,2012-03-15,Spring,2012,Mar,16,0,Thursday,1,Clear,0.72,0.6515,0.37,0.3881,95,331,426,291,426,426
10431,2012-03-15,Spring,2012,Mar,17,0,Thursday,1,Clear,0.7,0.6364,0.39,0.2537,79,634,713,291,713,713
10432,2012-03-15,Spring,2012,Mar,18,0,Thursday,1,Clear,0.66,0.6212,0.44,0.2836,98,648,746,291,746,746
10433,2012-03-15,Spring,2012,Mar,19,0,Thursday,1,Misty,0.64,0.6212,0.5,0.194,72,353,425,291,425,425
10434,2012-03-15,Spring,2012,Mar,20,0,Thursday,1,Misty,0.58,0.5455,0.6,0.3582,60,270,330,291,330,330
10435,2012-03-15,Spring,2012,Mar,21,0,Thursday,1,Clear,0.54,0.5152,0.68,0.2836,36,207,243,291,243,243
10436,2012-03-15,Spring,2012,Mar,22,0,Thursday,1,Clear,0.52,0.5,0.68,0.1343,32,137,169,291,169,169
10437,2012-03-15,Spring,2012,Mar,23,0,Thursday,1,Clear,0.48,0.4697,0.72,0.194,12,85,97,291,97,97
10438,2012-03-16,Spring,2012,Mar,0,0,Friday,1,Clear,0.44,0.4394,0.77,0.2537,8,49,57,290,57,57
10439,2012-03-16,Spring,2012,Mar,1,0,Friday,1,Misty,0.42,0.4242,0.82,0.3284,4,22,26,290,26,26
10440,2012-03-16,Spring,2012,Mar,2,0,Friday,1,Misty,0.42,0.4242,0.82,0.194,0,4,4,290,4,4
10441,2012-03-16,Spring,2012,Mar,3,0,Friday,1,Misty,0.4,0.4091,0.87,0.2836,0,3,3,290,3,3
10442,2012-03-16,Spring,2012,Mar,4,0,Friday,1,Misty,0.4,0.4091,0.87,0.2537,0,3,3,290,3,3
10443,2012-03-16,Spring,2012,Mar,5,0,Friday,1,Misty,0.4,0.4091,0.87,0.2239,2,30,32,290,32,32
10444,2012-03-16,Spring,2012,Mar,6,0,Friday,1,Misty,0.4,0.4091,0.87,0.1642,3,96,99,290,99,99
10445,2012-03-16,Spring,2012,Mar,7,0,Friday,1,Misty,0.4,0.4091,0.87,0.194,13,265,278,290,278,278
10446,2012-03-16,Spring,2012,Mar,8,0,Friday,1,Misty,0.4,0.4091,0.87,0.2239,28,534,562,290,562,562
10447,2012-03-16,Spring,2012,Mar,9,0,Friday,1,Misty,0.42,0.4242,0.82,0.0,35,277,312,290,312,312
10448,2012-03-16,Spring,2012,Mar,10,0,Friday,1,Misty,0.4,0.4091,0.87,0.0896,44,136,180,290,180,180
10449,2012-03-16,Spring,2012,Mar,11,0,Friday,1,Misty,0.44,0.4394,0.77,0.0,40,167,207,290,207,207
10450,2012-03-16,Spring,2012,Mar,12,0,Friday,1,Misty,0.44,0.4394,0.82,0.1343,72,222,294,290,294,294
10451,2012-03-16,Spring,2012,Mar,13,0,Friday,1,Misty,0.46,0.4545,0.77,0.0896,52,208,260,290,260,260
10452,2012-03-16,Spring,2012,Mar,14,0,Friday,1,Misty,0.48,0.4697,0.72,0.0,56,146,202,290,202,202
10453,2012-03-16,Spring,2012,Mar,15,0,Friday,1,Light_rainsnow,0.46,0.4545,0.82,0.1045,19,88,107,290,107,107
10454,2012-03-16,Spring,2012,Mar,16,0,Friday,1,Light_rainsnow,0.48,0.4697,0.77,0.0,18,111,129,290,129,129
10455,2012-03-16,Spring,2012,Mar,17,0,Friday,1,Light_rainsnow,0.48,0.4697,0.82,0.0896,23,235,258,290,258,258
10456,2012-03-16,Spring,2012,Mar,18,0,Friday,1,Light_rainsnow,0.48,0.4697,0.82,0.0896,31,377,408,290,408,408
10457,2012-03-16,Spring,2012,Mar,19,0,Friday,1,Misty,0.46,0.4545,0.88,0.0,23,273,296,290,296,296
10458,2012-03-16,Spring,2012,Mar,20,0,Friday,1,Clear,0.46,0.4545,0.88,0.0,31,204,235,290,235,235
10459,2012-03-16,Spring,2012,Mar,21,0,Friday,1,Misty,0.44,0.4394,0.94,0.0,8,144,152,290,152,152
10460,2012-03-16,Spring,2012,Mar,22,0,Friday,1,Misty,0.44,0.4394,0.94,0.0,16,132,148,290,148,148
10461,2012-03-16,Spring,2012,Mar,23,0,Friday,1,Misty,0.44,0.4394,0.94,0.0,22,104,126,290,126,126
10462,2012-03-17,Spring,2012,Mar,0,0,Saturday,0,Misty,0.44,0.4394,0.94,0.0896,13,87,100,289,100,100
10463,2012-03-17,Spring,2012,Mar,1,0,Saturday,0,Misty,0.44,0.4394,0.94,0.0,12,57,69,289,69,69
10464,2012-03-17,Spring,2012,Mar,2,0,Saturday,0,Misty,0.44,0.4394,0.88,0.0,10,32,42,289,42,42
10465,2012-03-17,Spring,2012,Mar,3,0,Saturday,0,Misty,0.44,0.4394,0.88,0.0,2,24,26,289,26,26
10466,2012-03-17,Spring,2012,Mar,4,0,Saturday,0,Misty,0.42,0.4242,0.94,0.0,0,2,2,289,2,2
10467,2012-03-17,Spring,2012,Mar,5,0,Saturday,0,Misty,0.42,0.4242,0.94,0.0896,5,3,8,289,8,8
10468,2012-03-17,Spring,2012,Mar,6,0,Saturday,0,Misty,0.42,0.4242,0.94,0.194,1,29,30,289,30,30
10469,2012-03-17,Spring,2012,Mar,7,0,Saturday,0,Misty,0.4,0.4091,1.0,0.1343,29,57,86,289,86,86
10470,2012-03-17,Spring,2012,Mar,8,0,Saturday,0,Misty,0.42,0.4242,0.94,0.1045,63,155,218,289,218,218
10471,2012-03-17,Spring,2012,Mar,9,0,Saturday,0,Misty,0.44,0.4394,0.88,0.0896,104,217,321,289,321,321
10472,2012-03-17,Spring,2012,Mar,10,0,Saturday,0,Misty,0.5,0.4848,0.77,0.0896,140,303,443,289,443,443
10473,2012-03-17,Spring,2012,Mar,11,0,Saturday,0,Misty,0.52,0.5,0.77,0.1343,226,359,585,289,585,585
10474,2012-03-17,Spring,2012,Mar,12,0,Saturday,0,Clear,0.56,0.5303,0.68,0.1642,286,365,651,289,651,651
10475,2012-03-17,Spring,2012,Mar,13,0,Saturday,0,Clear,0.6,0.6061,0.6,0.1045,286,400,686,289,686,686
10476,2012-03-17,Spring,2012,Mar,14,0,Saturday,0,Clear,0.62,0.6212,0.53,0.0896,352,338,690,289,690,690
10477,2012-03-17,Spring,2012,Mar,15,0,Saturday,0,Clear,0.64,0.6212,0.53,0.1343,357,322,679,289,679,679
10478,2012-03-17,Spring,2012,Mar,16,0,Saturday,0,Clear,0.64,0.6212,0.5,0.0,367,318,685,289,685,685
10479,2012-03-17,Spring,2012,Mar,17,0,Saturday,0,Clear,0.64,0.6212,0.5,0.1343,291,357,648,289,648,648
10480,2012-03-17,Spring,2012,Mar,18,0,Saturday,0,Clear,0.62,0.6212,0.57,0.2985,221,339,560,289,560,560
10481,2012-03-17,Spring,2012,Mar,19,0,Saturday,0,Clear,0.58,0.5455,0.64,0.2836,155,262,417,289,417,417
10482,2012-03-17,Spring,2012,Mar,20,0,Saturday,0,Clear,0.56,0.5303,0.64,0.194,89,182,271,289,271,271
10483,2012-03-17,Spring,2012,Mar,21,0,Saturday,0,Clear,0.54,0.5152,0.68,0.1642,54,169,223,289,223,223
10484,2012-03-17,Spring,2012,Mar,22,0,Saturday,0,Clear,0.54,0.5152,0.68,0.0,58,153,211,289,211,211
10485,2012-03-17,Spring,2012,Mar,23,0,Saturday,0,Clear,0.5,0.4848,0.77,0.1642,34,151,185,289,185,185
10486,2012-03-18,Spring,2012,Mar,0,0,Sunday,0,Clear,0.46,0.4545,0.88,0.194,27,80,107,288,107,107
10487,2012-03-18,Spring,2012,Mar,1,0,Sunday,0,Clear,0.46,0.4545,0.82,0.1343,25,88,113,288,113,113
10488,2012-03-18,Spring,2012,Mar,2,0,Sunday,0,Misty,0.46,0.4545,0.82,0.1045,15,41,56,288,56,56
10489,2012-03-18,Spring,2012,Mar,3,0,Sunday,0,Misty,0.44,0.4394,0.88,0.1343,3,15,18,288,18,18
10490,2012-03-18,Spring,2012,Mar,4,0,Sunday,0,Misty,0.42,0.4242,0.94,0.1642,6,8,14,288,14,14
10491,2012-03-18,Spring,2012,Mar,5,0,Sunday,0,Misty,0.4,0.4091,0.94,0.1045,0,6,6,288,6,6
10492,2012-03-18,Spring,2012,Mar,6,0,Sunday,0,Misty,0.4,0.4091,0.94,0.1045,2,9,11,288,11,11
10493,2012-03-18,Spring,2012,Mar,7,0,Sunday,0,Light_rainsnow,0.42,0.4242,0.88,0.1642,17,25,42,288,42,42
10494,2012-03-18,Spring,2012,Mar,8,0,Sunday,0,Misty,0.42,0.4242,0.88,0.1045,25,71,96,288,96,96
10495,2012-03-18,Spring,2012,Mar,9,0,Sunday,0,Misty,0.42,0.4242,0.88,0.0896,65,113,178,288,178,178
10496,2012-03-18,Spring,2012,Mar,10,0,Sunday,0,Misty,0.42,0.4242,0.88,0.1045,139,212,351,288,351,351
10497,2012-03-18,Spring,2012,Mar,11,0,Sunday,0,Misty,0.44,0.4394,0.82,0.1642,129,239,368,288,368,368
10498,2012-03-18,Spring,2012,Mar,12,0,Sunday,0,Misty,0.44,0.4394,0.88,0.1343,222,281,503,288,503,503
10499,2012-03-18,Spring,2012,Mar,13,0,Sunday,0,Misty,0.46,0.4545,0.82,0.1642,198,346,544,288,544,544
10500,2012-03-18,Spring,2012,Mar,14,0,Sunday,0,Misty,0.5,0.4848,0.77,0.0896,218,303,521,288,521,521
10501,2012-03-18,Spring,2012,Mar,15,0,Sunday,0,Clear,0.54,0.5152,0.68,0.0896,240,314,554,288,554,554
10502,2012-03-18,Spring,2012,Mar,16,0,Sunday,0,Clear,0.54,0.5152,0.73,0.0896,229,312,541,288,541,541
10503,2012-03-18,Spring,2012,Mar,17,0,Sunday,0,Clear,0.56,0.5303,0.64,0.0896,233,308,541,288,541,541
10504,2012-03-18,Spring,2012,Mar,18,0,Sunday,0,Clear,0.56,0.5303,0.64,0.1642,165,294,459,288,459,459
10505,2012-03-18,Spring,2012,Mar,19,0,Sunday,0,Clear,0.56,0.5303,0.64,0.1642,118,234,352,288,352,352
10506,2012-03-18,Spring,2012,Mar,20,0,Sunday,0,Clear,0.52,0.5,0.77,0.1343,59,139,198,288,198,198
10507,2012-03-18,Spring,2012,Mar,21,0,Sunday,0,Clear,0.52,0.5,0.72,0.0896,44,129,173,288,173,173
10508,2012-03-18,Spring,2012,Mar,22,0,Sunday,0,Clear,0.5,0.4848,0.77,0.1045,21,79,100,288,100,100
10509,2012-03-18,Spring,2012,Mar,23,0,Sunday,0,Clear,0.48,0.4697,0.82,0.1642,7,39,46,288,46,46
10510,2012-03-19,Spring,2012,Mar,0,0,Monday,1,Clear,0.48,0.4697,0.82,0.1045,4,19,23,287,23,23
10511,2012-03-19,Spring,2012,Mar,1,0,Monday,1,Clear,0.46,0.4545,0.88,0.1045,0,15,15,287,15,15
10512,2012-03-19,Spring,2012,Mar,2,0,Monday,1,Clear,0.46,0.4545,0.88,0.1642,1,7,8,287,8,8
10513,2012-03-19,Spring,2012,Mar,3,0,Monday,1,Clear,0.46,0.4545,0.88,0.0896,0,2,2,287,2,2
10514,2012-03-19,Spring,2012,Mar,4,0,Monday,1,Clear,0.44,0.4394,0.94,0.0,0,3,3,287,3,3
10515,2012-03-19,Spring,2012,Mar,5,0,Monday,1,Clear,0.44,0.4394,0.94,0.0,0,31,31,287,31,31
10516,2012-03-19,Spring,2012,Mar,6,0,Monday,1,Clear,0.46,0.4545,0.88,0.1343,2,118,120,287,120,120
10517,2012-03-19,Spring,2012,Mar,7,0,Monday,1,Clear,0.46,0.4545,0.88,0.194,25,329,354,287,354,354
10518,2012-03-19,Spring,2012,Mar,8,0,Monday,1,Clear,0.46,0.4545,0.88,0.1045,16,563,579,287,579,579
10519,2012-03-19,Spring,2012,Mar,9,0,Monday,1,Clear,0.5,0.4848,0.72,0.1642,55,276,331,287,331,331
10520,2012-03-19,Spring,2012,Mar,10,0,Monday,1,Clear,0.52,0.5,0.72,0.1343,56,128,184,287,184,184
10521,2012-03-19,Spring,2012,Mar,11,0,Monday,1,Clear,0.56,0.5303,0.68,0.1642,56,145,201,287,201,201
10522,2012-03-19,Spring,2012,Mar,12,0,Monday,1,Clear,0.6,0.6061,0.64,0.2537,71,211,282,287,282,282
10523,2012-03-19,Spring,2012,Mar,13,0,Monday,1,Clear,0.62,0.6061,0.61,0.2537,69,194,263,287,263,263
10524,2012-03-19,Spring,2012,Mar,14,0,Monday,1,Misty,0.64,0.6212,0.57,0.194,60,200,260,287,260,260
10525,2012-03-19,Spring,2012,Mar,15,0,Monday,1,Clear,0.64,0.6212,0.57,0.2239,97,189,286,287,286,286
10526,2012-03-19,Spring,2012,Mar,16,0,Monday,1,Clear,0.66,0.6212,0.5,0.2239,65,320,385,287,385,385
10527,2012-03-19,Spring,2012,Mar,17,0,Monday,1,Clear,0.64,0.6212,0.53,0.2239,106,615,721,287,721,721
10528,2012-03-19,Spring,2012,Mar,18,0,Monday,1,Clear,0.64,0.6212,0.57,0.2537,120,681,801,287,801,801
10529,2012-03-19,Spring,2012,Mar,19,0,Monday,1,Clear,0.62,0.6061,0.61,0.2239,86,463,549,287,549,549
10530,2012-03-19,Spring,2012,Mar,20,0,Monday,1,Clear,0.6,0.6061,0.64,0.2239,34,296,330,287,330,330
10531,2012-03-19,Spring,2012,Mar,21,0,Monday,1,Clear,0.6,0.6061,0.64,0.1642,33,190,223,287,223,223
10532,2012-03-19,Spring,2012,Mar,22,0,Monday,1,Misty,0.56,0.5303,0.73,0.1642,17,131,148,287,148,148
10533,2012-03-19,Spring,2012,Mar,23,0,Monday,1,Misty,0.56,0.5303,0.78,0.1343,9,45,54,287,54,54
10534,2012-03-20,Spring,2012,Mar,0,0,Tuesday,1,Misty,0.56,0.5303,0.78,0.0896,5,24,29,286,29,29
10535,2012-03-20,Spring,2012,Mar,1,0,Tuesday,1,Clear,0.54,0.5152,0.88,0.0,6,9,15,286,15,15
10536,2012-03-20,Spring,2012,Mar,2,0,Tuesday,1,Clear,0.54,0.5152,0.88,0.0896,2,8,10,286,10,10
10537,2012-03-20,Spring,2012,Mar,3,0,Tuesday,1,Misty,0.54,0.5152,0.88,0.0,0,3,3,286,3,3
10538,2012-03-20,Spring,2012,Mar,4,0,Tuesday,1,Misty,0.52,0.5,0.88,0.1343,0,6,6,286,6,6
10539,2012-03-20,Spring,2012,Mar,5,0,Tuesday,1,Misty,0.52,0.5,0.94,0.0,0,20,20,286,20,20
10540,2012-03-20,Spring,2012,Mar,6,0,Tuesday,1,Misty,0.52,0.5,0.94,0.1642,6,94,100,286,100,100
10541,2012-03-20,Spring,2012,Mar,7,0,Tuesday,1,Light_rainsnow,0.52,0.5,0.94,0.2239,3,167,170,286,170,170
10542,2012-03-20,Spring,2012,Mar,8,0,Tuesday,1,Misty,0.52,0.5,0.88,0.1045,28,488,516,286,516,516
10543,2012-03-20,Spring,2012,Mar,9,0,Tuesday,1,Misty,0.54,0.5152,0.88,0.1642,41,284,325,286,325,325
10544,2012-03-20,Spring,2012,Mar,10,0,Tuesday,1,Clear,0.54,0.5152,0.88,0.194,44,119,163,286,163,163
10545,2012-03-20,Spring,2012,Mar,11,0,Tuesday,1,Clear,0.58,0.5455,0.83,0.1343,74,156,230,286,230,230
10546,2012-03-20,Spring,2012,Mar,12,0,Tuesday,1,Clear,0.6,0.5758,0.78,0.2537,56,205,261,286,261,261
10547,2012-03-20,Spring,2012,Mar,13,0,Tuesday,1,Clear,0.6,0.5758,0.78,0.194,77,207,284,286,284,284
10548,2012-03-20,Spring,2012,Mar,14,0,Tuesday,1,Misty,0.6,0.5909,0.73,0.1642,66,182,248,286,248,248
10549,2012-03-20,Spring,2012,Mar,15,0,Tuesday,1,Misty,0.62,0.6061,0.69,0.1045,67,177,244,286,244,244
10550,2012-03-20,Spring,2012,Mar,16,0,Tuesday,1,Clear,0.62,0.6061,0.66,0.2239,99,332,431,286,431,431
10551,2012-03-20,Spring,2012,Mar,17,0,Tuesday,1,Clear,0.6,0.5909,0.73,0.194,108,642,750,286,750,750
10552,2012-03-20,Spring,2012,Mar,18,0,Tuesday,1,Clear,0.6,0.5909,0.69,0.2537,136,665,801,286,801,801
10553,2012-03-20,Spring,2012,Mar,19,0,Tuesday,1,Clear,0.58,0.5455,0.73,0.1343,75,480,555,286,555,555
10554,2012-03-20,Spring,2012,Mar,20,0,Tuesday,1,Clear,0.58,0.5455,0.68,0.0896,78,299,377,286,377,377
10555,2012-03-20,Spring,2012,Mar,21,0,Tuesday,1,Clear,0.56,0.5303,0.73,0.0,38,239,277,286,277,277
10556,2012-03-20,Spring,2012,Mar,22,0,Tuesday,1,Clear,0.54,0.5152,0.77,0.0,32,156,188,286,188,188
10557,2012-03-20,Spring,2012,Mar,23,0,Tuesday,1,Clear,0.52,0.5,0.83,0.0,10,80,90,286,90,90
10558,2012-03-21,Summer,2012,Mar,0,0,Wednesday,1,Clear,0.52,0.5,0.88,0.0,4,29,33,285,33,33
10559,2012-03-21,Summer,2012,Mar,1,0,Wednesday,1,Clear,0.52,0.5,0.83,0.0896,4,22,26,285,26,26
10560,2012-03-21,Summer,2012,Mar,2,0,Wednesday,1,Clear,0.5,0.4848,0.88,0.1343,2,8,10,285,10,10
10561,2012-03-21,Summer,2012,Mar,3,0,Wednesday,1,Misty,0.5,0.4848,0.88,0.194,1,7,8,285,8,8
10562,2012-03-21,Summer,2012,Mar,4,0,Wednesday,1,Misty,0.5,0.4848,0.88,0.1343,0,4,4,285,4,4
10563,2012-03-21,Summer,2012,Mar,5,0,Wednesday,1,Misty,0.5,0.4848,0.88,0.1343,4,35,39,285,39,39
10564,2012-03-21,Summer,2012,Mar,6,0,Wednesday,1,Misty,0.48,0.4697,0.94,0.2239,10,139,149,285,149,149
10565,2012-03-21,Summer,2012,Mar,7,0,Wednesday,1,Light_rainsnow,0.48,0.4697,0.94,0.194,34,338,372,285,372,372
10566,2012-03-21,Summer,2012,Mar,8,0,Wednesday,1,Light_rainsnow,0.48,0.4697,0.94,0.1045,33,502,535,285,535,535
10567,2012-03-21,Summer,2012,Mar,9,0,Wednesday,1,Misty,0.5,0.4848,0.88,0.1642,38,255,293,285,293,293
10568,2012-03-21,Summer,2012,Mar,10,0,Wednesday,1,Misty,0.52,0.5,0.83,0.1642,30,124,154,285,154,154
10569,2012-03-21,Summer,2012,Mar,11,0,Wednesday,1,Misty,0.52,0.5,0.83,0.1642,38,154,192,285,192,192
10570,2012-03-21,Summer,2012,Mar,12,0,Wednesday,1,Misty,0.54,0.5152,0.77,0.0,58,171,229,285,229,229
10571,2012-03-21,Summer,2012,Mar,13,0,Wednesday,1,Misty,0.54,0.5152,0.83,0.0,81,222,303,285,303,303
10572,2012-03-21,Summer,2012,Mar,14,0,Wednesday,1,Misty,0.56,0.5303,0.78,0.0,74,151,225,285,225,225
10573,2012-03-21,Summer,2012,Mar,15,0,Wednesday,1,Misty,0.56,0.5303,0.78,0.0,68,175,243,285,243,243
10574,2012-03-21,Summer,2012,Mar,16,0,Wednesday,1,Clear,0.58,0.5455,0.73,0.0,91,287,378,285,378,378
10575,2012-03-21,Summer,2012,Mar,17,0,Wednesday,1,Clear,0.6,0.5909,0.69,0.0896,113,616,729,285,729,729
10576,2012-03-21,Summer,2012,Mar,18,0,Wednesday,1,Clear,0.6,0.5909,0.69,0.0,152,627,779,285,779,779
10577,2012-03-21,Summer,2012,Mar,19,0,Wednesday,1,Clear,0.6,0.6061,0.64,0.0,86,496,582,285,582,582
10578,2012-03-21,Summer,2012,Mar,20,0,Wednesday,1,Clear,0.56,0.5303,0.78,0.0896,76,298,374,285,374,374
10579,2012-03-21,Summer,2012,Mar,21,0,Wednesday,1,Clear,0.54,0.5152,0.83,0.1045,47,204,251,285,251,251
10580,2012-03-21,Summer,2012,Mar,22,0,Wednesday,1,Clear,0.52,0.5,0.83,0.1642,41,156,197,285,197,197
10581,2012-03-21,Summer,2012,Mar,23,0,Wednesday,1,Clear,0.54,0.5152,0.77,0.0,37,88,125,285,125,125
10582,2012-03-22,Summer,2012,Mar,0,0,Thursday,1,Clear,0.52,0.5,0.83,0.0896,9,32,41,284,41,41
10583,2012-03-22,Summer,2012,Mar,1,0,Thursday,1,Clear,0.52,0.5,0.83,0.0896,14,16,30,284,30,30
10584,2012-03-22,Summer,2012,Mar,2,0,Thursday,1,Clear,0.52,0.5,0.83,0.0896,1,5,6,284,6,6
10585,2012-03-22,Summer,2012,Mar,3,0,Thursday,1,Clear,0.52,0.5,0.83,0.0896,0,7,7,284,7,7
10586,2012-03-22,Summer,2012,Mar,4,0,Thursday,1,Misty,0.48,0.4697,1.0,0.0896,0,6,6,284,6,6
10587,2012-03-22,Summer,2012,Mar,5,0,Thursday,1,Misty,0.48,0.4697,1.0,0.0896,2,32,34,284,34,34
10588,2012-03-22,Summer,2012,Mar,6,0,Thursday,1,Misty,0.48,0.4697,1.0,0.0896,10,126,136,284,136,136
10589,2012-03-22,Summer,2012,Mar,7,0,Thursday,1,Misty,0.48,0.4697,1.0,0.0896,29,332,361,284,361,361
10590,2012-03-22,Summer,2012,Mar,8,0,Thursday,1,Misty,0.5,0.4848,0.94,0.0896,51,598,649,284,649,649
10591,2012-03-22,Summer,2012,Mar,9,0,Thursday,1,Misty,0.5,0.4848,0.94,0.0896,41,277,318,284,318,318
10592,2012-03-22,Summer,2012,Mar,10,0,Thursday,1,Misty,0.5,0.4848,1.0,0.0896,32,110,142,284,142,142
10593,2012-03-22,Summer,2012,Mar,11,0,Thursday,1,Misty,0.52,0.5,0.94,0.0,53,166,219,284,219,219
10594,2012-03-22,Summer,2012,Mar,12,0,Thursday,1,Misty,0.54,0.5152,0.88,0.194,48,224,272,284,272,272
10595,2012-03-22,Summer,2012,Mar,13,0,Thursday,1,Clear,0.58,0.5455,0.78,0.0896,83,215,298,284,298,298
10596,2012-03-22,Summer,2012,Mar,14,0,Thursday,1,Clear,0.6,0.5909,0.73,0.1045,96,161,257,284,257,257
10597,2012-03-22,Summer,2012,Mar,15,0,Thursday,1,Clear,0.62,0.6061,0.69,0.194,102,202,304,284,304,304
10598,2012-03-22,Summer,2012,Mar,16,0,Thursday,1,Clear,0.64,0.6061,0.65,0.194,125,300,425,284,425,425
10599,2012-03-22,Summer,2012,Mar,17,0,Thursday,1,Clear,0.66,0.6212,0.65,0.1642,154,656,810,284,810,810
10600,2012-03-22,Summer,2012,Mar,18,0,Thursday,1,Clear,0.66,0.6212,0.65,0.1642,147,654,801,284,801,801
10601,2012-03-22,Summer,2012,Mar,19,0,Thursday,1,Clear,0.66,0.6212,0.61,0.0,117,469,586,284,586,586
10602,2012-03-22,Summer,2012,Mar,20,0,Thursday,1,Clear,0.62,0.5909,0.73,0.2836,64,360,424,284,424,424
10603,2012-03-22,Summer,2012,Mar,21,0,Thursday,1,Clear,0.58,0.5455,0.78,0.1642,66,308,374,284,374,374
10604,2012-03-22,Summer,2012,Mar,22,0,Thursday,1,Clear,0.56,0.5303,0.83,0.194,56,164,220,284,220,220
10605,2012-03-22,Summer,2012,Mar,23,0,Thursday,1,Clear,0.56,0.5303,0.83,0.0896,34,117,151,284,151,151
10606,2012-03-23,Summer,2012,Mar,0,0,Friday,1,Clear,0.56,0.5303,0.83,0.0,30,65,95,283,95,95
10607,2012-03-23,Summer,2012,Mar,1,0,Friday,1,Clear,0.54,0.5152,0.88,0.0,18,32,50,283,50,50
10608,2012-03-23,Summer,2012,Mar,2,0,Friday,1,Clear,0.54,0.5152,0.88,0.0896,12,20,32,283,32,32
10609,2012-03-23,Summer,2012,Mar,3,0,Friday,1,Clear,0.52,0.5,0.88,0.1045,4,6,10,283,10,10
10610,2012-03-23,Summer,2012,Mar,4,0,Friday,1,Misty,0.5,0.4848,0.94,0.1045,0,3,3,283,3,3
10611,2012-03-23,Summer,2012,Mar,5,0,Friday,1,Misty,0.5,0.4848,0.94,0.0,5,29,34,283,34,34
10612,2012-03-23,Summer,2012,Mar,6,0,Friday,1,Misty,0.5,0.4848,0.88,0.0,6,110,116,283,116,116
10613,2012-03-23,Summer,2012,Mar,7,0,Friday,1,Misty,0.5,0.4848,0.93,0.1343,28,318,346,283,346,346
10614,2012-03-23,Summer,2012,Mar,8,0,Friday,1,Misty,0.5,0.4848,0.94,0.1343,47,615,662,283,662,662
10615,2012-03-23,Summer,2012,Mar,9,0,Friday,1,Misty,0.52,0.5,0.9,0.0896,75,305,380,283,380,380
10616,2012-03-23,Summer,2012,Mar,10,0,Friday,1,Misty,0.56,0.5303,0.88,0.1045,125,150,275,283,275,275
10617,2012-03-23,Summer,2012,Mar,11,0,Friday,1,Misty,0.62,0.5909,0.73,0.1045,131,187,318,283,318,318
10618,2012-03-23,Summer,2012,Mar,12,0,Friday,1,Misty,0.66,0.6212,0.61,0.2239,199,272,471,283,471,471
10619,2012-03-23,Summer,2012,Mar,13,0,Friday,1,Misty,0.7,0.6515,0.48,0.0,172,256,428,283,428,428
10620,2012-03-23,Summer,2012,Mar,14,0,Friday,1,Misty,0.72,0.6515,0.42,0.1045,208,224,432,283,432,432
10621,2012-03-23,Summer,2012,Mar,15,0,Friday,1,Misty,0.72,0.6515,0.42,0.1343,191,281,472,283,472,472
10622,2012-03-23,Summer,2012,Mar,16,0,Friday,1,Misty,0.72,0.6515,0.42,0.1642,219,370,589,283,589,589
10623,2012-03-23,Summer,2012,Mar,17,0,Friday,1,Misty,0.72,0.6515,0.42,0.1642,264,693,957,283,957,957
10624,2012-03-23,Summer,2012,Mar,18,0,Friday,1,Clear,0.7,0.6364,0.45,0.1642,237,593,830,283,830,830
10625,2012-03-23,Summer,2012,Mar,19,0,Friday,1,Clear,0.66,0.6212,0.5,0.194,213,473,686,283,686,686
10626,2012-03-23,Summer,2012,Mar,20,0,Friday,1,Clear,0.66,0.6212,0.47,0.1343,117,328,445,283,445,445
10627,2012-03-23,Summer,2012,Mar,21,0,Friday,1,Clear,0.62,0.6212,0.53,0.1045,64,220,284,283,284,284
10628,2012-03-23,Summer,2012,Mar,22,0,Friday,1,Clear,0.6,0.6061,0.64,0.2836,53,218,271,283,271,271
10629,2012-03-23,Summer,2012,Mar,23,0,Friday,1,Clear,0.6,0.5909,0.69,0.2537,51,125,176,283,176,176
10630,2012-03-24,Summer,2012,Mar,0,0,Saturday,0,Clear,0.58,0.5455,0.68,0.0,45,111,156,282,156,156
10631,2012-03-24,Summer,2012,Mar,1,0,Saturday,0,Clear,0.56,0.5303,0.73,0.0896,20,108,128,282,128,128
10632,2012-03-24,Summer,2012,Mar,2,0,Saturday,0,Clear,0.54,0.5152,0.77,0.1045,14,55,69,282,69,69
10633,2012-03-24,Summer,2012,Mar,3,0,Saturday,0,Clear,0.54,0.5152,0.77,0.1045,10,22,32,282,32,32
10634,2012-03-24,Summer,2012,Mar,4,0,Saturday,0,Clear,0.52,0.5,0.83,0.0896,1,6,7,282,7,7
10635,2012-03-24,Summer,2012,Mar,5,0,Saturday,0,Misty,0.52,0.5,0.83,0.1642,0,4,4,282,4,4
10636,2012-03-24,Summer,2012,Mar,6,0,Saturday,0,Misty,0.52,0.5,0.83,0.1642,4,24,28,282,28,28
10637,2012-03-24,Summer,2012,Mar,7,0,Saturday,0,Misty,0.5,0.4848,0.88,0.1343,25,45,70,282,70,70
10638,2012-03-24,Summer,2012,Mar,8,0,Saturday,0,Misty,0.5,0.4848,0.94,0.194,41,113,154,282,154,154
10639,2012-03-24,Summer,2012,Mar,9,0,Saturday,0,Misty,0.52,0.5,0.83,0.1343,96,153,249,282,249,249
10640,2012-03-24,Summer,2012,Mar,10,0,Saturday,0,Misty,0.52,0.5,0.88,0.194,148,197,345,282,345,345
10641,2012-03-24,Summer,2012,Mar,11,0,Saturday,0,Misty,0.5,0.4848,0.94,0.194,98,175,273,282,273,273
10642,2012-03-24,Summer,2012,Mar,12,0,Saturday,0,Light_rainsnow,0.52,0.5,0.94,0.2239,61,122,183,282,183,183
10643,2012-03-24,Summer,2012,Mar,13,0,Saturday,0,Light_rainsnow,0.52,0.5,0.94,0.2537,62,134,196,282,196,196
10644,2012-03-24,Summer,2012,Mar,14,0,Saturday,0,Light_rainsnow,0.52,0.5,0.88,0.3582,63,160,223,282,223,223
10645,2012-03-24,Summer,2012,Mar,15,0,Saturday,0,Light_rainsnow,0.5,0.4848,0.94,0.4179,118,172,290,282,290,290
10646,2012-03-24,Summer,2012,Mar,16,0,Saturday,0,Light_rainsnow,0.5,0.4848,0.94,0.2985,49,128,177,282,177,177
10647,2012-03-24,Summer,2012,Mar,17,0,Saturday,0,Light_rainsnow,0.5,0.4848,0.88,0.2239,47,68,115,282,115,115
10648,2012-03-24,Summer,2012,Mar,18,0,Saturday,0,Light_rainsnow,0.46,0.4545,0.94,0.2239,27,110,137,282,137,137
10649,2012-03-24,Summer,2012,Mar,19,0,Saturday,0,Light_rainsnow,0.46,0.4545,0.94,0.1343,28,105,133,282,133,133
10650,2012-03-24,Summer,2012,Mar,20,0,Saturday,0,Light_rainsnow,0.44,0.4394,1.0,0.194,31,80,111,282,111,111
10651,2012-03-24,Summer,2012,Mar,21,0,Saturday,0,Light_rainsnow,0.44,0.4394,1.0,0.194,16,88,104,282,104,104
10652,2012-03-24,Summer,2012,Mar,22,0,Saturday,0,Light_rainsnow,0.44,0.4394,1.0,0.2537,12,71,83,282,83,83
10653,2012-03-24,Summer,2012,Mar,23,0,Saturday,0,Misty,0.44,0.4394,0.94,0.2836,17,88,105,282,105,105
10654,2012-03-25,Summer,2012,Mar,0,0,Sunday,0,Misty,0.44,0.4394,0.94,0.2836,18,62,80,281,80,80
10655,2012-03-25,Summer,2012,Mar,1,0,Sunday,0,Misty,0.42,0.4242,1.0,0.2537,24,65,89,281,89,89
10656,2012-03-25,Summer,2012,Mar,2,0,Sunday,0,Light_rainsnow,0.42,0.4242,1.0,0.2985,6,29,35,281,35,35
10657,2012-03-25,Summer,2012,Mar,3,0,Sunday,0,Light_rainsnow,0.42,0.4242,0.94,0.2985,8,10,18,281,18,18
10658,2012-03-25,Summer,2012,Mar,4,0,Sunday,0,Misty,0.42,0.4242,0.94,0.3284,1,7,8,281,8,8
10659,2012-03-25,Summer,2012,Mar,5,0,Sunday,0,Misty,0.4,0.4091,1.0,0.2537,0,6,6,281,6,6
10660,2012-03-25,Summer,2012,Mar,6,0,Sunday,0,Misty,0.4,0.4091,1.0,0.2537,5,13,18,281,18,18
10661,2012-03-25,Summer,2012,Mar,7,0,Sunday,0,Misty,0.4,0.4091,0.94,0.3284,14,25,39,281,39,39
10662,2012-03-25,Summer,2012,Mar,8,0,Sunday,0,Misty,0.4,0.4091,0.94,0.3284,21,68,89,281,89,89
10663,2012-03-25,Summer,2012,Mar,9,0,Sunday,0,Misty,0.4,0.4091,0.94,0.2537,26,92,118,281,118,118
10664,2012-03-25,Summer,2012,Mar,10,0,Sunday,0,Misty,0.4,0.4091,0.87,0.3284,78,172,250,281,250,250
10665,2012-03-25,Summer,2012,Mar,11,0,Sunday,0,Misty,0.4,0.4091,0.94,0.2537,106,217,323,281,323,323
10666,2012-03-25,Summer,2012,Mar,12,0,Sunday,0,Misty,0.4,0.4091,0.94,0.2239,122,238,360,281,360,360
10667,2012-03-25,Summer,2012,Mar,13,0,Sunday,0,Misty,0.42,0.4242,0.88,0.1642,110,257,367,281,367,367
10668,2012-03-25,Summer,2012,Mar,14,0,Sunday,0,Misty,0.44,0.4394,0.88,0.1642,123,291,414,281,414,414
10669,2012-03-25,Summer,2012,Mar,15,0,Sunday,0,Misty,0.44,0.4394,0.88,0.194,139,282,421,281,421,421
10670,2012-03-25,Summer,2012,Mar,16,0,Sunday,0,Clear,0.48,0.4697,0.77,0.0,153,339,492,281,492,492
10671,2012-03-25,Summer,2012,Mar,17,0,Sunday,0,Clear,0.5,0.4848,0.72,0.0896,146,273,419,281,419,419
10672,2012-03-25,Summer,2012,Mar,18,0,Sunday,0,Clear,0.5,0.4848,0.72,0.0896,202,289,491,281,491,491
10673,2012-03-25,Summer,2012,Mar,19,0,Sunday,0,Clear,0.5,0.4848,0.72,0.2537,114,261,375,281,375,375
10674,2012-03-25,Summer,2012,Mar,20,0,Sunday,0,Clear,0.48,0.4697,0.77,0.2239,63,196,259,281,259,259
10675,2012-03-25,Summer,2012,Mar,21,0,Sunday,0,Clear,0.48,0.4697,0.77,0.1642,25,124,149,281,149,149
10676,2012-03-25,Summer,2012,Mar,22,0,Sunday,0,Clear,0.46,0.4545,0.82,0.1343,19,92,111,281,111,111
10677,2012-03-25,Summer,2012,Mar,23,0,Sunday,0,Clear,0.48,0.4697,0.82,0.1343,9,56,65,281,65,65
10678,2012-03-26,Summer,2012,Mar,0,0,Monday,1,Misty,0.48,0.4697,0.82,0.1642,10,23,33,280,33,33
10679,2012-03-26,Summer,2012,Mar,1,0,Monday,1,Clear,0.48,0.4697,0.82,0.2537,18,10,28,280,28,28
10680,2012-03-26,Summer,2012,Mar,2,0,Monday,1,Clear,0.46,0.4545,0.88,0.2239,14,6,20,280,20,20
10681,2012-03-26,Summer,2012,Mar,3,0,Monday,1,Clear,0.46,0.4545,0.82,0.194,0,1,1,280,1,1
10682,2012-03-26,Summer,2012,Mar,4,0,Monday,1,Clear,0.44,0.4394,0.82,0.1642,0,4,4,280,4,4
10683,2012-03-26,Summer,2012,Mar,5,0,Monday,1,Clear,0.44,0.4394,0.77,0.1642,0,36,36,280,36,36
10684,2012-03-26,Summer,2012,Mar,6,0,Monday,1,Clear,0.42,0.4242,0.82,0.194,7,110,117,280,117,117
10685,2012-03-26,Summer,2012,Mar,7,0,Monday,1,Clear,0.44,0.4394,0.72,0.194,15,355,370,280,370,370
10686,2012-03-26,Summer,2012,Mar,8,0,Monday,1,Clear,0.44,0.4394,0.62,0.2239,32,625,657,280,657,657
10687,2012-03-26,Summer,2012,Mar,9,0,Monday,1,Clear,0.46,0.4545,0.47,0.2836,37,245,282,280,282,282
10688,2012-03-26,Summer,2012,Mar,10,0,Monday,1,Clear,0.5,0.4848,0.36,0.5821,55,98,153,280,153,153
10689,2012-03-26,Summer,2012,Mar,11,0,Monday,1,Clear,0.48,0.4697,0.31,0.5821,47,131,178,280,178,178
10690,2012-03-26,Summer,2012,Mar,12,0,Monday,1,Clear,0.48,0.4697,0.33,0.5224,63,216,279,280,279,279
10691,2012-03-26,Summer,2012,Mar,13,0,Monday,1,Clear,0.48,0.4697,0.29,0.6866,79,222,301,280,301,301
10692,2012-03-26,Summer,2012,Mar,14,0,Monday,1,Clear,0.48,0.4697,0.33,0.4478,58,159,217,280,217,217
10693,2012-03-26,Summer,2012,Mar,15,0,Monday,1,Clear,0.48,0.4697,0.29,0.6119,66,157,223,280,223,223
10694,2012-03-26,Summer,2012,Mar,16,0,Monday,1,Clear,0.48,0.4697,0.25,0.6418,60,245,305,280,305,305
10695,2012-03-26,Summer,2012,Mar,17,0,Monday,1,Clear,0.46,0.4545,0.24,0.4478,65,599,664,280,664,664
10696,2012-03-26,Summer,2012,Mar,18,0,Monday,1,Clear,0.44,0.4394,0.26,0.4478,90,594,684,280,684,684
10697,2012-03-26,Summer,2012,Mar,19,0,Monday,1,Clear,0.42,0.4242,0.24,0.3582,41,417,458,280,458,458
10698,2012-03-26,Summer,2012,Mar,20,0,Monday,1,Clear,0.4,0.4091,0.26,0.5224,12,209,221,280,221,221
10699,2012-03-26,Summer,2012,Mar,21,0,Monday,1,Clear,0.38,0.3939,0.25,0.4925,11,175,186,280,186,186
10700,2012-03-26,Summer,2012,Mar,22,0,Monday,1,Clear,0.36,0.3333,0.25,0.3582,13,80,93,280,93,93
10701,2012-03-26,Summer,2012,Mar,23,0,Monday,1,Clear,0.34,0.2879,0.25,0.5224,2,46,48,280,48,48
10702,2012-03-27,Summer,2012,Mar,0,0,Tuesday,1,Clear,0.32,0.2879,0.26,0.5224,1,9,10,279,10,10
10703,2012-03-27,Summer,2012,Mar,1,0,Tuesday,1,Clear,0.3,0.2727,0.26,0.4627,1,4,5,279,5,5
10704,2012-03-27,Summer,2012,Mar,2,0,Tuesday,1,Clear,0.26,0.2273,0.3,0.2985,1,6,7,279,7,7
10705,2012-03-27,Summer,2012,Mar,3,0,Tuesday,1,Clear,0.26,0.2273,0.3,0.3284,0,4,4,279,4,4
10706,2012-03-27,Summer,2012,Mar,4,0,Tuesday,1,Clear,0.24,0.2121,0.32,0.3582,0,3,3,279,3,3
10707,2012-03-27,Summer,2012,Mar,5,0,Tuesday,1,Clear,0.22,0.2121,0.37,0.2836,1,16,17,279,17,17
10708,2012-03-27,Summer,2012,Mar,6,0,Tuesday,1,Clear,0.22,0.2273,0.37,0.194,5,96,101,279,101,101
10709,2012-03-27,Summer,2012,Mar,7,0,Tuesday,1,Clear,0.22,0.2273,0.37,0.194,9,277,286,279,286,286
10710,2012-03-27,Summer,2012,Mar,8,0,Tuesday,1,Clear,0.22,0.2121,0.37,0.2985,14,567,581,279,581,581
10711,2012-03-27,Summer,2012,Mar,9,0,Tuesday,1,Clear,0.24,0.2273,0.38,0.194,8,259,267,279,267,267
10712,2012-03-27,Summer,2012,Mar,10,0,Tuesday,1,Clear,0.26,0.2576,0.35,0.2239,20,118,138,279,138,138
10713,2012-03-27,Summer,2012,Mar,11,0,Tuesday,1,Clear,0.3,0.303,0.31,0.1642,34,141,175,279,175,175
10714,2012-03-27,Summer,2012,Mar,12,0,Tuesday,1,Clear,0.32,0.3182,0.31,0.1642,34,186,220,279,220,220
10715,2012-03-27,Summer,2012,Mar,13,0,Tuesday,1,Clear,0.36,0.3485,0.27,0.0,46,165,211,279,211,211
10716,2012-03-27,Summer,2012,Mar,14,0,Tuesday,1,Clear,0.4,0.4091,0.24,0.1343,37,147,184,279,184,184
10717,2012-03-27,Summer,2012,Mar,15,0,Tuesday,1,Clear,0.42,0.4242,0.2,0.0,42,158,200,279,200,200
10718,2012-03-27,Summer,2012,Mar,16,0,Tuesday,1,Clear,0.42,0.4242,0.2,0.0,38,267,305,279,305,305
10719,2012-03-27,Summer,2012,Mar,17,0,Tuesday,1,Clear,0.44,0.4394,0.16,0.0,72,542,614,279,614,614
10720,2012-03-27,Summer,2012,Mar,18,0,Tuesday,1,Clear,0.42,0.4242,0.17,0.0896,67,577,644,279,644,644
10721,2012-03-27,Summer,2012,Mar,19,0,Tuesday,1,Clear,0.42,0.4242,0.17,0.0,40,377,417,279,417,417
10722,2012-03-27,Summer,2012,Mar,20,0,Tuesday,1,Clear,0.42,0.4242,0.17,0.0896,28,266,294,279,294,294
10723,2012-03-27,Summer,2012,Mar,21,0,Tuesday,1,Clear,0.36,0.3485,0.37,0.1642,21,200,221,279,221,221
10724,2012-03-27,Summer,2012,Mar,22,0,Tuesday,1,Clear,0.36,0.3485,0.37,0.1343,7,127,134,279,134,134
10725,2012-03-27,Summer,2012,Mar,23,0,Tuesday,1,Clear,0.36,0.3485,0.37,0.194,5,59,64,279,64,64
10726,2012-03-28,Summer,2012,Mar,0,0,Wednesday,1,Clear,0.36,0.3333,0.4,0.2836,1,29,30,278,30,30
10727,2012-03-28,Summer,2012,Mar,1,0,Wednesday,1,Clear,0.36,0.3333,0.46,0.2985,0,8,8,278,8,8
10728,2012-03-28,Summer,2012,Mar,2,0,Wednesday,1,Clear,0.34,0.303,0.49,0.2985,0,3,3,278,3,3
10729,2012-03-28,Summer,2012,Mar,3,0,Wednesday,1,Clear,0.34,0.303,0.42,0.3284,1,4,5,278,5,5
10730,2012-03-28,Summer,2012,Mar,4,0,Wednesday,1,Clear,0.36,0.3333,0.43,0.2985,1,0,1,278,1,1
10731,2012-03-28,Summer,2012,Mar,5,0,Wednesday,1,Clear,0.36,0.3333,0.43,0.2985,2,38,40,278,40,40
10732,2012-03-28,Summer,2012,Mar,6,0,Wednesday,1,Clear,0.36,0.3333,0.46,0.3582,4,111,115,278,115,115
10733,2012-03-28,Summer,2012,Mar,7,0,Wednesday,1,Clear,0.36,0.3333,0.46,0.3284,10,348,358,278,358,358
10734,2012-03-28,Summer,2012,Mar,8,0,Wednesday,1,Clear,0.38,0.3939,0.46,0.3582,19,639,658,278,658,658
10735,2012-03-28,Summer,2012,Mar,9,0,Wednesday,1,Clear,0.4,0.4091,0.43,0.4478,16,298,314,278,314,314
10736,2012-03-28,Summer,2012,Mar,10,0,Wednesday,1,Clear,0.46,0.4545,0.41,0.4179,33,140,173,278,173,173
10737,2012-03-28,Summer,2012,Mar,11,0,Wednesday,1,Clear,0.5,0.4848,0.42,0.3881,54,168,222,278,222,222
10738,2012-03-28,Summer,2012,Mar,12,0,Wednesday,1,Misty,0.54,0.5152,0.39,0.3582,50,218,268,278,268,268
10739,2012-03-28,Summer,2012,Mar,13,0,Wednesday,1,Clear,0.56,0.5303,0.43,0.3284,60,213,273,278,273,273
10740,2012-03-28,Summer,2012,Mar,14,0,Wednesday,1,Clear,0.62,0.6212,0.38,0.3582,52,169,221,278,221,221
10741,2012-03-28,Summer,2012,Mar,15,0,Wednesday,1,Misty,0.62,0.6212,0.41,0.2985,47,152,199,278,199,199
10742,2012-03-28,Summer,2012,Mar,16,0,Wednesday,1,Light_rainsnow,0.62,0.6212,0.43,0.0896,51,170,221,278,221,221
10743,2012-03-28,Summer,2012,Mar,17,0,Wednesday,1,Clear,0.6,0.6061,0.6,0.2239,72,532,604,278,604,604
10744,2012-03-28,Summer,2012,Mar,18,0,Wednesday,1,Clear,0.6,0.6061,0.6,0.2239,61,580,641,278,641,641
10745,2012-03-28,Summer,2012,Mar,19,0,Wednesday,1,Clear,0.6,0.6212,0.56,0.194,41,415,456,278,456,456
10746,2012-03-28,Summer,2012,Mar,20,0,Wednesday,1,Clear,0.6,0.6212,0.56,0.2985,38,324,362,278,362,362
10747,2012-03-28,Summer,2012,Mar,21,0,Wednesday,1,Clear,0.58,0.5455,0.6,0.2537,28,233,261,278,261,261
10748,2012-03-28,Summer,2012,Mar,22,0,Wednesday,1,Clear,0.56,0.5303,0.64,0.1343,21,151,172,278,172,172
10749,2012-03-28,Summer,2012,Mar,23,0,Wednesday,1,Clear,0.54,0.5152,0.68,0.1343,12,81,93,278,93,93
10750,2012-03-29,Summer,2012,Mar,0,0,Thursday,1,Clear,0.54,0.5152,0.68,0.194,10,38,48,277,48,48
10751,2012-03-29,Summer,2012,Mar,1,0,Thursday,1,Clear,0.56,0.5303,0.6,0.1343,15,18,33,277,33,33
10752,2012-03-29,Summer,2012,Mar,2,0,Thursday,1,Clear,0.6,0.6061,0.28,0.2985,0,6,6,277,6,6
10753,2012-03-29,Summer,2012,Mar,3,0,Thursday,1,Clear,0.58,0.5455,0.28,0.2537,1,4,5,277,5,5
10754,2012-03-29,Summer,2012,Mar,4,0,Thursday,1,Clear,0.52,0.5,0.36,0.2537,1,8,9,277,9,9
10755,2012-03-29,Summer,2012,Mar,5,0,Thursday,1,Clear,0.5,0.4848,0.45,0.2239,2,30,32,277,32,32
10756,2012-03-29,Summer,2012,Mar,6,0,Thursday,1,Clear,0.46,0.4545,0.59,0.2537,3,114,117,277,117,117
10757,2012-03-29,Summer,2012,Mar,7,0,Thursday,1,Clear,0.46,0.4545,0.51,0.3582,14,353,367,277,367,367
10758,2012-03-29,Summer,2012,Mar,8,0,Thursday,1,Clear,0.46,0.4545,0.47,0.4179,26,628,654,277,654,654
10759,2012-03-29,Summer,2012,Mar,9,0,Thursday,1,Clear,0.48,0.4697,0.48,0.4179,22,299,321,277,321,321
10760,2012-03-29,Summer,2012,Mar,10,0,Thursday,1,Clear,0.46,0.4545,0.47,0.4478,42,124,166,277,166,166
10761,2012-03-29,Summer,2012,Mar,11,0,Thursday,1,Clear,0.5,0.4848,0.45,0.4179,54,166,220,277,220,220
10762,2012-03-29,Summer,2012,Mar,12,0,Thursday,1,Clear,0.5,0.4848,0.42,0.4925,64,228,292,277,292,292
10763,2012-03-29,Summer,2012,Mar,13,0,Thursday,1,Clear,0.46,0.4545,0.44,0.3284,50,223,273,277,273,273
10764,2012-03-29,Summer,2012,Mar,14,0,Thursday,1,Clear,0.5,0.4848,0.42,0.3582,63,175,238,277,238,238
10765,2012-03-29,Summer,2012,Mar,15,0,Thursday,1,Clear,0.52,0.5,0.39,0.3582,109,198,307,277,307,307
10766,2012-03-29,Summer,2012,Mar,16,0,Thursday,1,Clear,0.52,0.5,0.36,0.3284,67,321,388,277,388,388
10767,2012-03-29,Summer,2012,Mar,17,0,Thursday,1,Clear,0.52,0.5,0.38,0.3881,83,620,703,277,703,703
10768,2012-03-29,Summer,2012,Mar,18,0,Thursday,1,Clear,0.5,0.4848,0.39,0.2985,83,598,681,277,681,681
10769,2012-03-29,Summer,2012,Mar,19,0,Thursday,1,Clear,0.48,0.4697,0.39,0.2836,47,421,468,277,468,468
10770,2012-03-29,Summer,2012,Mar,20,0,Thursday,1,Clear,0.46,0.4545,0.38,0.2985,34,301,335,277,335,335
10771,2012-03-29,Summer,2012,Mar,21,0,Thursday,1,Clear,0.44,0.4394,0.44,0.2836,10,214,224,277,224,224
10772,2012-03-29,Summer,2012,Mar,22,0,Thursday,1,Clear,0.42,0.4242,0.44,0.2836,17,135,152,277,152,152
10773,2012-03-29,Summer,2012,Mar,23,0,Thursday,1,Clear,0.42,0.4242,0.47,0.2985,17,77,94,277,94,94
10774,2012-03-30,Summer,2012,Mar,0,0,Friday,1,Clear,0.4,0.4091,0.47,0.2985,10,49,59,276,59,59
10775,2012-03-30,Summer,2012,Mar,1,0,Friday,1,Clear,0.38,0.3939,0.5,0.2836,6,21,27,276,27,27
10776,2012-03-30,Summer,2012,Mar,2,0,Friday,1,Clear,0.36,0.3333,0.53,0.2985,1,6,7,276,7,7
10777,2012-03-30,Summer,2012,Mar,3,0,Friday,1,Clear,0.34,0.3333,0.61,0.1343,0,7,7,276,7,7
10778,2012-03-30,Summer,2012,Mar,4,0,Friday,1,Clear,0.34,0.3485,0.53,0.0896,1,1,2,276,2,2
10779,2012-03-30,Summer,2012,Mar,5,0,Friday,1,Clear,0.32,0.3333,0.61,0.0896,0,26,26,276,26,26
10780,2012-03-30,Summer,2012,Mar,6,0,Friday,1,Clear,0.32,0.3333,0.57,0.1343,5,81,86,276,86,86
10781,2012-03-30,Summer,2012,Mar,7,0,Friday,1,Clear,0.32,0.3182,0.57,0.1642,9,280,289,276,289,289
10782,2012-03-30,Summer,2012,Mar,8,0,Friday,1,Clear,0.32,0.3182,0.66,0.1642,38,555,593,276,593,593
10783,2012-03-30,Summer,2012,Mar,9,0,Friday,1,Clear,0.34,0.3333,0.57,0.1642,29,292,321,276,321,321
10784,2012-03-30,Summer,2012,Mar,10,0,Friday,1,Misty,0.36,0.3636,0.57,0.1045,50,137,187,276,187,187
10785,2012-03-30,Summer,2012,Mar,11,0,Friday,1,Misty,0.36,0.3788,0.53,0.0,48,153,201,276,201,201
10786,2012-03-30,Summer,2012,Mar,12,0,Friday,1,Misty,0.38,0.3939,0.54,0.0,62,208,270,276,270,270
10787,2012-03-30,Summer,2012,Mar,13,0,Friday,1,Light_rainsnow,0.4,0.4091,0.5,0.0,44,198,242,276,242,242
10788,2012-03-30,Summer,2012,Mar,14,0,Friday,1,Light_rainsnow,0.4,0.4091,0.54,0.0,56,173,229,276,229,229
10789,2012-03-30,Summer,2012,Mar,15,0,Friday,1,Light_rainsnow,0.42,0.4242,0.54,0.0,73,207,280,276,280,280
10790,2012-03-30,Summer,2012,Mar,16,0,Friday,1,Light_rainsnow,0.4,0.4091,0.62,0.2836,75,292,367,276,367,367
10791,2012-03-30,Summer,2012,Mar,17,0,Friday,1,Misty,0.4,0.4091,0.62,0.2239,93,513,606,276,606,606
10792,2012-03-30,Summer,2012,Mar,18,0,Friday,1,Clear,0.42,0.4242,0.54,0.194,68,492,560,276,560,560
10793,2012-03-30,Summer,2012,Mar,19,0,Friday,1,Clear,0.4,0.4091,0.62,0.2239,42,353,395,276,395,395
10794,2012-03-30,Summer,2012,Mar,20,0,Friday,1,Clear,0.4,0.4091,0.62,0.1642,17,192,209,276,209,209
10795,2012-03-30,Summer,2012,Mar,21,0,Friday,1,Clear,0.38,0.3939,0.66,0.1343,30,190,220,276,220,220
10796,2012-03-30,Summer,2012,Mar,22,0,Friday,1,Clear,0.36,0.3485,0.71,0.1642,23,130,153,276,153,153
10797,2012-03-30,Summer,2012,Mar,23,0,Friday,1,Clear,0.36,0.3788,0.71,0.0,16,107,123,276,123,123
10798,2012-03-31,Summer,2012,Mar,0,0,Saturday,0,Clear,0.38,0.3939,0.82,0.194,12,80,92,275,92,92
10799,2012-03-31,Summer,2012,Mar,1,0,Saturday,0,Misty,0.4,0.4091,0.76,0.194,17,65,82,275,82,82
10800,2012-03-31,Summer,2012,Mar,2,0,Saturday,0,Misty,0.42,0.4242,0.77,0.2537,14,55,69,275,69,69
10801,2012-03-31,Summer,2012,Mar,3,0,Saturday,0,Clear,0.4,0.4091,0.82,0.2537,10,21,31,275,31,31
10802,2012-03-31,Summer,2012,Mar,4,0,Saturday,0,Clear,0.42,0.4242,0.77,0.4179,4,4,8,275,8,8
10803,2012-03-31,Summer,2012,Mar,5,0,Saturday,0,Clear,0.4,0.4091,0.82,0.2239,0,5,5,275,5,5
10804,2012-03-31,Summer,2012,Mar,6,0,Saturday,0,Misty,0.36,0.3485,0.87,0.1642,7,16,23,275,23,23
10805,2012-03-31,Summer,2012,Mar,7,0,Saturday,0,Misty,0.36,0.3485,0.87,0.1642,5,39,44,275,44,44
10806,2012-03-31,Summer,2012,Mar,8,0,Saturday,0,Misty,0.36,0.3485,0.87,0.194,19,126,145,275,145,145
10807,2012-03-31,Summer,2012,Mar,9,0,Saturday,0,Misty,0.4,0.4091,0.76,0.194,62,161,223,275,223,223
10808,2012-03-31,Summer,2012,Mar,10,0,Saturday,0,Misty,0.4,0.4091,0.76,0.1343,108,205,313,275,313,313
10809,2012-03-31,Summer,2012,Mar,11,0,Saturday,0,Clear,0.46,0.4545,0.72,0.1343,184,279,463,275,463,463
10810,2012-03-31,Summer,2012,Mar,12,0,Saturday,0,Clear,0.48,0.4697,0.67,0.0,263,358,621,275,621,621
10811,2012-03-31,Summer,2012,Mar,13,0,Saturday,0,Clear,0.54,0.5152,0.6,0.1343,265,373,638,275,638,638
10812,2012-03-31,Summer,2012,Mar,14,0,Saturday,0,Misty,0.5,0.4848,0.63,0.2537,240,311,551,275,551,551
10813,2012-03-31,Summer,2012,Mar,15,0,Saturday,0,Misty,0.52,0.5,0.59,0.2836,275,330,605,275,605,605
10814,2012-03-31,Summer,2012,Mar,16,0,Saturday,0,Misty,0.5,0.4848,0.63,0.2985,243,292,535,275,535,535
10815,2012-03-31,Summer,2012,Mar,17,0,Saturday,0,Clear,0.48,0.4697,0.67,0.4179,238,305,543,275,543,543
10816,2012-03-31,Summer,2012,Mar,18,0,Saturday,0,Misty,0.44,0.4394,0.72,0.4627,102,239,341,275,341,341
10817,2012-03-31,Summer,2012,Mar,19,0,Saturday,0,Clear,0.42,0.4242,0.71,0.4478,93,191,284,275,284,284
10818,2012-03-31,Summer,2012,Mar,20,0,Saturday,0,Misty,0.4,0.4091,0.71,0.3284,52,156,208,275,208,208
10819,2012-03-31,Summer,2012,Mar,21,0,Saturday,0,Misty,0.4,0.4091,0.71,0.3284,36,107,143,275,143,143
10820,2012-03-31,Summer,2012,Mar,22,0,Saturday,0,Misty,0.38,0.3939,0.71,0.2537,40,116,156,275,156,156
10821,2012-03-31,Summer,2012,Mar,23,0,Saturday,0,Misty,0.36,0.3333,0.76,0.2836,12,100,112,275,112,112
10822,2012-04-01,Summer,2012,Apr,0,0,Sunday,0,Misty,0.36,0.3333,0.76,0.2537,8,59,67,274,67,67
10823,2012-04-01,Summer,2012,Apr,1,0,Sunday,0,Misty,0.36,0.3485,0.76,0.1642,13,49,62,274,62,62
10824,2012-04-01,Summer,2012,Apr,2,0,Sunday,0,Misty,0.36,0.3485,0.76,0.1642,20,61,81,274,81,81
10825,2012-04-01,Summer,2012,Apr,3,0,Sunday,0,Misty,0.34,0.3333,0.81,0.1343,4,21,25,274,25,25
10826,2012-04-01,Summer,2012,Apr,4,0,Sunday,0,Misty,0.34,0.3485,0.81,0.0896,3,9,12,274,12,12
10827,2012-04-01,Summer,2012,Apr,5,0,Sunday,0,Misty,0.34,0.3485,0.81,0.0896,8,10,18,274,18,18
10828,2012-04-01,Summer,2012,Apr,6,0,Sunday,0,Misty,0.36,0.3485,0.76,0.1343,9,88,97,274,97,97
10829,2012-04-01,Summer,2012,Apr,7,0,Sunday,0,Misty,0.36,0.3485,0.71,0.1343,29,55,84,274,84,84
10830,2012-04-01,Summer,2012,Apr,8,0,Sunday,0,Misty,0.36,0.3636,0.76,0.0896,37,88,125,274,125,125
10831,2012-04-01,Summer,2012,Apr,9,0,Sunday,0,Misty,0.36,0.3485,0.81,0.1343,102,173,275,274,275,275
10832,2012-04-01,Summer,2012,Apr,10,0,Sunday,0,Misty,0.4,0.4091,0.71,0.1045,132,228,360,274,360,360
10833,2012-04-01,Summer,2012,Apr,11,0,Sunday,0,Misty,0.4,0.4091,0.71,0.194,180,271,451,274,451,451
10834,2012-04-01,Summer,2012,Apr,12,0,Sunday,0,Misty,0.42,0.4242,0.67,0.2239,187,258,445,274,445,445
10835,2012-04-01,Summer,2012,Apr,13,0,Sunday,0,Misty,0.44,0.4394,0.62,0.194,190,274,464,274,464,464
10836,2012-04-01,Summer,2012,Apr,14,0,Sunday,0,Misty,0.48,0.4697,0.55,0.2239,283,278,561,274,561,561
10837,2012-04-01,Summer,2012,Apr,15,0,Sunday,0,Clear,0.5,0.4848,0.55,0.2537,295,278,573,274,573,573
10838,2012-04-01,Summer,2012,Apr,16,0,Sunday,0,Clear,0.52,0.5,0.52,0.2537,236,275,511,274,511,511
10839,2012-04-01,Summer,2012,Apr,17,0,Sunday,0,Clear,0.52,0.5,0.55,0.2836,232,323,555,274,555,555
10840,2012-04-01,Summer,2012,Apr,18,0,Sunday,0,Clear,0.52,0.5,0.52,0.2985,153,279,432,274,432,432
10841,2012-04-01,Summer,2012,Apr,19,0,Sunday,0,Clear,0.52,0.5,0.55,0.2239,110,236,346,274,346,346
10842,2012-04-01,Summer,2012,Apr,20,0,Sunday,0,Misty,0.5,0.4848,0.59,0.2239,66,166,232,274,232,232
10843,2012-04-01,Summer,2012,Apr,21,0,Sunday,0,Misty,0.5,0.4848,0.59,0.1642,33,101,134,274,134,134
10844,2012-04-01,Summer,2012,Apr,22,0,Sunday,0,Light_rainsnow,0.5,0.4848,0.63,0.1045,7,61,68,274,68,68
10845,2012-04-01,Summer,2012,Apr,23,0,Sunday,0,Light_rainsnow,0.46,0.4545,0.72,0.0,10,53,63,274,63,63
10846,2012-04-02,Summer,2012,Apr,0,0,Monday,1,Light_rainsnow,0.44,0.4394,0.82,0.1045,6,11,17,273,17,17
10847,2012-04-02,Summer,2012,Apr,1,0,Monday,1,Light_rainsnow,0.42,0.4242,0.88,0.0896,0,5,5,273,5,5
10848,2012-04-02,Summer,2012,Apr,2,0,Monday,1,Light_rainsnow,0.44,0.4394,0.94,0.1343,2,3,5,273,5,5
10849,2012-04-02,Summer,2012,Apr,4,0,Monday,1,Clear,0.4,0.4091,0.76,0.4925,2,2,4,273,4,4
10850,2012-04-02,Summer,2012,Apr,5,0,Monday,1,Clear,0.4,0.4091,0.76,0.4925,2,22,24,273,24,24
10851,2012-04-02,Summer,2012,Apr,6,0,Monday,1,Clear,0.36,0.3182,0.71,0.4627,6,104,110,273,110,110
10852,2012-04-02,Summer,2012,Apr,7,0,Monday,1,Clear,0.34,0.303,0.66,0.3881,12,294,306,273,306,306
10853,2012-04-02,Summer,2012,Apr,8,0,Monday,1,Clear,0.36,0.3333,0.57,0.3284,36,553,589,273,589,589
10854,2012-04-02,Summer,2012,Apr,9,0,Monday,1,Clear,0.38,0.3939,0.54,0.3582,52,265,317,273,317,317
10855,2012-04-02,Summer,2012,Apr,10,0,Monday,1,Clear,0.4,0.4091,0.5,0.5224,85,119,204,273,204,204
10856,2012-04-02,Summer,2012,Apr,11,0,Monday,1,Clear,0.42,0.4242,0.47,0.4478,81,128,209,273,209,209
10857,2012-04-02,Summer,2012,Apr,12,0,Monday,1,Clear,0.44,0.4394,0.44,0.4478,100,181,281,273,281,281
10858,2012-04-02,Summer,2012,Apr,13,0,Monday,1,Clear,0.46,0.4545,0.36,0.2985,97,184,281,273,281,281
10859,2012-04-02,Summer,2012,Apr,14,0,Monday,1,Clear,0.46,0.4545,0.31,0.4179,127,141,268,273,268,268
10860,2012-04-02,Summer,2012,Apr,15,0,Monday,1,Clear,0.48,0.4697,0.33,0.4179,132,192,324,273,324,324
10861,2012-04-02,Summer,2012,Apr,16,0,Monday,1,Clear,0.5,0.4848,0.34,0.3284,104,291,395,273,395,395
10862,2012-04-02,Summer,2012,Apr,17,0,Monday,1,Clear,0.5,0.4848,0.29,0.2836,128,601,729,273,729,729
10863,2012-04-02,Summer,2012,Apr,18,0,Monday,1,Clear,0.5,0.4848,0.27,0.2537,75,543,618,273,618,618
10864,2012-04-02,Summer,2012,Apr,19,0,Monday,1,Clear,0.5,0.4848,0.27,0.2537,66,428,494,273,494,494
10865,2012-04-02,Summer,2012,Apr,20,0,Monday,1,Clear,0.46,0.4545,0.31,0.1642,48,281,329,273,329,329
10866,2012-04-02,Summer,2012,Apr,21,0,Monday,1,Clear,0.46,0.4545,0.28,0.1343,24,214,238,273,238,238
10867,2012-04-02,Summer,2012,Apr,22,0,Monday,1,Clear,0.42,0.4242,0.44,0.194,17,106,123,273,123,123
10868,2012-04-02,Summer,2012,Apr,23,0,Monday,1,Clear,0.44,0.4394,0.35,0.1642,6,60,66,273,66,66
10869,2012-04-03,Summer,2012,Apr,0,0,Tuesday,1,Clear,0.4,0.4091,0.43,0.1343,1,32,33,272,33,33
10870,2012-04-03,Summer,2012,Apr,1,0,Tuesday,1,Clear,0.38,0.3939,0.46,0.2239,0,11,11,272,11,11
10871,2012-04-03,Summer,2012,Apr,2,0,Tuesday,1,Clear,0.36,0.3485,0.53,0.1642,0,5,5,272,5,5
10872,2012-04-03,Summer,2012,Apr,3,0,Tuesday,1,Clear,0.38,0.3939,0.46,0.0,0,3,3,272,3,3
10873,2012-04-03,Summer,2012,Apr,4,0,Tuesday,1,Clear,0.32,0.3333,0.66,0.0896,0,1,1,272,1,1
10874,2012-04-03,Summer,2012,Apr,5,0,Tuesday,1,Clear,0.32,0.3333,0.66,0.0896,2,25,27,272,27,27
10875,2012-04-03,Summer,2012,Apr,6,0,Tuesday,1,Clear,0.3,0.3182,0.61,0.0896,2,98,100,272,100,100
10876,2012-04-03,Summer,2012,Apr,7,0,Tuesday,1,Clear,0.32,0.3333,0.66,0.0896,14,327,341,272,341,341
10877,2012-04-03,Summer,2012,Apr,8,0,Tuesday,1,Clear,0.34,0.3636,0.57,0.0,27,577,604,272,604,604
10878,2012-04-03,Summer,2012,Apr,9,0,Tuesday,1,Clear,0.42,0.4242,0.38,0.0896,54,354,408,272,408,408
10879,2012-04-03,Summer,2012,Apr,10,0,Tuesday,1,Clear,0.44,0.4394,0.33,0.0,77,142,219,272,219,219
10880,2012-04-03,Summer,2012,Apr,11,0,Tuesday,1,Clear,0.48,0.4697,0.23,0.0,91,167,258,272,258,258
10881,2012-04-03,Summer,2012,Apr,12,0,Tuesday,1,Clear,0.52,0.5,0.25,0.0,101,230,331,272,331,331
10882,2012-04-03,Summer,2012,Apr,13,0,Tuesday,1,Clear,0.56,0.5303,0.19,0.2537,120,225,345,272,345,345
10883,2012-04-03,Summer,2012,Apr,14,0,Tuesday,1,Clear,0.56,0.5303,0.21,0.2239,120,191,311,272,311,311
10884,2012-04-03,Summer,2012,Apr,15,0,Tuesday,1,Clear,0.6,0.5909,0.2,0.194,109,207,316,272,316,316
10885,2012-04-03,Summer,2012,Apr,16,0,Tuesday,1,Clear,0.62,0.6061,0.21,0.1642,145,340,485,272,485,485
10886,2012-04-03,Summer,2012,Apr,17,0,Tuesday,1,Clear,0.62,0.6061,0.17,0.194,123,634,757,272,757,757
10887,2012-04-03,Summer,2012,Apr,18,0,Tuesday,1,Clear,0.6,0.6061,0.26,0.1642,139,661,800,272,800,800
10888,2012-04-03,Summer,2012,Apr,19,0,Tuesday,1,Clear,0.56,0.5303,0.26,0.1045,98,460,558,272,558,558
10889,2012-04-03,Summer,2012,Apr,20,0,Tuesday,1,Clear,0.56,0.5303,0.24,0.1343,54,325,379,272,379,379
10890,2012-04-03,Summer,2012,Apr,21,0,Tuesday,1,Clear,0.54,0.5152,0.45,0.0,33,210,243,272,243,243
10891,2012-04-03,Summer,2012,Apr,22,0,Tuesday,1,Clear,0.5,0.4848,0.51,0.0,25,133,158,272,158,158
10892,2012-04-03,Summer,2012,Apr,23,0,Tuesday,1,Clear,0.5,0.4848,0.59,0.0,13,66,79,272,79,79
10893,2012-04-04,Summer,2012,Apr,0,0,Wednesday,1,Clear,0.48,0.4697,0.48,0.0,18,23,41,271,41,41
10894,2012-04-04,Summer,2012,Apr,1,0,Wednesday,1,Clear,0.46,0.4545,0.59,0.0,0,11,11,271,11,11
10895,2012-04-04,Summer,2012,Apr,2,0,Wednesday,1,Clear,0.46,0.4545,0.51,0.0,0,5,5,271,5,5
10896,2012-04-04,Summer,2012,Apr,3,0,Wednesday,1,Clear,0.44,0.4394,0.58,0.0896,0,3,3,271,3,3
10897,2012-04-04,Summer,2012,Apr,4,0,Wednesday,1,Clear,0.42,0.4242,0.67,0.0896,0,1,1,271,1,1
10898,2012-04-04,Summer,2012,Apr,5,0,Wednesday,1,Clear,0.42,0.4242,0.67,0.0896,0,27,27,271,27,27
10899,2012-04-04,Summer,2012,Apr,6,0,Wednesday,1,Misty,0.42,0.4242,0.58,0.0,6,120,126,271,126,126
10900,2012-04-04,Summer,2012,Apr,7,0,Wednesday,1,Misty,0.44,0.4394,0.62,0.0,12,354,366,271,366,366
10901,2012-04-04,Summer,2012,Apr,8,0,Wednesday,1,Misty,0.44,0.4394,0.72,0.1045,31,653,684,271,684,684
10902,2012-04-04,Summer,2012,Apr,9,0,Wednesday,1,Misty,0.48,0.4697,0.55,0.1343,47,316,363,271,363,363
10903,2012-04-04,Summer,2012,Apr,10,0,Wednesday,1,Misty,0.54,0.5152,0.45,0.1343,68,99,167,271,167,167
10904,2012-04-04,Summer,2012,Apr,11,0,Wednesday,1,Misty,0.6,0.6212,0.43,0.3582,61,152,213,271,213,213
10905,2012-04-04,Summer,2012,Apr,12,0,Wednesday,1,Misty,0.6,0.6212,0.46,0.4179,73,210,283,271,283,283
10906,2012-04-04,Summer,2012,Apr,13,0,Wednesday,1,Misty,0.6,0.6212,0.46,0.2537,70,181,251,271,251,251
10907,2012-04-04,Summer,2012,Apr,14,0,Wednesday,1,Misty,0.62,0.6212,0.46,0.194,82,176,258,271,258,258
10908,2012-04-04,Summer,2012,Apr,15,0,Wednesday,1,Misty,0.64,0.6212,0.44,0.2836,86,182,268,271,268,268
10909,2012-04-04,Summer,2012,Apr,16,0,Wednesday,1,Misty,0.64,0.6212,0.44,0.2836,86,304,390,271,390,390
10910,2012-04-04,Summer,2012,Apr,17,0,Wednesday,1,Clear,0.66,0.6212,0.41,0.2985,99,645,744,271,744,744
10911,2012-04-04,Summer,2012,Apr,18,0,Wednesday,1,Clear,0.66,0.6212,0.41,0.2537,113,646,759,271,759,759
10912,2012-04-04,Summer,2012,Apr,19,0,Wednesday,1,Clear,0.66,0.6212,0.39,0.2239,75,419,494,271,494,494
10913,2012-04-04,Summer,2012,Apr,20,0,Wednesday,1,Clear,0.64,0.6212,0.27,0.2239,39,333,372,271,372,372
10914,2012-04-04,Summer,2012,Apr,21,0,Wednesday,1,Clear,0.6,0.6061,0.23,0.3284,43,255,298,271,298,298
10915,2012-04-04,Summer,2012,Apr,22,0,Wednesday,1,Clear,0.56,0.5303,0.22,0.1642,30,151,181,271,181,181
10916,2012-04-04,Summer,2012,Apr,23,0,Wednesday,1,Clear,0.52,0.5,0.23,0.4179,19,112,131,271,131,131
10917,2012-04-05,Summer,2012,Apr,0,0,Thursday,1,Clear,0.52,0.5,0.23,0.4179,12,33,45,270,45,45
10918,2012-04-05,Summer,2012,Apr,1,0,Thursday,1,Clear,0.48,0.4697,0.27,0.3284,4,9,13,270,13,13
10919,2012-04-05,Summer,2012,Apr,2,0,Thursday,1,Clear,0.46,0.4545,0.33,0.4478,7,11,18,270,18,18
10920,2012-04-05,Summer,2012,Apr,3,0,Thursday,1,Clear,0.42,0.4242,0.41,0.2985,0,5,5,270,5,5
10921,2012-04-05,Summer,2012,Apr,4,0,Thursday,1,Clear,0.38,0.3939,0.43,0.2836,0,1,1,270,1,1
10922,2012-04-05,Summer,2012,Apr,5,0,Thursday,1,Clear,0.38,0.3939,0.43,0.2836,1,28,29,270,29,29
10923,2012-04-05,Summer,2012,Apr,6,0,Thursday,1,Clear,0.36,0.3333,0.46,0.3284,8,118,126,270,126,126
10924,2012-04-05,Summer,2012,Apr,7,0,Thursday,1,Clear,0.34,0.3333,0.49,0.194,15,339,354,270,354,354
10925,2012-04-05,Summer,2012,Apr,8,0,Thursday,1,Clear,0.36,0.3485,0.46,0.2239,28,610,638,270,638,638
10926,2012-04-05,Summer,2012,Apr,9,0,Thursday,1,Clear,0.4,0.4091,0.37,0.2537,61,290,351,270,351,351
10927,2012-04-05,Summer,2012,Apr,10,0,Thursday,1,Clear,0.42,0.4242,0.35,0.2836,88,158,246,270,246,246
10928,2012-04-05,Summer,2012,Apr,11,0,Thursday,1,Misty,0.42,0.4242,0.38,0.2239,109,159,268,270,268,268
10929,2012-04-05,Summer,2012,Apr,12,0,Thursday,1,Clear,0.44,0.4394,0.33,0.0,66,210,276,270,276,276
10930,2012-04-05,Summer,2012,Apr,13,0,Thursday,1,Clear,0.46,0.4545,0.31,0.0,89,202,291,270,291,291
10931,2012-04-05,Summer,2012,Apr,14,0,Thursday,1,Clear,0.46,0.4545,0.33,0.1642,143,144,287,270,287,287
10932,2012-04-05,Summer,2012,Apr,15,0,Thursday,1,Clear,0.5,0.4848,0.31,0.1045,98,171,269,270,269,269
10933,2012-04-05,Summer,2012,Apr,16,0,Thursday,1,Clear,0.5,0.4848,0.31,0.194,84,318,402,270,402,402
10934,2012-04-05,Summer,2012,Apr,17,0,Thursday,1,Clear,0.5,0.4848,0.31,0.1642,145,677,822,270,822,822
10935,2012-04-05,Summer,2012,Apr,18,0,Thursday,1,Clear,0.5,0.4848,0.31,0.1045,80,618,698,270,698,698
10936,2012-04-05,Summer,2012,Apr,19,0,Thursday,1,Clear,0.48,0.4697,0.31,0.2537,64,423,487,270,487,487
10937,2012-04-05,Summer,2012,Apr,20,0,Thursday,1,Clear,0.44,0.4394,0.41,0.194,33,279,312,270,312,312
10938,2012-04-05,Summer,2012,Apr,21,0,Thursday,1,Clear,0.42,0.4242,0.47,0.194,25,209,234,270,234,234
10939,2012-04-05,Summer,2012,Apr,22,0,Thursday,1,Clear,0.4,0.4091,0.47,0.194,20,129,149,270,149,149
10940,2012-04-05,Summer,2012,Apr,23,0,Thursday,1,Clear,0.4,0.4091,0.5,0.1343,12,124,136,270,136,136
10941,2012-04-06,Summer,2012,Apr,0,0,Friday,1,Clear,0.4,0.4091,0.43,0.0,12,49,61,269,61,61
10942,2012-04-06,Summer,2012,Apr,1,0,Friday,1,Clear,0.36,0.3485,0.62,0.1343,10,28,38,269,38,38
10943,2012-04-06,Summer,2012,Apr,2,0,Friday,1,Clear,0.36,0.3333,0.5,0.3881,6,5,11,269,11,11
10944,2012-04-06,Summer,2012,Apr,3,0,Friday,1,Clear,0.34,0.303,0.53,0.3284,3,5,8,269,8,8
10945,2012-04-06,Summer,2012,Apr,4,0,Friday,1,Clear,0.34,0.3182,0.49,0.2537,2,3,5,269,5,5
10946,2012-04-06,Summer,2012,Apr,5,0,Friday,1,Clear,0.32,0.303,0.53,0.3284,0,23,23,269,23,23
10947,2012-04-06,Summer,2012,Apr,6,0,Friday,1,Clear,0.3,0.2727,0.49,0.3881,0,80,80,269,80,80
10948,2012-04-06,Summer,2012,Apr,7,0,Friday,1,Clear,0.3,0.2879,0.49,0.2836,15,231,246,269,246,246
10949,2012-04-06,Summer,2012,Apr,8,0,Friday,1,Clear,0.3,0.2727,0.49,0.3284,19,489,508,269,508,508
10950,2012-04-06,Summer,2012,Apr,9,0,Friday,1,Clear,0.34,0.303,0.42,0.3284,58,318,376,269,376,376
10951,2012-04-06,Summer,2012,Apr,10,0,Friday,1,Clear,0.36,0.3333,0.4,0.3284,81,157,238,269,238,238
10952,2012-04-06,Summer,2012,Apr,11,0,Friday,1,Clear,0.4,0.4091,0.37,0.2985,112,179,291,269,291,291
10953,2012-04-06,Summer,2012,Apr,12,0,Friday,1,Clear,0.42,0.4242,0.35,0.2985,113,224,337,269,337,337
10954,2012-04-06,Summer,2012,Apr,13,0,Friday,1,Clear,0.44,0.4394,0.33,0.3284,173,238,411,269,411,411
10955,2012-04-06,Summer,2012,Apr,14,0,Friday,1,Clear,0.48,0.4697,0.29,0.3881,240,250,490,269,490,490
10956,2012-04-06,Summer,2012,Apr,15,0,Friday,1,Clear,0.5,0.4848,0.27,0.2836,218,319,537,269,537,537
10957,2012-04-06,Summer,2012,Apr,16,0,Friday,1,Clear,0.5,0.4848,0.22,0.4179,184,352,536,269,536,536
10958,2012-04-06,Summer,2012,Apr,17,0,Friday,1,Clear,0.52,0.5,0.23,0.4179,172,483,655,269,655,655
10959,2012-04-06,Summer,2012,Apr,18,0,Friday,1,Clear,0.5,0.4848,0.22,0.4627,104,380,484,269,484,484
10960,2012-04-06,Summer,2012,Apr,19,0,Friday,1,Clear,0.48,0.4697,0.23,0.2985,115,297,412,269,412,412
10961,2012-04-06,Summer,2012,Apr,20,0,Friday,1,Clear,0.46,0.4545,0.24,0.2836,61,191,252,269,252,252
10962,2012-04-06,Summer,2012,Apr,21,0,Friday,1,Clear,0.44,0.4394,0.26,0.1343,54,136,190,269,190,190
10963,2012-04-06,Summer,2012,Apr,22,0,Friday,1,Clear,0.4,0.4091,0.35,0.2239,34,124,158,269,158,158
10964,2012-04-06,Summer,2012,Apr,23,0,Friday,1,Clear,0.42,0.4242,0.3,0.2836,21,92,113,269,113,113
10965,2012-04-07,Summer,2012,Apr,0,0,Saturday,0,Clear,0.42,0.4242,0.26,0.2985,9,85,94,268,94,94
10966,2012-04-07,Summer,2012,Apr,1,0,Saturday,0,Clear,0.4,0.4091,0.28,0.2537,9,60,69,268,69,69
10967,2012-04-07,Summer,2012,Apr,2,0,Saturday,0,Clear,0.36,0.3333,0.29,0.3582,11,25,36,268,36,36
10968,2012-04-07,Summer,2012,Apr,3,0,Saturday,0,Clear,0.36,0.3333,0.32,0.2537,7,21,28,268,28,28
10969,2012-04-07,Summer,2012,Apr,4,0,Saturday,0,Clear,0.32,0.3182,0.36,0.1642,3,4,7,268,7,7
10970,2012-04-07,Summer,2012,Apr,5,0,Saturday,0,Clear,0.32,0.3182,0.33,0.1642,0,2,2,268,2,2
10971,2012-04-07,Summer,2012,Apr,6,0,Saturday,0,Clear,0.32,0.3182,0.36,0.194,1,18,19,268,19,19
10972,2012-04-07,Summer,2012,Apr,7,0,Saturday,0,Clear,0.32,0.303,0.33,0.2836,14,40,54,268,54,54
10973,2012-04-07,Summer,2012,Apr,8,0,Saturday,0,Clear,0.34,0.3182,0.34,0.2537,29,94,123,268,123,123
10974,2012-04-07,Summer,2012,Apr,9,0,Saturday,0,Clear,0.4,0.4091,0.3,0.2537,103,173,276,268,276,276
10975,2012-04-07,Summer,2012,Apr,10,0,Saturday,0,Clear,0.42,0.4242,0.28,0.2537,187,176,363,268,363,363
10976,2012-04-07,Summer,2012,Apr,11,0,Saturday,0,Clear,0.44,0.4394,0.24,0.2985,251,244,495,268,495,495
10977,2012-04-07,Summer,2012,Apr,12,0,Saturday,0,Clear,0.46,0.4545,0.23,0.3881,320,270,590,268,590,590
10978,2012-04-07,Summer,2012,Apr,13,0,Saturday,0,Clear,0.5,0.4848,0.22,0.194,355,288,643,268,643,643
10979,2012-04-07,Summer,2012,Apr,14,0,Saturday,0,Clear,0.5,0.4848,0.22,0.2985,326,252,578,268,578,578
10980,2012-04-07,Summer,2012,Apr,15,0,Saturday,0,Clear,0.52,0.5,0.19,0.4179,321,305,626,268,626,626
10981,2012-04-07,Summer,2012,Apr,16,0,Saturday,0,Clear,0.54,0.5152,0.19,0.3881,354,261,615,268,615,615
10982,2012-04-07,Summer,2012,Apr,17,0,Saturday,0,Clear,0.54,0.5152,0.19,0.4179,299,268,567,268,567,567
10983,2012-04-07,Summer,2012,Apr,18,0,Saturday,0,Clear,0.54,0.5152,0.18,0.2985,227,290,517,268,517,517
10984,2012-04-07,Summer,2012,Apr,19,0,Saturday,0,Clear,0.54,0.5152,0.16,0.3284,170,243,413,268,413,413
10985,2012-04-07,Summer,2012,Apr,20,0,Saturday,0,Clear,0.5,0.4848,0.2,0.2239,73,135,208,268,208,208
10986,2012-04-07,Summer,2012,Apr,21,0,Saturday,0,Clear,0.5,0.4848,0.2,0.194,75,159,234,268,234,234
10987,2012-04-07,Summer,2012,Apr,22,0,Saturday,0,Clear,0.48,0.4697,0.2,0.194,76,106,182,268,182,182
10988,2012-04-07,Summer,2012,Apr,23,0,Saturday,0,Clear,0.46,0.4545,0.23,0.2239,32,86,118,268,118,118
10989,2012-04-08,Summer,2012,Apr,0,0,Sunday,0,Clear,0.44,0.4394,0.24,0.2239,21,64,85,267,85,85
10990,2012-04-08,Summer,2012,Apr,1,0,Sunday,0,Clear,0.44,0.4394,0.24,0.2239,14,50,64,267,64,64
10991,2012-04-08,Summer,2012,Apr,2,0,Sunday,0,Clear,0.44,0.4394,0.24,0.2239,7,25,32,267,32,32
10992,2012-04-08,Summer,2012,Apr,3,0,Sunday,0,Clear,0.42,0.4242,0.26,0.1343,8,18,26,267,26,26
10993,2012-04-08,Summer,2012,Apr,4,0,Sunday,0,Clear,0.4,0.4091,0.4,0.0,0,7,7,267,7,7
10994,2012-04-08,Summer,2012,Apr,5,0,Sunday,0,Clear,0.38,0.3939,0.46,0.0,4,8,12,267,12,12
10995,2012-04-08,Summer,2012,Apr,6,0,Sunday,0,Clear,0.36,0.3788,0.37,0.0,7,21,28,267,28,28
10996,2012-04-08,Summer,2012,Apr,7,0,Sunday,0,Clear,0.38,0.3939,0.27,0.1642,12,25,37,267,37,37
10997,2012-04-08,Summer,2012,Apr,8,0,Sunday,0,Clear,0.4,0.4091,0.3,0.194,19,65,84,267,84,84
10998,2012-04-08,Summer,2012,Apr,9,0,Sunday,0,Clear,0.44,0.4394,0.26,0.2239,71,108,179,267,179,179
10999,2012-04-08,Summer,2012,Apr,10,0,Sunday,0,Clear,0.5,0.4848,0.25,0.2239,113,186,299,267,299,299
11000,2012-04-08,Summer,2012,Apr,11,0,Sunday,0,Clear,0.5,0.4848,0.25,0.2836,195,209,404,267,404,404
11001,2012-04-08,Summer,2012,Apr,12,0,Sunday,0,Clear,0.54,0.5152,0.24,0.2537,198,259,457,267,457,457
11002,2012-04-08,Summer,2012,Apr,13,0,Sunday,0,Clear,0.58,0.5455,0.23,0.1642,229,254,483,267,483,483
11003,2012-04-08,Summer,2012,Apr,14,0,Sunday,0,Clear,0.6,0.5909,0.18,0.4478,254,249,503,267,503,503
11004,2012-04-08,Summer,2012,Apr,15,0,Sunday,0,Clear,0.62,0.6061,0.17,0.3582,260,226,486,267,486,486
11005,2012-04-08,Summer,2012,Apr,16,0,Sunday,0,Clear,0.64,0.6061,0.19,0.3284,232,244,476,267,476,476
11006,2012-04-08,Summer,2012,Apr,17,0,Sunday,0,Clear,0.62,0.6061,0.22,0.2985,185,226,411,267,411,411
11007,2012-04-08,Summer,2012,Apr,18,0,Sunday,0,Clear,0.62,0.6061,0.25,0.3284,151,159,310,267,310,310
11008,2012-04-08,Summer,2012,Apr,19,0,Sunday,0,Clear,0.6,0.6061,0.23,0.3881,89,187,276,267,276,276
11009,2012-04-08,Summer,2012,Apr,20,0,Sunday,0,Clear,0.56,0.5303,0.28,0.4179,65,146,211,267,211,211
11010,2012-04-08,Summer,2012,Apr,21,0,Sunday,0,Clear,0.52,0.5,0.34,0.2239,53,77,130,267,130,130
11011,2012-04-08,Summer,2012,Apr,22,0,Sunday,0,Clear,0.5,0.4848,0.36,0.2239,33,85,118,267,118,118
11012,2012-04-08,Summer,2012,Apr,23,0,Sunday,0,Clear,0.5,0.4848,0.39,0.2537,10,41,51,267,51,51
11013,2012-04-09,Summer,2012,Apr,0,0,Monday,1,Clear,0.48,0.4697,0.39,0.2836,8,29,37,266,37,37
11014,2012-04-09,Summer,2012,Apr,1,0,Monday,1,Clear,0.46,0.4545,0.41,0.1343,4,12,16,266,16,16
11015,2012-04-09,Summer,2012,Apr,2,0,Monday,1,Clear,0.46,0.4545,0.31,0.194,2,4,6,266,6,6
11016,2012-04-09,Summer,2012,Apr,3,0,Monday,1,Clear,0.44,0.4394,0.3,0.1642,0,3,3,266,3,3
11017,2012-04-09,Summer,2012,Apr,4,0,Monday,1,Clear,0.44,0.4394,0.24,0.194,2,3,5,266,5,5
11018,2012-04-09,Summer,2012,Apr,5,0,Monday,1,Clear,0.44,0.4394,0.24,0.194,2,30,32,266,32,32
11019,2012-04-09,Summer,2012,Apr,6,0,Monday,1,Clear,0.42,0.4242,0.26,0.2239,3,108,111,266,111,111
11020,2012-04-09,Summer,2012,Apr,7,0,Monday,1,Clear,0.42,0.4242,0.28,0.194,11,320,331,266,331,331
11021,2012-04-09,Summer,2012,Apr,8,0,Monday,1,Clear,0.44,0.4394,0.3,0.194,22,595,617,266,617,617
11022,2012-04-09,Summer,2012,Apr,9,0,Monday,1,Clear,0.46,0.4545,0.31,0.3582,50,236,286,266,286,286
11023,2012-04-09,Summer,2012,Apr,10,0,Monday,1,Clear,0.5,0.4848,0.27,0.4925,65,113,178,266,178,178
11024,2012-04-09,Summer,2012,Apr,11,0,Monday,1,Clear,0.52,0.5,0.27,0.4179,96,127,223,266,223,223
11025,2012-04-09,Summer,2012,Apr,12,0,Monday,1,Clear,0.54,0.5152,0.28,0.7164,94,186,280,266,280,280
11026,2012-04-09,Summer,2012,Apr,13,0,Monday,1,Clear,0.54,0.5152,0.28,0.5821,108,173,281,266,281,281
11027,2012-04-09,Summer,2012,Apr,14,0,Monday,1,Clear,0.56,0.5303,0.28,0.5522,66,152,218,266,218,218
11028,2012-04-09,Summer,2012,Apr,15,0,Monday,1,Clear,0.58,0.5455,0.28,0.5522,82,173,255,266,255,255
11029,2012-04-09,Summer,2012,Apr,16,0,Monday,1,Clear,0.56,0.5303,0.3,0.4179,81,310,391,266,391,391
11030,2012-04-09,Summer,2012,Apr,17,0,Monday,1,Clear,0.54,0.5152,0.32,0.4179,67,565,632,266,632,632
11031,2012-04-09,Summer,2012,Apr,18,0,Monday,1,Clear,0.54,0.5152,0.34,0.2985,60,586,646,266,646,646
11032,2012-04-09,Summer,2012,Apr,19,0,Monday,1,Clear,0.52,0.5,0.34,0.3582,35,386,421,266,421,421
11033,2012-04-09,Summer,2012,Apr,20,0,Monday,1,Clear,0.5,0.4848,0.36,0.4478,21,255,276,266,276,276
11034,2012-04-09,Summer,2012,Apr,21,0,Monday,1,Light_rainsnow,0.48,0.4697,0.41,0.4179,14,151,165,266,165,165
11035,2012-04-09,Summer,2012,Apr,22,0,Monday,1,Misty,0.46,0.4545,0.41,0.4925,6,102,108,266,108,108
11036,2012-04-09,Summer,2012,Apr,23,0,Monday,1,Clear,0.44,0.4394,0.44,0.2985,6,61,67,266,67,67
11037,2012-04-10,Summer,2012,Apr,0,0,Tuesday,1,Misty,0.44,0.4394,0.47,0.2836,3,23,26,265,26,26
11038,2012-04-10,Summer,2012,Apr,1,0,Tuesday,1,Clear,0.42,0.4242,0.5,0.2239,0,9,9,265,9,9
11039,2012-04-10,Summer,2012,Apr,2,0,Tuesday,1,Clear,0.36,0.3485,0.71,0.1343,0,2,2,265,2,2
11040,2012-04-10,Summer,2012,Apr,3,0,Tuesday,1,Clear,0.36,0.3485,0.71,0.1343,0,2,2,265,2,2
11041,2012-04-10,Summer,2012,Apr,4,0,Tuesday,1,Clear,0.34,0.3333,0.71,0.1343,0,2,2,265,2,2
11042,2012-04-10,Summer,2012,Apr,5,0,Tuesday,1,Clear,0.34,0.3333,0.71,0.1343,0,24,24,265,24,24
11043,2012-04-10,Summer,2012,Apr,6,0,Tuesday,1,Clear,0.34,0.3485,0.71,0.1045,3,100,103,265,103,103
11044,2012-04-10,Summer,2012,Apr,7,0,Tuesday,1,Clear,0.34,0.3485,0.71,0.1045,16,368,384,265,384,384
11045,2012-04-10,Summer,2012,Apr,8,0,Tuesday,1,Clear,0.38,0.3939,0.62,0.1343,22,670,692,265,692,692
11046,2012-04-10,Summer,2012,Apr,9,0,Tuesday,1,Clear,0.42,0.4242,0.67,0.194,16,303,319,265,319,319
11047,2012-04-10,Summer,2012,Apr,10,0,Tuesday,1,Clear,0.46,0.4545,0.47,0.1642,49,132,181,265,181,181
11048,2012-04-10,Summer,2012,Apr,11,0,Tuesday,1,Clear,0.5,0.4848,0.36,0.0,78,161,239,265,239,239
11049,2012-04-10,Summer,2012,Apr,12,0,Tuesday,1,Clear,0.54,0.5152,0.22,0.2836,75,184,259,265,259,259
11050,2012-04-10,Summer,2012,Apr,13,0,Tuesday,1,Clear,0.52,0.5,0.23,0.1642,81,202,283,265,283,283
11051,2012-04-10,Summer,2012,Apr,14,0,Tuesday,1,Clear,0.54,0.5152,0.24,0.194,75,149,224,265,224,224
11052,2012-04-10,Summer,2012,Apr,15,0,Tuesday,1,Clear,0.56,0.5303,0.21,0.2985,46,157,203,265,203,203
11053,2012-04-10,Summer,2012,Apr,16,0,Tuesday,1,Clear,0.58,0.5455,0.21,0.2537,66,296,362,265,362,362
11054,2012-04-10,Summer,2012,Apr,17,0,Tuesday,1,Clear,0.56,0.5303,0.21,0.5224,88,656,744,265,744,744
11055,2012-04-10,Summer,2012,Apr,18,0,Tuesday,1,Clear,0.54,0.5152,0.22,0.4179,78,626,704,265,704,704
11056,2012-04-10,Summer,2012,Apr,19,0,Tuesday,1,Clear,0.52,0.5,0.2,0.3582,51,428,479,265,479,479
11057,2012-04-10,Summer,2012,Apr,20,0,Tuesday,1,Clear,0.46,0.4545,0.28,0.3881,34,248,282,265,282,282
11058,2012-04-10,Summer,2012,Apr,21,0,Tuesday,1,Clear,0.44,0.4394,0.3,0.4478,15,191,206,265,206,206
11059,2012-04-10,Summer,2012,Apr,22,0,Tuesday,1,Clear,0.4,0.4091,0.37,0.4925,9,118,127,265,127,127
11060,2012-04-10,Summer,2012,Apr,23,0,Tuesday,1,Clear,0.36,0.3333,0.4,0.4179,14,48,62,265,62,62
11061,2012-04-11,Summer,2012,Apr,0,0,Wednesday,1,Clear,0.34,0.303,0.36,0.4179,8,22,30,264,30,30
11062,2012-04-11,Summer,2012,Apr,1,0,Wednesday,1,Clear,0.34,0.3182,0.39,0.2836,3,9,12,264,12,12
11063,2012-04-11,Summer,2012,Apr,2,0,Wednesday,1,Clear,0.32,0.303,0.45,0.2836,0,2,2,264,2,2
11064,2012-04-11,Summer,2012,Apr,3,0,Wednesday,1,Clear,0.3,0.2879,0.49,0.2239,0,2,2,264,2,2
11065,2012-04-11,Summer,2012,Apr,5,0,Wednesday,1,Clear,0.28,0.2727,0.56,0.194,1,26,27,264,27,27
11066,2012-04-11,Summer,2012,Apr,6,0,Wednesday,1,Clear,0.28,0.2879,0.56,0.1045,3,103,106,264,106,106
11067,2012-04-11,Summer,2012,Apr,7,0,Wednesday,1,Clear,0.28,0.2879,0.52,0.1343,18,303,321,264,321,321
11068,2012-04-11,Summer,2012,Apr,8,0,Wednesday,1,Clear,0.3,0.2879,0.49,0.2239,14,581,595,264,595,595
11069,2012-04-11,Summer,2012,Apr,9,0,Wednesday,1,Misty,0.32,0.303,0.49,0.2985,20,282,302,264,302,302
11070,2012-04-11,Summer,2012,Apr,10,0,Wednesday,1,Misty,0.34,0.303,0.49,0.3284,26,127,153,264,153,153
11071,2012-04-11,Summer,2012,Apr,11,0,Wednesday,1,Misty,0.38,0.3939,0.43,0.3284,38,142,180,264,180,180
11072,2012-04-11,Summer,2012,Apr,12,0,Wednesday,1,Misty,0.36,0.3333,0.46,0.3881,35,147,182,264,182,182
11073,2012-04-11,Summer,2012,Apr,13,0,Wednesday,1,Misty,0.4,0.4091,0.4,0.3582,16,147,163,264,163,163
11074,2012-04-11,Summer,2012,Apr,14,0,Wednesday,1,Clear,0.36,0.3485,0.57,0.194,34,101,135,264,135,135
11075,2012-04-11,Summer,2012,Apr,15,0,Wednesday,1,Light_rainsnow,0.38,0.3939,0.46,0.2239,50,152,202,264,202,202
11076,2012-04-11,Summer,2012,Apr,16,0,Wednesday,1,Clear,0.44,0.4394,0.33,0.2985,51,256,307,264,307,307
11077,2012-04-11,Summer,2012,Apr,17,0,Wednesday,1,Clear,0.42,0.4242,0.35,0.3881,52,527,579,264,579,579
11078,2012-04-11,Summer,2012,Apr,18,0,Wednesday,1,Light_rainsnow,0.4,0.4091,0.43,0.4179,39,546,585,264,585,585
11079,2012-04-11,Summer,2012,Apr,19,0,Wednesday,1,Clear,0.4,0.4091,0.4,0.3582,28,356,384,264,384,384
11080,2012-04-11,Summer,2012,Apr,20,0,Wednesday,1,Clear,0.36,0.3333,0.46,0.3284,22,213,235,264,235,235
11081,2012-04-11,Summer,2012,Apr,21,0,Wednesday,1,Clear,0.34,0.303,0.57,0.3881,11,154,165,264,165,165
11082,2012-04-11,Summer,2012,Apr,22,0,Wednesday,1,Clear,0.34,0.303,0.57,0.3284,4,130,134,264,134,134
11083,2012-04-11,Summer,2012,Apr,23,0,Wednesday,1,Clear,0.34,0.303,0.57,0.2985,9,52,61,264,61,61
11084,2012-04-12,Summer,2012,Apr,0,0,Thursday,1,Clear,0.32,0.303,0.66,0.2836,1,22,23,263,23,23
11085,2012-04-12,Summer,2012,Apr,1,0,Thursday,1,Clear,0.32,0.303,0.66,0.2239,2,7,9,263,9,9
11086,2012-04-12,Summer,2012,Apr,2,0,Thursday,1,Clear,0.32,0.303,0.61,0.2836,0,4,4,263,4,4
11087,2012-04-12,Summer,2012,Apr,3,0,Thursday,1,Clear,0.32,0.303,0.61,0.2537,2,3,5,263,5,5
11088,2012-04-12,Summer,2012,Apr,4,0,Thursday,1,Clear,0.3,0.2879,0.61,0.2239,0,1,1,263,1,1
11089,2012-04-12,Summer,2012,Apr,5,0,Thursday,1,Clear,0.3,0.2879,0.61,0.2239,0,21,21,263,21,21
11090,2012-04-12,Summer,2012,Apr,6,0,Thursday,1,Clear,0.3,0.2879,0.65,0.2537,2,94,96,263,96,96
11091,2012-04-12,Summer,2012,Apr,7,0,Thursday,1,Clear,0.3,0.2727,0.65,0.3284,12,294,306,263,306,306
11092,2012-04-12,Summer,2012,Apr,8,0,Thursday,1,Clear,0.32,0.303,0.66,0.3284,20,604,624,263,624,624
11093,2012-04-12,Summer,2012,Apr,9,0,Thursday,1,Clear,0.36,0.3333,0.57,0.3582,16,271,287,263,287,287
11094,2012-04-12,Summer,2012,Apr,10,0,Thursday,1,Clear,0.4,0.4091,0.5,0.2985,38,103,141,263,141,141
11095,2012-04-12,Summer,2012,Apr,11,0,Thursday,1,Clear,0.42,0.4242,0.47,0.2985,50,174,224,263,224,224
11096,2012-04-12,Summer,2012,Apr,12,0,Thursday,1,Clear,0.46,0.4545,0.41,0.4478,60,199,259,263,259,259
11097,2012-04-12,Summer,2012,Apr,13,0,Thursday,1,Clear,0.48,0.4697,0.36,0.4478,55,148,203,263,203,203
11098,2012-04-12,Summer,2012,Apr,14,0,Thursday,1,Clear,0.5,0.4848,0.31,0.3284,74,150,224,263,224,224
11099,2012-04-12,Summer,2012,Apr,15,0,Thursday,1,Clear,0.48,0.4697,0.31,0.2537,42,169,211,263,211,211
11100,2012-04-12,Summer,2012,Apr,16,0,Thursday,1,Clear,0.48,0.4697,0.31,0.2836,54,299,353,263,353,353
11101,2012-04-12,Summer,2012,Apr,17,0,Thursday,1,Clear,0.5,0.4848,0.27,0.3881,60,596,656,263,656,656
11102,2012-04-12,Summer,2012,Apr,18,0,Thursday,1,Clear,0.5,0.4848,0.27,0.3881,63,547,610,263,610,610
11103,2012-04-12,Summer,2012,Apr,19,0,Thursday,1,Clear,0.46,0.4545,0.31,0.2985,50,383,433,263,433,433
11104,2012-04-12,Summer,2012,Apr,20,0,Thursday,1,Clear,0.44,0.4394,0.33,0.2537,26,254,280,263,280,280
11105,2012-04-12,Summer,2012,Apr,21,0,Thursday,1,Clear,0.42,0.4242,0.35,0.1343,13,174,187,263,187,187
11106,2012-04-12,Summer,2012,Apr,22,0,Thursday,1,Clear,0.42,0.4242,0.35,0.194,15,143,158,263,158,158
11107,2012-04-12,Summer,2012,Apr,23,0,Thursday,1,Clear,0.42,0.4242,0.35,0.194,8,86,94,263,94,94
11108,2012-04-13,Summer,2012,Apr,0,0,Friday,1,Clear,0.4,0.4091,0.37,0.2537,14,41,55,262,55,55
11109,2012-04-13,Summer,2012,Apr,1,0,Friday,1,Clear,0.36,0.3485,0.46,0.194,2,28,30,262,30,30
11110,2012-04-13,Summer,2012,Apr,2,0,Friday,1,Clear,0.34,0.3333,0.49,0.194,6,5,11,262,11,11
11111,2012-04-13,Summer,2012,Apr,3,0,Friday,1,Clear,0.34,0.3333,0.61,0.1642,3,8,11,262,11,11
11112,2012-04-13,Summer,2012,Apr,4,0,Friday,1,Misty,0.34,0.3333,0.53,0.1343,1,4,5,262,5,5
11113,2012-04-13,Summer,2012,Apr,5,0,Friday,1,Misty,0.34,0.3333,0.53,0.1642,2,19,21,262,21,21
11114,2012-04-13,Summer,2012,Apr,6,0,Friday,1,Clear,0.32,0.3182,0.57,0.1642,0,84,84,262,84,84
11115,2012-04-13,Summer,2012,Apr,7,0,Friday,1,Clear,0.34,0.3182,0.61,0.2239,13,283,296,262,296,296
11116,2012-04-13,Summer,2012,Apr,8,0,Friday,1,Clear,0.38,0.3939,0.46,0.1642,24,539,563,262,563,563
11117,2012-04-13,Summer,2012,Apr,9,0,Friday,1,Clear,0.42,0.4242,0.41,0.1642,36,294,330,262,330,330
11118,2012-04-13,Summer,2012,Apr,10,0,Friday,1,Clear,0.44,0.4394,0.38,0.194,59,133,192,262,192,192
11119,2012-04-13,Summer,2012,Apr,11,0,Friday,1,Clear,0.46,0.4545,0.36,0.1343,75,158,233,262,233,233
11120,2012-04-13,Summer,2012,Apr,12,0,Friday,1,Clear,0.5,0.4848,0.31,0.0,104,218,322,262,322,322
11121,2012-04-13,Summer,2012,Apr,13,0,Friday,1,Clear,0.52,0.5,0.27,0.2836,112,246,358,262,358,358
11122,2012-04-13,Summer,2012,Apr,14,0,Friday,1,Clear,0.52,0.5,0.27,0.0,125,223,348,262,348,348
11123,2012-04-13,Summer,2012,Apr,15,0,Friday,1,Clear,0.54,0.5152,0.28,0.2537,115,237,352,262,352,352
11124,2012-04-13,Summer,2012,Apr,16,0,Friday,1,Clear,0.56,0.5303,0.26,0.2537,113,350,463,262,463,463
11125,2012-04-13,Summer,2012,Apr,17,0,Friday,1,Clear,0.56,0.5303,0.24,0.1642,117,621,738,262,738,738
11126,2012-04-13,Summer,2012,Apr,18,0,Friday,1,Clear,0.54,0.5152,0.26,0.1343,107,564,671,262,671,671
11127,2012-04-13,Summer,2012,Apr,19,0,Friday,1,Clear,0.54,0.5152,0.24,0.1642,75,352,427,262,427,427
11128,2012-04-13,Summer,2012,Apr,20,0,Friday,1,Clear,0.5,0.4848,0.29,0.1343,44,242,286,262,286,286
11129,2012-04-13,Summer,2012,Apr,21,0,Friday,1,Clear,0.5,0.4848,0.36,0.0,36,153,189,262,189,189
11130,2012-04-13,Summer,2012,Apr,22,0,Friday,1,Clear,0.44,0.4394,0.62,0.1045,34,181,215,262,215,215
11131,2012-04-13,Summer,2012,Apr,23,0,Friday,1,Clear,0.42,0.4242,0.62,0.0896,35,163,198,262,198,198
11132,2012-04-14,Summer,2012,Apr,0,0,Saturday,0,Clear,0.4,0.4091,0.58,0.1343,11,85,96,261,96,96
11133,2012-04-14,Summer,2012,Apr,1,0,Saturday,0,Clear,0.4,0.4091,0.58,0.1343,10,60,70,261,70,70
11134,2012-04-14,Summer,2012,Apr,2,0,Saturday,0,Clear,0.38,0.3939,0.66,0.1343,3,53,56,261,56,56
11135,2012-04-14,Summer,2012,Apr,3,0,Saturday,0,Clear,0.36,0.3636,0.66,0.0896,6,26,32,261,32,32
11136,2012-04-14,Summer,2012,Apr,4,0,Saturday,0,Clear,0.36,0.3636,0.71,0.1045,5,9,14,261,14,14
11137,2012-04-14,Summer,2012,Apr,5,0,Saturday,0,Clear,0.36,0.3636,0.66,0.1045,2,5,7,261,7,7
11138,2012-04-14,Summer,2012,Apr,6,0,Saturday,0,Clear,0.34,0.3333,0.76,0.1642,2,19,21,261,21,21
11139,2012-04-14,Summer,2012,Apr,7,0,Saturday,0,Clear,0.36,0.3636,0.71,0.1045,8,56,64,261,64,64
11140,2012-04-14,Summer,2012,Apr,8,0,Saturday,0,Clear,0.36,0.3485,0.71,0.1343,24,136,160,261,160,160
11141,2012-04-14,Summer,2012,Apr,9,0,Saturday,0,Clear,0.42,0.4242,0.54,0.1343,59,206,265,261,265,265
11142,2012-04-14,Summer,2012,Apr,10,0,Saturday,0,Clear,0.46,0.4545,0.51,0.1642,139,267,406,261,406,406
11143,2012-04-14,Summer,2012,Apr,11,0,Saturday,0,Clear,0.52,0.5,0.45,0.194,207,357,564,261,564,564
11144,2012-04-14,Summer,2012,Apr,12,0,Saturday,0,Clear,0.58,0.5455,0.35,0.2537,274,404,678,261,678,678
11145,2012-04-14,Summer,2012,Apr,13,0,Saturday,0,Clear,0.62,0.6212,0.33,0.2985,308,370,678,261,678,678
11146,2012-04-14,Summer,2012,Apr,14,0,Saturday,0,Misty,0.64,0.6212,0.27,0.4478,288,372,660,261,660,660
11147,2012-04-14,Summer,2012,Apr,15,0,Saturday,0,Misty,0.64,0.6212,0.27,0.3582,311,347,658,261,658,658
11148,2012-04-14,Summer,2012,Apr,16,0,Saturday,0,Misty,0.64,0.6212,0.27,0.3582,253,329,582,261,582,582
11149,2012-04-14,Summer,2012,Apr,17,0,Saturday,0,Misty,0.62,0.6212,0.33,0.2537,251,309,560,261,560,560
11150,2012-04-14,Summer,2012,Apr,18,0,Saturday,0,Misty,0.62,0.6212,0.35,0.2239,197,284,481,261,481,481
11151,2012-04-14,Summer,2012,Apr,19,0,Saturday,0,Misty,0.6,0.6212,0.4,0.1642,163,296,459,261,459,459
11152,2012-04-14,Summer,2012,Apr,20,0,Saturday,0,Misty,0.56,0.5303,0.46,0.1343,112,209,321,261,321,321
11153,2012-04-14,Summer,2012,Apr,21,0,Saturday,0,Misty,0.56,0.5303,0.43,0.1343,53,167,220,261,220,220
11154,2012-04-14,Summer,2012,Apr,22,0,Saturday,0,Misty,0.54,0.5152,0.52,0.1642,64,148,212,261,212,212
11155,2012-04-14,Summer,2012,Apr,23,0,Saturday,0,Misty,0.54,0.5152,0.56,0.194,45,151,196,261,196,196
11156,2012-04-15,Summer,2012,Apr,0,0,Sunday,0,Misty,0.54,0.5152,0.56,0.194,30,94,124,260,124,124
11157,2012-04-15,Summer,2012,Apr,1,0,Sunday,0,Misty,0.54,0.5152,0.56,0.1642,17,89,106,260,106,106
11158,2012-04-15,Summer,2012,Apr,2,0,Sunday,0,Misty,0.54,0.5152,0.56,0.1045,20,54,74,260,74,74
11159,2012-04-15,Summer,2012,Apr,3,0,Sunday,0,Misty,0.52,0.5,0.59,0.1343,18,27,45,260,45,45
11160,2012-04-15,Summer,2012,Apr,4,0,Sunday,0,Misty,0.54,0.5152,0.52,0.0,2,10,12,260,12,12
11161,2012-04-15,Summer,2012,Apr,5,0,Sunday,0,Clear,0.5,0.4848,0.68,0.1642,4,6,10,260,10,10
11162,2012-04-15,Summer,2012,Apr,6,0,Sunday,0,Clear,0.5,0.4848,0.63,0.1343,5,11,16,260,16,16
11163,2012-04-15,Summer,2012,Apr,7,0,Sunday,0,Clear,0.5,0.4848,0.63,0.1045,16,30,46,260,46,46
11164,2012-04-15,Summer,2012,Apr,8,0,Sunday,0,Clear,0.52,0.5,0.59,0.0,33,64,97,260,97,97
11165,2012-04-15,Summer,2012,Apr,9,0,Sunday,0,Clear,0.54,0.5152,0.56,0.2239,97,154,251,260,251,251
11166,2012-04-15,Summer,2012,Apr,10,0,Sunday,0,Clear,0.58,0.5455,0.53,0.2239,186,235,421,260,421,421
11167,2012-04-15,Summer,2012,Apr,11,0,Sunday,0,Clear,0.62,0.6212,0.46,0.2985,227,301,528,260,528,528
11168,2012-04-15,Summer,2012,Apr,12,0,Sunday,0,Clear,0.64,0.6212,0.44,0.2836,275,360,635,260,635,635
11169,2012-04-15,Summer,2012,Apr,13,0,Sunday,0,Clear,0.66,0.6212,0.44,0.2836,298,383,681,260,681,681
11170,2012-04-15,Summer,2012,Apr,14,0,Sunday,0,Clear,0.7,0.6364,0.39,0.2836,282,346,628,260,628,628
11171,2012-04-15,Summer,2012,Apr,15,0,Sunday,0,Clear,0.7,0.6364,0.39,0.3881,266,351,617,260,617,617
11172,2012-04-15,Summer,2012,Apr,16,0,Sunday,0,Clear,0.72,0.6515,0.39,0.3582,286,330,616,260,616,616
11173,2012-04-15,Summer,2012,Apr,17,0,Sunday,0,Clear,0.7,0.6364,0.42,0.3284,262,361,623,260,623,623
11174,2012-04-15,Summer,2012,Apr,18,0,Sunday,0,Clear,0.7,0.6364,0.42,0.2537,184,295,479,260,479,479
11175,2012-04-15,Summer,2012,Apr,19,0,Sunday,0,Clear,0.7,0.6364,0.42,0.2537,114,265,379,260,379,379
11176,2012-04-15,Summer,2012,Apr,20,0,Sunday,0,Clear,0.64,0.6212,0.5,0.2239,86,205,291,260,291,291
11177,2012-04-15,Summer,2012,Apr,21,0,Sunday,0,Clear,0.62,0.6212,0.57,0.2537,76,153,229,260,229,229
11178,2012-04-15,Summer,2012,Apr,22,0,Sunday,0,Clear,0.68,0.6364,0.44,0.3582,37,97,134,260,134,134
11179,2012-04-15,Summer,2012,Apr,23,0,Sunday,0,Clear,0.66,0.6212,0.5,0.3881,25,65,90,260,90,90
11180,2012-04-16,Summer,2012,Apr,0,1,Monday,0,Clear,0.64,0.6212,0.53,0.3284,15,26,41,259,41,41
11181,2012-04-16,Summer,2012,Apr,1,1,Monday,0,Clear,0.62,0.6061,0.61,0.3582,7,21,28,259,28,28
11182,2012-04-16,Summer,2012,Apr,2,1,Monday,0,Clear,0.6,0.6061,0.64,0.2537,5,9,14,259,14,14
11183,2012-04-16,Summer,2012,Apr,3,1,Monday,0,Clear,0.58,0.5455,0.68,0.194,3,5,8,259,8,8
11184,2012-04-16,Summer,2012,Apr,4,1,Monday,0,Clear,0.54,0.5152,0.77,0.2239,0,6,6,259,6,6
11185,2012-04-16,Summer,2012,Apr,5,1,Monday,0,Clear,0.54,0.5152,0.77,0.2239,4,34,38,259,38,38
11186,2012-04-16,Summer,2012,Apr,6,1,Monday,0,Clear,0.52,0.5,0.83,0.1642,10,123,133,259,133,133
11187,2012-04-16,Summer,2012,Apr,7,1,Monday,0,Clear,0.52,0.5,0.83,0.1343,20,367,387,259,387,387
11188,2012-04-16,Summer,2012,Apr,8,1,Monday,0,Misty,0.56,0.5303,0.83,0.1642,48,549,597,259,597,597
11189,2012-04-16,Summer,2012,Apr,9,1,Monday,0,Clear,0.62,0.6061,0.69,0.2239,59,238,297,259,297,297
11190,2012-04-16,Summer,2012,Apr,10,1,Monday,0,Clear,0.62,0.6061,0.69,0.2537,75,149,224,259,224,224
11191,2012-04-16,Summer,2012,Apr,11,1,Monday,0,Clear,0.64,0.6061,0.65,0.2537,115,136,251,259,251,251
11192,2012-04-16,Summer,2012,Apr,12,1,Monday,0,Clear,0.68,0.6364,0.57,0.2537,75,196,271,259,271,271
11193,2012-04-16,Summer,2012,Apr,13,1,Monday,0,Clear,0.74,0.6667,0.45,0.2985,79,184,263,259,263,263
11194,2012-04-16,Summer,2012,Apr,14,1,Monday,0,Clear,0.76,0.6818,0.45,0.3284,105,183,288,259,288,288
11195,2012-04-16,Summer,2012,Apr,15,1,Monday,0,Clear,0.8,0.697,0.33,0.4478,81,194,275,259,275,275
11196,2012-04-16,Summer,2012,Apr,16,1,Monday,0,Clear,0.8,0.697,0.33,0.4627,92,266,358,259,358,358
11197,2012-04-16,Summer,2012,Apr,17,1,Monday,0,Clear,0.8,0.697,0.33,0.3881,111,601,712,259,712,712
11198,2012-04-16,Summer,2012,Apr,18,1,Monday,0,Clear,0.8,0.697,0.31,0.3881,87,589,676,259,676,676
11199,2012-04-16,Summer,2012,Apr,19,1,Monday,0,Clear,0.76,0.6667,0.35,0.3881,61,461,522,259,522,522
11200,2012-04-16,Summer,2012,Apr,20,1,Monday,0,Clear,0.74,0.6515,0.37,0.2985,48,327,375,259,375,375
11201,2012-04-16,Summer,2012,Apr,21,1,Monday,0,Clear,0.68,0.6364,0.51,0.2537,39,232,271,259,271,271
11202,2012-04-16,Summer,2012,Apr,22,1,Monday,0,Clear,0.68,0.6364,0.51,0.2537,35,179,214,259,214,214
11203,2012-04-16,Summer,2012,Apr,23,1,Monday,0,Clear,0.7,0.6364,0.45,0.2985,24,97,121,259,121,121
11204,2012-04-17,Summer,2012,Apr,0,0,Tuesday,1,Clear,0.66,0.6212,0.54,0.194,10,33,43,258,43,43
11205,2012-04-17,Summer,2012,Apr,1,0,Tuesday,1,Clear,0.64,0.6212,0.57,0.1642,6,5,11,258,11,11
11206,2012-04-17,Summer,2012,Apr,2,0,Tuesday,1,Clear,0.56,0.5303,0.83,0.1045,1,3,4,258,4,4
11207,2012-04-17,Summer,2012,Apr,3,0,Tuesday,1,Clear,0.56,0.5303,0.83,0.0896,0,6,6,258,6,6
11208,2012-04-17,Summer,2012,Apr,4,0,Tuesday,1,Clear,0.66,0.6212,0.44,0.2239,3,6,9,258,9,9
11209,2012-04-17,Summer,2012,Apr,5,0,Tuesday,1,Clear,0.6,0.6212,0.53,0.2537,1,29,30,258,30,30
11210,2012-04-17,Summer,2012,Apr,6,0,Tuesday,1,Clear,0.6,0.6212,0.46,0.2537,8,136,144,258,144,144
11211,2012-04-17,Summer,2012,Apr,7,0,Tuesday,1,Clear,0.6,0.6212,0.43,0.2537,18,443,461,258,461,461
11212,2012-04-17,Summer,2012,Apr,8,0,Tuesday,1,Clear,0.6,0.6212,0.43,0.2239,42,631,673,258,673,673
11213,2012-04-17,Summer,2012,Apr,9,0,Tuesday,1,Clear,0.6,0.6212,0.38,0.4925,71,329,400,258,400,400
11214,2012-04-17,Summer,2012,Apr,10,0,Tuesday,1,Clear,0.6,0.6212,0.38,0.4179,52,165,217,258,217,217
11215,2012-04-17,Summer,2012,Apr,11,0,Tuesday,1,Clear,0.6,0.6212,0.33,0.4179,65,174,239,258,239,239
11216,2012-04-17,Summer,2012,Apr,12,0,Tuesday,1,Clear,0.6,0.6212,0.33,0.3582,65,179,244,258,244,244
11217,2012-04-17,Summer,2012,Apr,13,0,Tuesday,1,Clear,0.62,0.6212,0.29,0.2537,52,187,239,258,239,239
11218,2012-04-17,Summer,2012,Apr,14,0,Tuesday,1,Clear,0.64,0.6212,0.27,0.2836,59,198,257,258,257,257
11219,2012-04-17,Summer,2012,Apr,15,0,Tuesday,1,Clear,0.66,0.6212,0.24,0.3284,91,217,308,258,308,308
11220,2012-04-17,Summer,2012,Apr,16,0,Tuesday,1,Clear,0.68,0.6212,0.22,0.3582,50,320,370,258,370,370
11221,2012-04-17,Summer,2012,Apr,17,0,Tuesday,1,Clear,0.64,0.6061,0.25,0.2985,108,673,781,258,781,781
11222,2012-04-17,Summer,2012,Apr,18,0,Tuesday,1,Clear,0.64,0.6061,0.25,0.2836,105,670,775,258,775,775
11223,2012-04-17,Summer,2012,Apr,19,0,Tuesday,1,Clear,0.6,0.6061,0.26,0.2537,73,464,537,258,537,537
11224,2012-04-17,Summer,2012,Apr,20,0,Tuesday,1,Clear,0.6,0.6061,0.23,0.2836,44,358,402,258,402,402
11225,2012-04-17,Summer,2012,Apr,21,0,Tuesday,1,Clear,0.56,0.5303,0.26,0.2985,37,260,297,258,297,297
11226,2012-04-17,Summer,2012,Apr,22,0,Tuesday,1,Clear,0.54,0.5152,0.3,0.2537,18,144,162,258,162,162
11227,2012-04-17,Summer,2012,Apr,23,0,Tuesday,1,Clear,0.54,0.5152,0.32,0.2239,10,72,82,258,82,82
11228,2012-04-18,Summer,2012,Apr,0,0,Wednesday,1,Clear,0.54,0.5152,0.32,0.1642,3,35,38,257,38,38
11229,2012-04-18,Summer,2012,Apr,1,0,Wednesday,1,Clear,0.52,0.5,0.34,0.194,1,13,14,257,14,14
11230,2012-04-18,Summer,2012,Apr,2,0,Wednesday,1,Misty,0.5,0.4848,0.42,0.194,1,8,9,257,9,9
11231,2012-04-18,Summer,2012,Apr,3,0,Wednesday,1,Misty,0.5,0.4848,0.42,0.2239,0,6,6,257,6,6
11232,2012-04-18,Summer,2012,Apr,4,0,Wednesday,1,Misty,0.5,0.4848,0.42,0.2836,0,7,7,257,7,7
11233,2012-04-18,Summer,2012,Apr,5,0,Wednesday,1,Misty,0.5,0.4848,0.39,0.2836,0,34,34,257,34,34
11234,2012-04-18,Summer,2012,Apr,6,0,Wednesday,1,Misty,0.5,0.4848,0.39,0.2836,6,128,134,257,134,134
11235,2012-04-18,Summer,2012,Apr,7,0,Wednesday,1,Misty,0.5,0.4848,0.39,0.194,10,408,418,257,418,418
11236,2012-04-18,Summer,2012,Apr,8,0,Wednesday,1,Light_rainsnow,0.5,0.4848,0.39,0.194,25,551,576,257,576,576
11237,2012-04-18,Summer,2012,Apr,9,0,Wednesday,1,Light_rainsnow,0.48,0.4697,0.44,0.2985,20,245,265,257,265,265
11238,2012-04-18,Summer,2012,Apr,10,0,Wednesday,1,Light_rainsnow,0.48,0.4697,0.47,0.2239,31,116,147,257,147,147
11239,2012-04-18,Summer,2012,Apr,11,0,Wednesday,1,Light_rainsnow,0.46,0.4545,0.47,0.2537,14,105,119,257,119,119
11240,2012-04-18,Summer,2012,Apr,12,0,Wednesday,1,Light_rainsnow,0.46,0.4545,0.51,0.1045,15,95,110,257,110,110
11241,2012-04-18,Summer,2012,Apr,13,0,Wednesday,1,Light_rainsnow,0.46,0.4545,0.59,0.0,13,51,64,257,64,64
11242,2012-04-18,Summer,2012,Apr,14,0,Wednesday,1,Light_rainsnow,0.44,0.4394,0.72,0.1045,8,43,51,257,51,51
11243,2012-04-18,Summer,2012,Apr,15,0,Wednesday,1,Light_rainsnow,0.42,0.4242,0.77,0.194,10,88,98,257,98,98
11244,2012-04-18,Summer,2012,Apr,16,0,Wednesday,1,Misty,0.42,0.4242,0.77,0.2239,36,199,235,257,235,235
11245,2012-04-18,Summer,2012,Apr,17,0,Wednesday,1,Misty,0.42,0.4242,0.77,0.194,46,442,488,257,488,488
11246,2012-04-18,Summer,2012,Apr,18,0,Wednesday,1,Misty,0.42,0.4242,0.77,0.0,27,478,505,257,505,505
11247,2012-04-18,Summer,2012,Apr,19,0,Wednesday,1,Misty,0.42,0.4242,0.77,0.1343,26,342,368,257,368,368
11248,2012-04-18,Summer,2012,Apr,20,0,Wednesday,1,Misty,0.42,0.4242,0.77,0.1045,8,252,260,257,260,260
11249,2012-04-18,Summer,2012,Apr,21,0,Wednesday,1,Misty,0.42,0.4242,0.82,0.0896,24,165,189,257,189,189
11250,2012-04-18,Summer,2012,Apr,22,0,Wednesday,1,Misty,0.42,0.4242,0.77,0.0896,9,153,162,257,162,162
11251,2012-04-18,Summer,2012,Apr,23,0,Wednesday,1,Misty,0.42,0.4242,0.77,0.0,14,56,70,257,70,70
11252,2012-04-19,Summer,2012,Apr,0,0,Thursday,1,Light_rainsnow,0.42,0.4242,0.77,0.0,5,20,25,256,25,25
11253,2012-04-19,Summer,2012,Apr,1,0,Thursday,1,Light_rainsnow,0.42,0.4242,0.77,0.1045,2,11,13,256,13,13
11254,2012-04-19,Summer,2012,Apr,2,0,Thursday,1,Misty,0.42,0.4242,0.77,0.0,2,4,6,256,6,6
11255,2012-04-19,Summer,2012,Apr,3,0,Thursday,1,Misty,0.42,0.4242,0.77,0.0,1,3,4,256,4,4
11256,2012-04-19,Summer,2012,Apr,4,0,Thursday,1,Misty,0.42,0.4242,0.71,0.0,0,4,4,256,4,4
11257,2012-04-19,Summer,2012,Apr,5,0,Thursday,1,Clear,0.4,0.4091,0.82,0.0,0,30,30,256,30,30
11258,2012-04-19,Summer,2012,Apr,6,0,Thursday,1,Misty,0.4,0.4091,0.82,0.1045,4,116,120,256,120,120
11259,2012-04-19,Summer,2012,Apr,7,0,Thursday,1,Misty,0.4,0.4091,0.82,0.1343,15,391,406,256,406,406
11260,2012-04-19,Summer,2012,Apr,8,0,Thursday,1,Misty,0.42,0.4242,0.82,0.1045,26,651,677,256,677,677
11261,2012-04-19,Summer,2012,Apr,9,0,Thursday,1,Misty,0.46,0.4545,0.72,0.0,31,270,301,256,301,301
11262,2012-04-19,Summer,2012,Apr,10,0,Thursday,1,Clear,0.48,0.4697,0.63,0.0896,46,143,189,256,189,189
11263,2012-04-19,Summer,2012,Apr,11,0,Thursday,1,Clear,0.52,0.5,0.48,0.0,46,183,229,256,229,229
11264,2012-04-19,Summer,2012,Apr,12,0,Thursday,1,Clear,0.54,0.5152,0.49,0.0,51,213,264,256,264,264
11265,2012-04-19,Summer,2012,Apr,13,0,Thursday,1,Clear,0.56,0.5303,0.46,0.0,52,186,238,256,238,238
11266,2012-04-19,Summer,2012,Apr,14,0,Thursday,1,Clear,0.58,0.5455,0.43,0.0,54,183,237,256,237,237
11267,2012-04-19,Summer,2012,Apr,15,0,Thursday,1,Clear,0.6,0.6212,0.43,0.0,66,196,262,256,262,262
11268,2012-04-19,Summer,2012,Apr,16,0,Thursday,1,Clear,0.62,0.6212,0.41,0.1045,63,324,387,256,387,387
11269,2012-04-19,Summer,2012,Apr,17,0,Thursday,1,Clear,0.6,0.6212,0.43,0.0896,85,663,748,256,748,748
11270,2012-04-19,Summer,2012,Apr,18,0,Thursday,1,Clear,0.6,0.6212,0.43,0.0896,99,677,776,256,776,776
11271,2012-04-19,Summer,2012,Apr,19,0,Thursday,1,Clear,0.58,0.5455,0.46,0.1343,70,516,586,256,586,586
11272,2012-04-19,Summer,2012,Apr,20,0,Thursday,1,Clear,0.56,0.5303,0.49,0.2239,52,352,404,256,404,404
11273,2012-04-19,Summer,2012,Apr,21,0,Thursday,1,Clear,0.52,0.5,0.55,0.1045,27,240,267,256,267,267
11274,2012-04-19,Summer,2012,Apr,22,0,Thursday,1,Clear,0.52,0.5,0.59,0.194,29,219,248,256,248,248
11275,2012-04-19,Summer,2012,Apr,23,0,Thursday,1,Clear,0.5,0.4848,0.63,0.1045,20,124,144,256,144,144
11276,2012-04-20,Summer,2012,Apr,0,0,Friday,1,Clear,0.48,0.4697,0.67,0.1045,5,59,64,255,64,64
11277,2012-04-20,Summer,2012,Apr,1,0,Friday,1,Clear,0.46,0.4545,0.82,0.194,3,22,25,255,25,25
11278,2012-04-20,Summer,2012,Apr,2,0,Friday,1,Clear,0.44,0.4394,0.88,0.194,3,18,21,255,21,21
11279,2012-04-20,Summer,2012,Apr,3,0,Friday,1,Clear,0.44,0.4394,0.88,0.1045,1,9,10,255,10,10
11280,2012-04-20,Summer,2012,Apr,4,0,Friday,1,Clear,0.42,0.4242,0.94,0.1045,0,3,3,255,3,3
11281,2012-04-20,Summer,2012,Apr,5,0,Friday,1,Clear,0.42,0.4242,0.94,0.0,1,24,25,255,25,25
11282,2012-04-20,Summer,2012,Apr,6,0,Friday,1,Clear,0.42,0.4242,0.88,0.0,8,105,113,255,113,113
11283,2012-04-20,Summer,2012,Apr,7,0,Friday,1,Clear,0.42,0.4242,0.94,0.0,9,350,359,255,359,359
11284,2012-04-20,Summer,2012,Apr,8,0,Friday,1,Clear,0.44,0.4394,0.94,0.0,32,668,700,255,700,700
11285,2012-04-20,Summer,2012,Apr,9,0,Friday,1,Clear,0.46,0.4545,0.88,0.0896,30,329,359,255,359,359
11286,2012-04-20,Summer,2012,Apr,10,0,Friday,1,Clear,0.5,0.4848,0.77,0.194,67,170,237,255,237,237
11287,2012-04-20,Summer,2012,Apr,11,0,Friday,1,Clear,0.54,0.5152,0.68,0.1642,64,190,254,255,254,254
11288,2012-04-20,Summer,2012,Apr,12,0,Friday,1,Clear,0.58,0.5455,0.53,0.194,102,260,362,255,362,362
11289,2012-04-20,Summer,2012,Apr,13,0,Friday,1,Clear,0.62,0.6212,0.43,0.194,105,276,381,255,381,381
11290,2012-04-20,Summer,2012,Apr,14,0,Friday,1,Clear,0.64,0.6212,0.44,0.2239,156,238,394,255,394,394
11291,2012-04-20,Summer,2012,Apr,15,0,Friday,1,Clear,0.64,0.6212,0.47,0.194,145,262,407,255,407,407
11292,2012-04-20,Summer,2012,Apr,16,0,Friday,1,Clear,0.66,0.6212,0.44,0.194,151,429,580,255,580,580
11293,2012-04-20,Summer,2012,Apr,17,0,Friday,1,Clear,0.64,0.6212,0.47,0.2836,122,697,819,255,819,819
11294,2012-04-20,Summer,2012,Apr,18,0,Friday,1,Clear,0.62,0.6212,0.5,0.2836,110,558,668,255,668,668
11295,2012-04-20,Summer,2012,Apr,19,0,Friday,1,Clear,0.6,0.6212,0.53,0.194,82,410,492,255,492,492
11296,2012-04-20,Summer,2012,Apr,20,0,Friday,1,Clear,0.58,0.5455,0.56,0.1642,52,289,341,255,341,341
11297,2012-04-20,Summer,2012,Apr,21,0,Friday,1,Clear,0.56,0.5303,0.68,0.1343,35,252,287,255,287,287
11298,2012-04-20,Summer,2012,Apr,22,0,Friday,1,Clear,0.54,0.5152,0.68,0.2537,26,176,202,255,202,202
11299,2012-04-20,Summer,2012,Apr,23,0,Friday,1,Clear,0.52,0.5,0.72,0.1343,31,156,187,255,187,187
11300,2012-04-21,Summer,2012,Apr,0,0,Saturday,0,Clear,0.52,0.5,0.77,0.2239,31,111,142,254,142,142
11301,2012-04-21,Summer,2012,Apr,1,0,Saturday,0,Clear,0.52,0.5,0.77,0.2239,24,64,88,254,88,88
11302,2012-04-21,Summer,2012,Apr,2,0,Saturday,0,Clear,0.52,0.5,0.77,0.1343,12,69,81,254,81,81
11303,2012-04-21,Summer,2012,Apr,3,0,Saturday,0,Clear,0.5,0.4848,0.82,0.2239,4,25,29,254,29,29
11304,2012-04-21,Summer,2012,Apr,4,0,Saturday,0,Clear,0.5,0.4848,0.82,0.2537,0,9,9,254,9,9
11305,2012-04-21,Summer,2012,Apr,5,0,Saturday,0,Clear,0.5,0.4848,0.82,0.2537,0,1,1,254,1,1
11306,2012-04-21,Summer,2012,Apr,6,0,Saturday,0,Clear,0.5,0.4848,0.82,0.2239,10,21,31,254,31,31
11307,2012-04-21,Summer,2012,Apr,7,0,Saturday,0,Clear,0.5,0.4848,0.82,0.2836,21,55,76,254,76,76
11308,2012-04-21,Summer,2012,Apr,8,0,Saturday,0,Clear,0.52,0.5,0.81,0.2537,52,149,201,254,201,201
11309,2012-04-21,Summer,2012,Apr,9,0,Saturday,0,Clear,0.54,0.5152,0.77,0.1642,115,216,331,254,331,331
11310,2012-04-21,Summer,2012,Apr,10,0,Saturday,0,Clear,0.6,0.6061,0.64,0.2836,183,299,482,254,482,482
11311,2012-04-21,Summer,2012,Apr,11,0,Saturday,0,Clear,0.62,0.6061,0.61,0.3284,260,348,608,254,608,608
11312,2012-04-21,Summer,2012,Apr,12,0,Saturday,0,Clear,0.64,0.6212,0.57,0.2239,262,378,640,254,640,640
11313,2012-04-21,Summer,2012,Apr,13,0,Saturday,0,Clear,0.66,0.6212,0.54,0.2239,291,358,649,254,649,649
11314,2012-04-21,Summer,2012,Apr,14,0,Saturday,0,Clear,0.7,0.6364,0.45,0.2836,278,331,609,254,609,609
11315,2012-04-21,Summer,2012,Apr,15,0,Saturday,0,Clear,0.72,0.6515,0.39,0.2537,267,361,628,254,628,628
11316,2012-04-21,Summer,2012,Apr,16,0,Saturday,0,Clear,0.7,0.6364,0.42,0.3284,267,372,639,254,639,639
11317,2012-04-21,Summer,2012,Apr,17,0,Saturday,0,Misty,0.74,0.6515,0.3,0.3881,259,309,568,254,568,568
11318,2012-04-21,Summer,2012,Apr,18,0,Saturday,0,Misty,0.68,0.6364,0.47,0.4925,133,283,416,254,416,416
11319,2012-04-21,Summer,2012,Apr,19,0,Saturday,0,Light_rainsnow,0.56,0.5303,0.73,0.4925,9,45,54,254,54,54
11320,2012-04-21,Summer,2012,Apr,20,0,Saturday,0,Light_rainsnow,0.5,0.4848,0.82,0.2985,5,34,39,254,39,39
11321,2012-04-21,Summer,2012,Apr,21,0,Saturday,0,Light_rainsnow,0.5,0.4848,0.82,0.3881,20,82,102,254,102,102
11322,2012-04-21,Summer,2012,Apr,22,0,Saturday,0,Clear,0.48,0.4697,0.82,0.2985,20,90,110,254,110,110
11323,2012-04-21,Summer,2012,Apr,23,0,Saturday,0,Misty,0.46,0.4545,0.82,0.2836,18,73,91,254,91,91
11324,2012-04-22,Summer,2012,Apr,0,0,Sunday,0,Misty,0.46,0.4545,0.82,0.194,32,85,117,253,117,117
11325,2012-04-22,Summer,2012,Apr,1,0,Sunday,0,Misty,0.46,0.4545,0.82,0.3284,10,63,73,253,73,73
11326,2012-04-22,Summer,2012,Apr,2,0,Sunday,0,Clear,0.46,0.4545,0.72,0.2836,7,49,56,253,56,56
11327,2012-04-22,Summer,2012,Apr,3,0,Sunday,0,Misty,0.44,0.4394,0.82,0.1642,7,33,40,253,40,40
11328,2012-04-22,Summer,2012,Apr,4,0,Sunday,0,Misty,0.44,0.4394,0.77,0.1642,0,7,7,253,7,7
11329,2012-04-22,Summer,2012,Apr,5,0,Sunday,0,Misty,0.44,0.4394,0.77,0.2239,0,6,6,253,6,6
11330,2012-04-22,Summer,2012,Apr,6,0,Sunday,0,Misty,0.44,0.4394,0.72,0.3284,6,6,12,253,12,12
11331,2012-04-22,Summer,2012,Apr,7,0,Sunday,0,Light_rainsnow,0.42,0.4242,0.77,0.3881,2,22,24,253,24,24
11332,2012-04-22,Summer,2012,Apr,8,0,Sunday,0,Light_rainsnow,0.4,0.4091,0.82,0.2537,8,43,51,253,51,51
11333,2012-04-22,Summer,2012,Apr,9,0,Sunday,0,Light_rainsnow,0.4,0.4091,0.82,0.2537,8,71,79,253,79,79
11334,2012-04-22,Summer,2012,Apr,10,0,Sunday,0,Light_rainsnow,0.38,0.3939,0.82,0.3284,11,57,68,253,68,68
11335,2012-04-22,Summer,2012,Apr,11,0,Sunday,0,Light_rainsnow,0.38,0.3939,0.87,0.2985,7,70,77,253,77,77
11336,2012-04-22,Summer,2012,Apr,12,0,Sunday,0,Light_rainsnow,0.38,0.3939,0.87,0.3284,5,56,61,253,61,61
11337,2012-04-22,Summer,2012,Apr,13,0,Sunday,0,Light_rainsnow,0.38,0.3939,0.82,0.3582,5,47,52,253,52,52
11338,2012-04-22,Summer,2012,Apr,14,0,Sunday,0,Light_rainsnow,0.38,0.3939,0.87,0.3284,3,50,53,253,53,53
11339,2012-04-22,Summer,2012,Apr,15,0,Sunday,0,Light_rainsnow,0.38,0.3939,0.87,0.3881,0,38,38,253,38,38
11340,2012-04-22,Summer,2012,Apr,16,0,Sunday,0,Light_rainsnow,0.38,0.3939,0.87,0.4478,4,32,36,253,36,36
11341,2012-04-22,Summer,2012,Apr,17,0,Sunday,0,Light_rainsnow,0.36,0.3182,0.93,0.4478,2,25,27,253,27,27
11342,2012-04-22,Summer,2012,Apr,18,0,Sunday,0,Light_rainsnow,0.36,0.3182,0.93,0.4478,1,38,39,253,39,39
11343,2012-04-22,Summer,2012,Apr,19,0,Sunday,0,Light_rainsnow,0.36,0.3182,0.87,0.5224,1,34,35,253,35,35
11344,2012-04-22,Summer,2012,Apr,20,0,Sunday,0,Light_rainsnow,0.36,0.3333,0.93,0.4179,1,34,35,253,35,35
11345,2012-04-22,Summer,2012,Apr,21,0,Sunday,0,Light_rainsnow,0.36,0.3333,0.87,0.3881,0,11,11,253,11,11
11346,2012-04-22,Summer,2012,Apr,22,0,Sunday,0,Light_rainsnow,0.34,0.2879,0.87,0.5224,0,13,13,253,13,13
11347,2012-04-22,Summer,2012,Apr,23,0,Sunday,0,Light_rainsnow,0.36,0.3182,0.81,0.4627,0,17,17,253,17,17
11348,2012-04-23,Summer,2012,Apr,0,0,Monday,1,Light_rainsnow,0.36,0.3333,0.81,0.4179,0,6,6,252,6,6
11349,2012-04-23,Summer,2012,Apr,1,0,Monday,1,Light_rainsnow,0.34,0.303,0.87,0.3582,1,1,2,252,2,2
11350,2012-04-23,Summer,2012,Apr,2,0,Monday,1,Misty,0.32,0.303,0.87,0.3284,1,3,4,252,4,4
11351,2012-04-23,Summer,2012,Apr,3,0,Monday,1,Misty,0.32,0.303,0.81,0.2836,0,1,1,252,1,1
11352,2012-04-23,Summer,2012,Apr,4,0,Monday,1,Light_rainsnow,0.3,0.2879,0.81,0.2836,0,3,3,252,3,3
11353,2012-04-23,Summer,2012,Apr,5,0,Monday,1,Light_rainsnow,0.3,0.2879,0.81,0.2836,0,14,14,252,14,14
11354,2012-04-23,Summer,2012,Apr,6,0,Monday,1,Misty,0.3,0.2727,0.81,0.2985,2,43,45,252,45,45
11355,2012-04-23,Summer,2012,Apr,7,0,Monday,1,Light_rainsnow,0.3,0.2879,0.81,0.2537,1,206,207,252,207,207
11356,2012-04-23,Summer,2012,Apr,8,0,Monday,1,Misty,0.3,0.2727,0.75,0.3284,11,471,482,252,482,482
11357,2012-04-23,Summer,2012,Apr,9,0,Monday,1,Misty,0.3,0.2727,0.75,0.3881,17,255,272,252,272,272
11358,2012-04-23,Summer,2012,Apr,10,0,Monday,1,Misty,0.32,0.303,0.7,0.3284,12,88,100,252,100,100
11359,2012-04-23,Summer,2012,Apr,11,0,Monday,1,Misty,0.32,0.2879,0.7,0.3582,10,91,101,252,101,101
11360,2012-04-23,Summer,2012,Apr,12,0,Monday,1,Light_rainsnow,0.34,0.303,0.71,0.3582,12,117,129,252,129,129
11361,2012-04-23,Summer,2012,Apr,13,0,Monday,1,Light_rainsnow,0.34,0.303,0.66,0.3881,9,98,107,252,107,107
11362,2012-04-23,Summer,2012,Apr,14,0,Monday,1,Light_rainsnow,0.36,0.3182,0.62,0.4478,12,102,114,252,114,114
11363,2012-04-23,Summer,2012,Apr,15,0,Monday,1,Misty,0.36,0.3333,0.62,0.3881,11,101,112,252,112,112
11364,2012-04-23,Summer,2012,Apr,16,0,Monday,1,Light_rainsnow,0.3,0.2727,0.81,0.3582,10,93,103,252,103,103
11365,2012-04-23,Summer,2012,Apr,17,0,Monday,1,Light_rainsnow,0.3,0.2727,0.82,0.3284,13,219,232,252,232,232
11366,2012-04-23,Summer,2012,Apr,18,0,Monday,1,Light_rainsnow,0.32,0.3333,0.81,0.1343,10,369,379,252,379,379
11367,2012-04-23,Summer,2012,Apr,19,0,Monday,1,Misty,0.34,0.3182,0.76,0.2239,11,287,298,252,298,298
11368,2012-04-23,Summer,2012,Apr,20,0,Monday,1,Misty,0.32,0.3182,0.76,0.1642,17,186,203,252,203,203
11369,2012-04-23,Summer,2012,Apr,21,0,Monday,1,Misty,0.32,0.303,0.81,0.2239,7,145,152,252,152,152
11370,2012-04-23,Summer,2012,Apr,22,0,Monday,1,Clear,0.32,0.3182,0.76,0.194,18,71,89,252,89,89
11371,2012-04-23,Summer,2012,Apr,23,0,Monday,1,Clear,0.32,0.3182,0.76,0.1642,10,49,59,252,59,59
11372,2012-04-24,Summer,2012,Apr,0,0,Tuesday,1,Misty,0.32,0.3333,0.76,0.1343,0,13,13,251,13,13
11373,2012-04-24,Summer,2012,Apr,1,0,Tuesday,1,Misty,0.32,0.3333,0.81,0.1343,1,6,7,251,7,7
11374,2012-04-24,Summer,2012,Apr,2,0,Tuesday,1,Clear,0.32,0.3182,0.81,0.194,0,3,3,251,3,3
11375,2012-04-24,Summer,2012,Apr,3,0,Tuesday,1,Clear,0.32,0.303,0.81,0.2239,0,2,2,251,2,2
11376,2012-04-24,Summer,2012,Apr,4,0,Tuesday,1,Clear,0.3,0.2879,0.7,0.194,0,3,3,251,3,3
11377,2012-04-24,Summer,2012,Apr,5,0,Tuesday,1,Clear,0.3,0.2879,0.7,0.194,0,22,22,251,22,22
11378,2012-04-24,Summer,2012,Apr,6,0,Tuesday,1,Clear,0.3,0.2879,0.7,0.2239,3,117,120,251,120,120
11379,2012-04-24,Summer,2012,Apr,7,0,Tuesday,1,Clear,0.32,0.303,0.66,0.2836,3,387,390,251,390,390
11380,2012-04-24,Summer,2012,Apr,8,0,Tuesday,1,Clear,0.34,0.3182,0.61,0.2537,12,599,611,251,611,611
11381,2012-04-24,Summer,2012,Apr,9,0,Tuesday,1,Clear,0.4,0.4091,0.47,0.3582,6,302,308,251,308,308
11382,2012-04-24,Summer,2012,Apr,10,0,Tuesday,1,Clear,0.42,0.4242,0.47,0.2985,33,129,162,251,162,162
11383,2012-04-24,Summer,2012,Apr,11,0,Tuesday,1,Clear,0.46,0.4545,0.31,0.3881,27,157,184,251,184,184
11384,2012-04-24,Summer,2012,Apr,12,0,Tuesday,1,Clear,0.48,0.4697,0.29,0.3881,36,188,224,251,224,224
11385,2012-04-24,Summer,2012,Apr,13,0,Tuesday,1,Clear,0.5,0.4848,0.29,0.3881,35,189,224,251,224,224
11386,2012-04-24,Summer,2012,Apr,14,0,Tuesday,1,Clear,0.5,0.4848,0.25,0.3881,50,166,216,251,216,216
11387,2012-04-24,Summer,2012,Apr,15,0,Tuesday,1,Clear,0.5,0.4848,0.23,0.4179,60,176,236,251,236,236
11388,2012-04-24,Summer,2012,Apr,16,0,Tuesday,1,Clear,0.5,0.4848,0.23,0.194,54,308,362,251,362,362
11389,2012-04-24,Summer,2012,Apr,17,0,Tuesday,1,Clear,0.52,0.5,0.22,0.3881,72,619,691,251,691,691
11390,2012-04-24,Summer,2012,Apr,18,0,Tuesday,1,Clear,0.5,0.4848,0.18,0.0,52,580,632,251,632,632
11391,2012-04-24,Summer,2012,Apr,19,0,Tuesday,1,Clear,0.5,0.4848,0.18,0.2537,33,449,482,251,482,482
11392,2012-04-24,Summer,2012,Apr,20,0,Tuesday,1,Clear,0.48,0.4697,0.21,0.3284,16,269,285,251,285,285
11393,2012-04-24,Summer,2012,Apr,21,0,Tuesday,1,Misty,0.46,0.4545,0.28,0.1642,13,213,226,251,226,226
11394,2012-04-24,Summer,2012,Apr,22,0,Tuesday,1,Clear,0.44,0.4394,0.35,0.1045,8,149,157,251,157,157
11395,2012-04-24,Summer,2012,Apr,23,0,Tuesday,1,Clear,0.42,0.4242,0.38,0.0896,4,69,73,251,73,73
11396,2012-04-25,Summer,2012,Apr,0,0,Wednesday,1,Clear,0.44,0.4394,0.38,0.0,13,23,36,250,36,36
11397,2012-04-25,Summer,2012,Apr,1,0,Wednesday,1,Clear,0.42,0.4242,0.41,0.0,8,17,25,250,25,25
11398,2012-04-25,Summer,2012,Apr,2,0,Wednesday,1,Clear,0.36,0.3788,0.62,0.0,1,6,7,250,7,7
11399,2012-04-25,Summer,2012,Apr,3,0,Wednesday,1,Clear,0.32,0.3333,0.7,0.0896,0,3,3,250,3,3
11400,2012-04-25,Summer,2012,Apr,4,0,Wednesday,1,Clear,0.34,0.3485,0.66,0.0896,0,6,6,250,6,6
11401,2012-04-25,Summer,2012,Apr,5,0,Wednesday,1,Clear,0.34,0.3636,0.66,0.0,0,24,24,250,24,24
11402,2012-04-25,Summer,2012,Apr,6,0,Wednesday,1,Clear,0.34,0.3636,0.66,0.0,3,103,106,250,106,106
11403,2012-04-25,Summer,2012,Apr,7,0,Wednesday,1,Clear,0.34,0.3636,0.71,0.0,13,376,389,250,389,389
11404,2012-04-25,Summer,2012,Apr,8,0,Wednesday,1,Clear,0.36,0.3636,0.76,0.0896,20,634,654,250,654,654
11405,2012-04-25,Summer,2012,Apr,9,0,Wednesday,1,Clear,0.42,0.4242,0.54,0.0,33,288,321,250,321,321
11406,2012-04-25,Summer,2012,Apr,10,0,Wednesday,1,Clear,0.52,0.5,0.34,0.0,44,138,182,250,182,182
11407,2012-04-25,Summer,2012,Apr,11,0,Wednesday,1,Clear,0.52,0.5,0.32,0.1343,42,177,219,250,219,219
11408,2012-04-25,Summer,2012,Apr,12,0,Wednesday,1,Clear,0.54,0.5152,0.28,0.2836,49,220,269,250,269,269
11409,2012-04-25,Summer,2012,Apr,13,0,Wednesday,1,Clear,0.56,0.5303,0.26,0.2239,35,193,228,250,228,228
11410,2012-04-25,Summer,2012,Apr,14,0,Wednesday,1,Clear,0.56,0.5303,0.22,0.3582,47,176,223,250,223,223
11411,2012-04-25,Summer,2012,Apr,15,0,Wednesday,1,Clear,0.58,0.5455,0.19,0.1642,47,182,229,250,229,229
11412,2012-04-25,Summer,2012,Apr,16,0,Wednesday,1,Clear,0.6,0.5909,0.2,0.3284,49,327,376,250,376,376
11413,2012-04-25,Summer,2012,Apr,17,0,Wednesday,1,Clear,0.6,0.5909,0.2,0.2985,68,664,732,250,732,732
11414,2012-04-25,Summer,2012,Apr,18,0,Wednesday,1,Clear,0.6,0.5909,0.2,0.2836,60,649,709,250,709,709
11415,2012-04-25,Summer,2012,Apr,19,0,Wednesday,1,Clear,0.6,0.5909,0.2,0.194,42,501,543,250,543,543
11416,2012-04-25,Summer,2012,Apr,20,0,Wednesday,1,Clear,0.56,0.5303,0.22,0.0896,22,358,380,250,380,380
11417,2012-04-25,Summer,2012,Apr,21,0,Wednesday,1,Clear,0.52,0.5,0.52,0.1343,27,212,239,250,239,239
11418,2012-04-25,Summer,2012,Apr,22,0,Wednesday,1,Clear,0.5,0.4848,0.51,0.0,22,170,192,250,192,192
11419,2012-04-25,Summer,2012,Apr,23,0,Wednesday,1,Misty,0.5,0.4848,0.51,0.0896,10,94,104,250,104,104
11420,2012-04-26,Summer,2012,Apr,0,0,Thursday,1,Misty,0.48,0.4697,0.63,0.0,1,42,43,249,43,43
11421,2012-04-26,Summer,2012,Apr,1,0,Thursday,1,Misty,0.48,0.4697,0.48,0.0896,1,22,23,249,23,23
11422,2012-04-26,Summer,2012,Apr,2,0,Thursday,1,Misty,0.48,0.4697,0.55,0.1045,3,10,13,249,13,13
11423,2012-04-26,Summer,2012,Apr,3,0,Thursday,1,Misty,0.48,0.4697,0.55,0.0896,1,5,6,249,6,6
11424,2012-04-26,Summer,2012,Apr,4,0,Thursday,1,Misty,0.48,0.4697,0.59,0.0896,1,2,3,249,3,3
11425,2012-04-26,Summer,2012,Apr,5,0,Thursday,1,Misty,0.48,0.4697,0.63,0.1343,0,17,17,249,17,17
11426,2012-04-26,Summer,2012,Apr,6,0,Thursday,1,Misty,0.48,0.4697,0.63,0.2537,5,122,127,249,127,127
11427,2012-04-26,Summer,2012,Apr,7,0,Thursday,1,Light_rainsnow,0.46,0.4545,0.82,0.3582,3,222,225,249,225,225
11428,2012-04-26,Summer,2012,Apr,8,0,Thursday,1,Light_rainsnow,0.46,0.4545,0.82,0.194,4,358,362,249,362,362
11429,2012-04-26,Summer,2012,Apr,9,0,Thursday,1,Light_rainsnow,0.46,0.4545,0.88,0.1642,12,189,201,249,201,201
11430,2012-04-26,Summer,2012,Apr,10,0,Thursday,1,Misty,0.46,0.4545,0.94,0.1642,14,125,139,249,139,139
11431,2012-04-26,Summer,2012,Apr,11,0,Thursday,1,Misty,0.46,0.4545,0.94,0.2239,16,135,151,249,151,151
11432,2012-04-26,Summer,2012,Apr,12,0,Thursday,1,Misty,0.52,0.5,0.83,0.1343,24,180,204,249,204,204
11433,2012-04-26,Summer,2012,Apr,13,0,Thursday,1,Misty,0.5,0.4848,0.82,0.1642,19,178,197,249,197,197
11434,2012-04-26,Summer,2012,Apr,14,0,Thursday,1,Misty,0.54,0.5152,0.77,0.194,37,132,169,249,169,169
11435,2012-04-26,Summer,2012,Apr,15,0,Thursday,1,Misty,0.52,0.5,0.83,0.3284,39,165,204,249,204,204
11436,2012-04-26,Summer,2012,Apr,16,0,Thursday,1,Misty,0.52,0.5,0.83,0.2239,37,281,318,249,318,318
11437,2012-04-26,Summer,2012,Apr,17,0,Thursday,1,Clear,0.54,0.5152,0.77,0.1642,49,565,614,249,614,614
11438,2012-04-26,Summer,2012,Apr,18,0,Thursday,1,Misty,0.54,0.5152,0.77,0.194,75,589,664,249,664,664
11439,2012-04-26,Summer,2012,Apr,19,0,Thursday,1,Misty,0.54,0.5152,0.77,0.2239,57,407,464,249,464,464
11440,2012-04-26,Summer,2012,Apr,20,0,Thursday,1,Clear,0.54,0.5152,0.77,0.194,23,314,337,249,337,337
11441,2012-04-26,Summer,2012,Apr,21,0,Thursday,1,Clear,0.52,0.5,0.83,0.2239,28,222,250,249,250,250
11442,2012-04-26,Summer,2012,Apr,22,0,Thursday,1,Clear,0.52,0.5,0.83,0.1642,20,163,183,249,183,183
11443,2012-04-26,Summer,2012,Apr,23,0,Thursday,1,Clear,0.5,0.4848,0.88,0.1642,6,106,112,249,112,112
11444,2012-04-27,Summer,2012,Apr,0,0,Friday,1,Clear,0.54,0.5152,0.68,0.5522,12,61,73,248,73,73
11445,2012-04-27,Summer,2012,Apr,1,0,Friday,1,Clear,0.5,0.4848,0.59,0.4478,3,32,35,248,35,35
11446,2012-04-27,Summer,2012,Apr,2,0,Friday,1,Clear,0.48,0.4697,0.59,0.4179,4,18,22,248,22,22
11447,2012-04-27,Summer,2012,Apr,3,0,Friday,1,Clear,0.44,0.4394,0.47,0.4925,1,2,3,248,3,3
11448,2012-04-27,Summer,2012,Apr,4,0,Friday,1,Clear,0.42,0.4242,0.44,0.2537,0,6,6,248,6,6
11449,2012-04-27,Summer,2012,Apr,5,0,Friday,1,Clear,0.42,0.4242,0.44,0.3582,0,19,19,248,19,19
11450,2012-04-27,Summer,2012,Apr,6,0,Friday,1,Clear,0.4,0.4091,0.43,0.2537,5,115,120,248,120,120
11451,2012-04-27,Summer,2012,Apr,7,0,Friday,1,Clear,0.38,0.3939,0.5,0.2836,10,305,315,248,315,315
11452,2012-04-27,Summer,2012,Apr,8,0,Friday,1,Clear,0.4,0.4091,0.5,0.0,17,575,592,248,592,592
11453,2012-04-27,Summer,2012,Apr,9,0,Friday,1,Clear,0.42,0.4242,0.44,0.4925,42,292,334,248,334,334
11454,2012-04-27,Summer,2012,Apr,10,0,Friday,1,Clear,0.44,0.4394,0.38,0.4179,64,172,236,248,236,236
11455,2012-04-27,Summer,2012,Apr,11,0,Friday,1,Clear,0.44,0.4394,0.38,0.3284,47,186,233,248,233,233
11456,2012-04-27,Summer,2012,Apr,12,0,Friday,1,Clear,0.46,0.4545,0.36,0.3582,63,244,307,248,307,307
11457,2012-04-27,Summer,2012,Apr,13,0,Friday,1,Clear,0.46,0.4545,0.33,0.3881,94,212,306,248,306,306
11458,2012-04-27,Summer,2012,Apr,14,0,Friday,1,Clear,0.46,0.4545,0.33,0.3284,94,206,300,248,300,300
11459,2012-04-27,Summer,2012,Apr,15,0,Friday,1,Clear,0.52,0.5,0.29,0.4925,101,223,324,248,324,324
11460,2012-04-27,Summer,2012,Apr,16,0,Friday,1,Clear,0.52,0.5,0.29,0.2537,105,335,440,248,440,440
11461,2012-04-27,Summer,2012,Apr,17,0,Friday,1,Clear,0.54,0.5152,0.24,0.3881,89,613,702,248,702,702
11462,2012-04-27,Summer,2012,Apr,18,0,Friday,1,Clear,0.52,0.5,0.25,0.3582,94,560,654,248,654,654
11463,2012-04-27,Summer,2012,Apr,19,0,Friday,1,Clear,0.5,0.4848,0.27,0.3881,62,379,441,248,441,441
11464,2012-04-27,Summer,2012,Apr,20,0,Friday,1,Clear,0.46,0.4545,0.31,0.2836,49,240,289,248,289,289
11465,2012-04-27,Summer,2012,Apr,21,0,Friday,1,Clear,0.44,0.4394,0.33,0.2985,23,185,208,248,208,208
11466,2012-04-27,Summer,2012,Apr,22,0,Friday,1,Clear,0.42,0.4242,0.38,0.2537,24,134,158,248,158,158
11467,2012-04-27,Summer,2012,Apr,23,0,Friday,1,Clear,0.4,0.4091,0.4,0.2537,11,105,116,248,116,116
11468,2012-04-28,Summer,2012,Apr,0,0,Saturday,0,Clear,0.38,0.3939,0.43,0.1642,4,99,103,247,103,103
11469,2012-04-28,Summer,2012,Apr,1,0,Saturday,0,Clear,0.36,0.3333,0.5,0.2985,7,60,67,247,67,67
11470,2012-04-28,Summer,2012,Apr,2,0,Saturday,0,Clear,0.36,0.3485,0.43,0.1642,8,49,57,247,57,57
11471,2012-04-28,Summer,2012,Apr,3,0,Saturday,0,Clear,0.34,0.3182,0.49,0.2239,3,23,26,247,26,26
11472,2012-04-28,Summer,2012,Apr,4,0,Saturday,0,Clear,0.34,0.3333,0.49,0.1642,0,2,2,247,2,2
11473,2012-04-28,Summer,2012,Apr,5,0,Saturday,0,Clear,0.34,0.3333,0.46,0.1343,2,3,5,247,5,5
11474,2012-04-28,Summer,2012,Apr,6,0,Saturday,0,Clear,0.34,0.3333,0.49,0.194,10,18,28,247,28,28
11475,2012-04-28,Summer,2012,Apr,7,0,Saturday,0,Clear,0.34,0.3333,0.49,0.1642,10,45,55,247,55,55
11476,2012-04-28,Summer,2012,Apr,8,0,Saturday,0,Clear,0.38,0.3939,0.4,0.1343,24,134,158,247,158,158
11477,2012-04-28,Summer,2012,Apr,9,0,Saturday,0,Misty,0.38,0.3939,0.37,0.0,45,169,214,247,214,214
11478,2012-04-28,Summer,2012,Apr,10,0,Saturday,0,Misty,0.38,0.3939,0.4,0.1642,60,231,291,247,291,291
11479,2012-04-28,Summer,2012,Apr,11,0,Saturday,0,Misty,0.38,0.3939,0.4,0.1045,96,262,358,247,358,358
11480,2012-04-28,Summer,2012,Apr,12,0,Saturday,0,Misty,0.38,0.3939,0.43,0.0,105,276,381,247,381,381
11481,2012-04-28,Summer,2012,Apr,13,0,Saturday,0,Misty,0.4,0.4091,0.37,0.0,120,269,389,247,389,389
11482,2012-04-28,Summer,2012,Apr,14,0,Saturday,0,Clear,0.42,0.4242,0.38,0.1045,147,293,440,247,440,440
11483,2012-04-28,Summer,2012,Apr,15,0,Saturday,0,Clear,0.42,0.4242,0.41,0.2239,148,260,408,247,408,408
11484,2012-04-28,Summer,2012,Apr,16,0,Saturday,0,Misty,0.44,0.4394,0.38,0.194,132,244,376,247,376,376
11485,2012-04-28,Summer,2012,Apr,17,0,Saturday,0,Misty,0.42,0.4242,0.41,0.1343,98,224,322,247,322,322
11486,2012-04-28,Summer,2012,Apr,18,0,Saturday,0,Light_rainsnow,0.4,0.4091,0.47,0.0,17,73,90,247,90,90
11487,2012-04-28,Summer,2012,Apr,19,0,Saturday,0,Light_rainsnow,0.36,0.3485,0.71,0.1343,29,110,139,247,139,139
11488,2012-04-28,Summer,2012,Apr,20,0,Saturday,0,Misty,0.38,0.3939,0.66,0.0,21,81,102,247,102,102
11489,2012-04-28,Summer,2012,Apr,21,0,Saturday,0,Light_rainsnow,0.36,0.3485,0.71,0.194,12,72,84,247,84,84
11490,2012-04-28,Summer,2012,Apr,22,0,Saturday,0,Misty,0.36,0.3485,0.71,0.1343,17,66,83,247,83,83
11491,2012-04-28,Summer,2012,Apr,23,0,Saturday,0,Misty,0.38,0.3939,0.76,0.0896,5,37,42,247,42,42
11492,2012-04-29,Summer,2012,Apr,0,0,Sunday,0,Light_rainsnow,0.36,0.3485,0.81,0.1343,0,36,36,246,36,36
11493,2012-04-29,Summer,2012,Apr,1,0,Sunday,0,Misty,0.36,0.3485,0.81,0.1343,5,37,42,246,42,42
11494,2012-04-29,Summer,2012,Apr,2,0,Sunday,0,Misty,0.36,0.3636,0.87,0.1045,4,36,40,246,40,40
11495,2012-04-29,Summer,2012,Apr,3,0,Sunday,0,Misty,0.36,0.3485,0.87,0.194,2,14,16,246,16,16
11496,2012-04-29,Summer,2012,Apr,4,0,Sunday,0,Misty,0.36,0.3485,0.87,0.1343,0,4,4,246,4,4
11497,2012-04-29,Summer,2012,Apr,5,0,Sunday,0,Clear,0.34,0.3636,0.87,0.0,0,6,6,246,6,6
11498,2012-04-29,Summer,2012,Apr,6,0,Sunday,0,Clear,0.34,0.3333,0.87,0.1343,1,6,7,246,7,7
11499,2012-04-29,Summer,2012,Apr,7,0,Sunday,0,Misty,0.34,0.3333,0.87,0.1343,7,20,27,246,27,27
11500,2012-04-29,Summer,2012,Apr,8,0,Sunday,0,Clear,0.38,0.3939,0.76,0.1343,26,81,107,246,107,107
11501,2012-04-29,Summer,2012,Apr,9,0,Sunday,0,Clear,0.4,0.4091,0.71,0.1343,52,133,185,246,185,185
11502,2012-04-29,Summer,2012,Apr,10,0,Sunday,0,Clear,0.42,0.4242,0.67,0.0896,127,253,380,246,380,380
11503,2012-04-29,Summer,2012,Apr,11,0,Sunday,0,Clear,0.46,0.4545,0.51,0.0,128,283,411,246,411,411
11504,2012-04-29,Summer,2012,Apr,12,0,Sunday,0,Clear,0.48,0.4697,0.44,0.1045,223,361,584,246,584,584
11505,2012-04-29,Summer,2012,Apr,13,0,Sunday,0,Clear,0.5,0.4848,0.45,0.1045,226,369,595,246,595,595
11506,2012-04-29,Summer,2012,Apr,14,0,Sunday,0,Clear,0.54,0.5152,0.34,0.0,281,372,653,246,653,653
11507,2012-04-29,Summer,2012,Apr,15,0,Sunday,0,Clear,0.56,0.5303,0.37,0.1343,279,324,603,246,603,603
11508,2012-04-29,Summer,2012,Apr,16,0,Sunday,0,Clear,0.6,0.6061,0.28,0.194,240,347,587,246,587,587
11509,2012-04-29,Summer,2012,Apr,17,0,Sunday,0,Clear,0.62,0.6061,0.27,0.2985,188,334,522,246,522,522
11510,2012-04-29,Summer,2012,Apr,18,0,Sunday,0,Clear,0.6,0.6061,0.26,0.2836,164,323,487,246,487,487
11511,2012-04-29,Summer,2012,Apr,19,0,Sunday,0,Clear,0.56,0.5303,0.35,0.1343,128,247,375,246,375,375
11512,2012-04-29,Summer,2012,Apr,20,0,Sunday,0,Clear,0.56,0.5303,0.32,0.0896,45,198,243,246,243,243
11513,2012-04-29,Summer,2012,Apr,21,0,Sunday,0,Clear,0.52,0.5,0.48,0.1343,65,139,204,246,204,204
11514,2012-04-29,Summer,2012,Apr,22,0,Sunday,0,Clear,0.5,0.4848,0.45,0.0,23,85,108,246,108,108
11515,2012-04-29,Summer,2012,Apr,23,0,Sunday,0,Clear,0.48,0.4697,0.59,0.0,15,67,82,246,82,82
11516,2012-04-30,Summer,2012,Apr,0,0,Monday,1,Clear,0.44,0.4394,0.72,0.1045,12,36,48,245,48,48
11517,2012-04-30,Summer,2012,Apr,1,0,Monday,1,Clear,0.42,0.4242,0.77,0.0896,9,15,24,245,24,24
11518,2012-04-30,Summer,2012,Apr,2,0,Monday,1,Clear,0.42,0.4242,0.71,0.1343,3,5,8,245,8,8
11519,2012-04-30,Summer,2012,Apr,3,0,Monday,1,Clear,0.4,0.4091,0.76,0.1642,0,4,4,245,4,4
11520,2012-04-30,Summer,2012,Apr,4,0,Monday,1,Clear,0.38,0.3939,0.62,0.2537,0,2,2,245,2,2
11521,2012-04-30,Summer,2012,Apr,5,0,Monday,1,Clear,0.38,0.3939,0.62,0.2537,1,19,20,245,20,20
11522,2012-04-30,Summer,2012,Apr,6,0,Monday,1,Clear,0.4,0.4091,0.47,0.194,2,121,123,245,123,123
11523,2012-04-30,Summer,2012,Apr,7,0,Monday,1,Clear,0.4,0.4091,0.5,0.194,6,343,349,245,349,349
11524,2012-04-30,Summer,2012,Apr,8,0,Monday,1,Clear,0.4,0.4091,0.43,0.194,17,579,596,245,596,596
11525,2012-04-30,Summer,2012,Apr,9,0,Monday,1,Misty,0.4,0.4091,0.43,0.194,29,239,268,245,268,268
11526,2012-04-30,Summer,2012,Apr,10,0,Monday,1,Misty,0.42,0.4242,0.41,0.1642,41,116,157,245,157,157
11527,2012-04-30,Summer,2012,Apr,11,0,Monday,1,Misty,0.44,0.4394,0.44,0.1045,52,111,163,245,163,163
11528,2012-04-30,Summer,2012,Apr,12,0,Monday,1,Misty,0.44,0.4394,0.47,0.1343,45,180,225,245,225,225
11529,2012-04-30,Summer,2012,Apr,13,0,Monday,1,Misty,0.48,0.4697,0.51,0.0896,48,199,247,245,247,247
11530,2012-04-30,Summer,2012,Apr,14,0,Monday,1,Misty,0.5,0.4848,0.55,0.1343,56,162,218,245,218,218
11531,2012-04-30,Summer,2012,Apr,15,0,Monday,1,Misty,0.52,0.5,0.55,0.1045,55,176,231,245,231,231
11532,2012-04-30,Summer,2012,Apr,16,0,Monday,1,Clear,0.56,0.5303,0.6,0.194,44,303,347,245,347,347
11533,2012-04-30,Summer,2012,Apr,17,0,Monday,1,Clear,0.56,0.5303,0.6,0.1642,66,617,683,245,683,683
11534,2012-04-30,Summer,2012,Apr,18,0,Monday,1,Misty,0.56,0.5303,0.6,0.2239,53,611,664,245,664,664
11535,2012-04-30,Summer,2012,Apr,19,0,Monday,1,Misty,0.54,0.5152,0.64,0.2537,51,420,471,245,471,471
11536,2012-04-30,Summer,2012,Apr,20,0,Monday,1,Misty,0.52,0.5,0.59,0.194,28,281,309,245,309,309
11537,2012-04-30,Summer,2012,Apr,21,0,Monday,1,Misty,0.52,0.5,0.59,0.194,26,195,221,245,221,221
11538,2012-04-30,Summer,2012,Apr,22,0,Monday,1,Misty,0.52,0.5,0.55,0.1642,11,123,134,245,134,134
11539,2012-04-30,Summer,2012,Apr,23,0,Monday,1,Misty,0.52,0.5,0.55,0.2239,10,50,60,245,60,60
11540,2012-05-01,Summer,2012,May,0,0,Tuesday,1,Misty,0.5,0.4848,0.59,0.194,7,28,35,244,35,35
11541,2012-05-01,Summer,2012,May,1,0,Tuesday,1,Misty,0.5,0.4848,0.63,0.1343,0,21,21,244,21,21
11542,2012-05-01,Summer,2012,May,2,0,Tuesday,1,Misty,0.5,0.4848,0.72,0.0896,1,7,8,244,8,8
11543,2012-05-01,Summer,2012,May,3,0,Tuesday,1,Misty,0.5,0.4848,0.77,0.0,1,2,3,244,3,3
11544,2012-05-01,Summer,2012,May,4,0,Tuesday,1,Misty,0.52,0.5,0.72,0.0896,1,7,8,244,8,8
11545,2012-05-01,Summer,2012,May,5,0,Tuesday,1,Misty,0.52,0.5,0.72,0.0896,0,17,17,244,17,17
11546,2012-05-01,Summer,2012,May,6,0,Tuesday,1,Light_rainsnow,0.52,0.5,0.77,0.1045,2,24,26,244,26,26
11547,2012-05-01,Summer,2012,May,7,0,Tuesday,1,Misty,0.5,0.4848,0.94,0.2537,8,161,169,244,169,169
11548,2012-05-01,Summer,2012,May,8,0,Tuesday,1,Misty,0.52,0.5,0.94,0.2836,19,538,557,244,557,557
11549,2012-05-01,Summer,2012,May,9,0,Tuesday,1,Misty,0.54,0.5152,0.88,0.194,18,331,349,244,349,349
11550,2012-05-01,Summer,2012,May,10,0,Tuesday,1,Clear,0.62,0.5909,0.78,0.2537,30,144,174,244,174,174
11551,2012-05-01,Summer,2012,May,11,0,Tuesday,1,Misty,0.66,0.6212,0.65,0.2836,50,179,229,244,229,229
11552,2012-05-01,Summer,2012,May,12,0,Tuesday,1,Misty,0.7,0.6515,0.58,0.2239,41,228,269,244,269,269
11553,2012-05-01,Summer,2012,May,13,0,Tuesday,1,Misty,0.72,0.6667,0.51,0.2239,41,208,249,244,249,249
11554,2012-05-01,Summer,2012,May,14,0,Tuesday,1,Misty,0.74,0.6667,0.48,0.2537,37,167,204,244,204,204
11555,2012-05-01,Summer,2012,May,15,0,Tuesday,1,Misty,0.74,0.6667,0.45,0.2239,48,186,234,244,234,234
11556,2012-05-01,Summer,2012,May,16,0,Tuesday,1,Clear,0.74,0.6667,0.45,0.194,41,313,354,244,354,354
11557,2012-05-01,Summer,2012,May,17,0,Tuesday,1,Clear,0.74,0.6667,0.48,0.0896,65,616,681,244,681,681
11558,2012-05-01,Summer,2012,May,18,0,Tuesday,1,Clear,0.7,0.6515,0.54,0.1343,81,662,743,244,743,743
11559,2012-05-01,Summer,2012,May,19,0,Tuesday,1,Clear,0.7,0.6515,0.54,0.1343,58,429,487,244,487,487
11560,2012-05-01,Summer,2012,May,20,0,Tuesday,1,Clear,0.66,0.6212,0.61,0.1642,36,299,335,244,335,335
11561,2012-05-01,Summer,2012,May,21,0,Tuesday,1,Clear,0.64,0.6061,0.65,0.1343,31,251,282,244,282,282
11562,2012-05-01,Summer,2012,May,22,0,Tuesday,1,Clear,0.64,0.6061,0.65,0.0,21,190,211,244,211,211
11563,2012-05-01,Summer,2012,May,23,0,Tuesday,1,Clear,0.6,0.5758,0.78,0.0,16,79,95,244,95,95
11564,2012-05-02,Summer,2012,May,0,0,Wednesday,1,Clear,0.6,0.5758,0.78,0.1045,4,43,47,243,47,47
11565,2012-05-02,Summer,2012,May,1,0,Wednesday,1,Clear,0.56,0.5303,0.83,0.0,8,7,15,243,15,15
11566,2012-05-02,Summer,2012,May,2,0,Wednesday,1,Clear,0.56,0.5303,0.83,0.0,7,9,16,243,16,16
11567,2012-05-02,Summer,2012,May,3,0,Wednesday,1,Clear,0.56,0.5303,0.83,0.0896,0,6,6,243,6,6
11568,2012-05-02,Summer,2012,May,4,0,Wednesday,1,Clear,0.54,0.5152,0.88,0.0,2,2,4,243,4,4
11569,2012-05-02,Summer,2012,May,5,0,Wednesday,1,Clear,0.54,0.5152,0.9,0.1343,2,31,33,243,33,33
11570,2012-05-02,Summer,2012,May,6,0,Wednesday,1,Light_rainsnow,0.56,0.5303,0.84,0.0,3,117,120,243,120,120
11571,2012-05-02,Summer,2012,May,7,0,Wednesday,1,Misty,0.54,0.5152,0.88,0.194,14,344,358,243,358,358
11572,2012-05-02,Summer,2012,May,8,0,Wednesday,1,Misty,0.56,0.5303,0.88,0.0,26,640,666,243,666,666
11573,2012-05-02,Summer,2012,May,9,0,Wednesday,1,Misty,0.56,0.5303,0.88,0.0,26,289,315,243,315,315
11574,2012-05-02,Summer,2012,May,10,0,Wednesday,1,Misty,0.58,0.5455,0.83,0.1045,28,147,175,243,175,175
11575,2012-05-02,Summer,2012,May,11,0,Wednesday,1,Misty,0.58,0.5455,0.81,0.1343,39,145,184,243,184,184
11576,2012-05-02,Summer,2012,May,12,0,Wednesday,1,Misty,0.58,0.5455,0.83,0.2239,35,210,245,243,245,245
11577,2012-05-02,Summer,2012,May,13,0,Wednesday,1,Misty,0.58,0.5455,0.78,0.194,49,179,228,243,228,228
11578,2012-05-02,Summer,2012,May,14,0,Wednesday,1,Clear,0.62,0.6061,0.69,0.0896,51,189,240,243,240,240
11579,2012-05-02,Summer,2012,May,15,0,Wednesday,1,Clear,0.64,0.6061,0.65,0.194,52,204,256,243,256,256
11580,2012-05-02,Summer,2012,May,16,0,Wednesday,1,Clear,0.64,0.6061,0.65,0.1642,54,313,367,243,367,367
11581,2012-05-02,Summer,2012,May,17,0,Wednesday,1,Clear,0.6,0.5909,0.73,0.2537,70,659,729,243,729,729
11582,2012-05-02,Summer,2012,May,18,0,Wednesday,1,Clear,0.56,0.5303,0.73,0.2239,43,770,813,243,813,813
11583,2012-05-02,Summer,2012,May,19,0,Wednesday,1,Clear,0.54,0.5152,0.77,0.2537,43,461,504,243,504,504
11584,2012-05-02,Summer,2012,May,20,0,Wednesday,1,Clear,0.52,0.5,0.77,0.2537,42,296,338,243,338,338
11585,2012-05-02,Summer,2012,May,21,0,Wednesday,1,Clear,0.52,0.5,0.77,0.2239,21,218,239,243,239,239
11586,2012-05-02,Summer,2012,May,22,0,Wednesday,1,Clear,0.5,0.4848,0.82,0.2239,27,146,173,243,173,173
11587,2012-05-02,Summer,2012,May,23,0,Wednesday,1,Misty,0.5,0.4848,0.77,0.2537,21,77,98,243,98,98
11588,2012-05-03,Summer,2012,May,0,0,Thursday,1,Misty,0.48,0.4697,0.82,0.2239,15,75,90,242,90,90
11589,2012-05-03,Summer,2012,May,1,0,Thursday,1,Misty,0.46,0.4545,0.88,0.1045,9,15,24,242,24,24
11590,2012-05-03,Summer,2012,May,2,0,Thursday,1,Misty,0.46,0.4545,0.88,0.1343,4,13,17,242,17,17
11591,2012-05-03,Summer,2012,May,3,0,Thursday,1,Misty,0.46,0.4545,0.88,0.0,2,4,6,242,6,6
11592,2012-05-03,Summer,2012,May,4,0,Thursday,1,Misty,0.46,0.4545,0.88,0.2537,0,2,2,242,2,2
11593,2012-05-03,Summer,2012,May,5,0,Thursday,1,Misty,0.46,0.4545,0.88,0.2537,1,20,21,242,21,21
11594,2012-05-03,Summer,2012,May,6,0,Thursday,1,Misty,0.46,0.4545,0.88,0.1642,8,128,136,242,136,136
11595,2012-05-03,Summer,2012,May,7,0,Thursday,1,Light_rainsnow,0.44,0.4394,0.94,0.1045,8,376,384,242,384,384
11596,2012-05-03,Summer,2012,May,8,0,Thursday,1,Light_rainsnow,0.46,0.4545,0.88,0.194,19,608,627,242,627,627
11597,2012-05-03,Summer,2012,May,9,0,Thursday,1,Misty,0.48,0.4697,0.88,0.1045,25,279,304,242,304,304
11598,2012-05-03,Summer,2012,May,10,0,Thursday,1,Misty,0.52,0.5,0.77,0.0,36,132,168,242,168,168
11599,2012-05-03,Summer,2012,May,11,0,Thursday,1,Clear,0.54,0.5152,0.77,0.0,34,167,201,242,201,201
11600,2012-05-03,Summer,2012,May,12,0,Thursday,1,Clear,0.56,0.5303,0.73,0.1343,64,237,301,242,301,301
11601,2012-05-03,Summer,2012,May,13,0,Thursday,1,Clear,0.6,0.5909,0.69,0.194,48,217,265,242,265,265
11602,2012-05-03,Summer,2012,May,14,0,Thursday,1,Clear,0.64,0.6061,0.65,0.194,33,171,204,242,204,204
11603,2012-05-03,Summer,2012,May,15,0,Thursday,1,Clear,0.66,0.6212,0.61,0.194,63,220,283,242,283,283
11604,2012-05-03,Summer,2012,May,16,0,Thursday,1,Clear,0.68,0.6364,0.57,0.1642,45,325,370,242,370,370
11605,2012-05-03,Summer,2012,May,17,0,Thursday,1,Clear,0.72,0.6667,0.54,0.1343,87,617,704,242,704,704
11606,2012-05-03,Summer,2012,May,18,0,Thursday,1,Clear,0.72,0.6667,0.58,0.1343,64,642,706,242,706,706
11607,2012-05-03,Summer,2012,May,19,0,Thursday,1,Clear,0.7,0.6515,0.61,0.194,55,467,522,242,522,522
11608,2012-05-03,Summer,2012,May,20,0,Thursday,1,Clear,0.64,0.6061,0.73,0.194,52,368,420,242,420,420
11609,2012-05-03,Summer,2012,May,21,0,Thursday,1,Clear,0.62,0.5909,0.78,0.1343,42,257,299,242,299,299
11610,2012-05-03,Summer,2012,May,22,0,Thursday,1,Clear,0.62,0.5909,0.78,0.0,29,217,246,242,246,246
11611,2012-05-03,Summer,2012,May,23,0,Thursday,1,Clear,0.6,0.5606,0.83,0.0,21,100,121,242,121,121
11612,2012-05-04,Summer,2012,May,0,0,Friday,1,Clear,0.6,0.5758,0.78,0.3284,19,70,89,241,89,89
11613,2012-05-04,Summer,2012,May,1,0,Friday,1,Clear,0.6,0.5758,0.78,0.1045,15,33,48,241,48,48
11614,2012-05-04,Summer,2012,May,2,0,Friday,1,Clear,0.58,0.5455,0.83,0.1343,0,11,11,241,11,11
11615,2012-05-04,Summer,2012,May,3,0,Friday,1,Clear,0.56,0.5303,0.88,0.2239,0,14,14,241,14,14
11616,2012-05-04,Summer,2012,May,4,0,Friday,1,Clear,0.56,0.5303,0.88,0.194,0,4,4,241,4,4
11617,2012-05-04,Summer,2012,May,5,0,Friday,1,Clear,0.56,0.5303,0.88,0.194,0,24,24,241,24,24
11618,2012-05-04,Summer,2012,May,6,0,Friday,1,Clear,0.54,0.5152,0.94,0.1045,8,127,135,241,135,135
11619,2012-05-04,Summer,2012,May,7,0,Friday,1,Clear,0.56,0.5303,0.88,0.0,9,347,356,241,356,356
11620,2012-05-04,Summer,2012,May,8,0,Friday,1,Clear,0.56,0.5303,0.88,0.0,34,584,618,241,618,618
11621,2012-05-04,Summer,2012,May,9,0,Friday,1,Clear,0.6,0.5758,0.78,0.0,32,262,294,241,294,294
11622,2012-05-04,Summer,2012,May,10,0,Friday,1,Misty,0.62,0.5909,0.73,0.1343,45,154,199,241,199,199
11623,2012-05-04,Summer,2012,May,11,0,Friday,1,Misty,0.7,0.6515,0.61,0.0,77,181,258,241,258,258
11624,2012-05-04,Summer,2012,May,12,0,Friday,1,Light_rainsnow,0.62,0.5909,0.78,0.3582,46,125,171,241,171,171
11625,2012-05-04,Summer,2012,May,13,0,Friday,1,Misty,0.64,0.6061,0.73,0.0,71,207,278,241,278,278
11626,2012-05-04,Summer,2012,May,14,0,Friday,1,Misty,0.66,0.6212,0.74,0.2836,83,159,242,241,242,242
11627,2012-05-04,Summer,2012,May,15,0,Friday,1,Misty,0.72,0.6818,0.62,0.1045,103,240,343,241,343,343
11628,2012-05-04,Summer,2012,May,16,0,Friday,1,Clear,0.76,0.6818,0.48,0.1642,82,358,440,241,440,440
11629,2012-05-04,Summer,2012,May,17,0,Friday,1,Clear,0.7,0.6515,0.54,0.4627,96,547,643,241,643,643
11630,2012-05-04,Summer,2012,May,18,0,Friday,1,Clear,0.7,0.6515,0.54,0.4627,77,564,641,241,641,641
11631,2012-05-04,Summer,2012,May,19,0,Friday,1,Clear,0.7,0.6515,0.51,0.1343,64,388,452,241,452,452
11632,2012-05-04,Summer,2012,May,20,0,Friday,1,Clear,0.68,0.6364,0.51,0.1045,58,255,313,241,313,313
11633,2012-05-04,Summer,2012,May,21,0,Friday,1,Clear,0.64,0.6061,0.69,0.194,49,186,235,241,235,235
11634,2012-05-04,Summer,2012,May,22,0,Friday,1,Clear,0.6,0.5606,0.83,0.1343,50,182,232,241,232,232
11635,2012-05-04,Summer,2012,May,23,0,Friday,1,Clear,0.6,0.5606,0.83,0.0896,51,205,256,241,256,256
11636,2012-05-05,Summer,2012,May,0,0,Saturday,0,Clear,0.6,0.5606,0.83,0.0,42,111,153,240,153,153
11637,2012-05-05,Summer,2012,May,1,0,Saturday,0,Clear,0.6,0.5606,0.83,0.0,28,79,107,240,107,107
11638,2012-05-05,Summer,2012,May,2,0,Saturday,0,Clear,0.58,0.5455,0.88,0.0,24,51,75,240,75,75
11639,2012-05-05,Summer,2012,May,3,0,Saturday,0,Clear,0.58,0.5455,0.83,0.0,11,21,32,240,32,32
11640,2012-05-05,Summer,2012,May,4,0,Saturday,0,Clear,0.56,0.5303,0.88,0.1045,0,9,9,240,9,9
11641,2012-05-05,Summer,2012,May,5,0,Saturday,0,Clear,0.56,0.5303,0.88,0.0896,8,14,22,240,22,22
11642,2012-05-05,Summer,2012,May,6,0,Saturday,0,Misty,0.54,0.5152,0.94,0.0,9,33,42,240,42,42
11643,2012-05-05,Summer,2012,May,7,0,Saturday,0,Clear,0.56,0.5303,0.88,0.0,8,79,87,240,87,87
11644,2012-05-05,Summer,2012,May,8,0,Saturday,0,Clear,0.58,0.5455,0.83,0.0896,42,155,197,240,197,197
11645,2012-05-05,Summer,2012,May,9,0,Saturday,0,Clear,0.62,0.5909,0.78,0.1045,61,223,284,240,284,284
11646,2012-05-05,Summer,2012,May,10,0,Saturday,0,Clear,0.66,0.6212,0.65,0.1343,148,284,432,240,432,432
11647,2012-05-05,Summer,2012,May,11,0,Saturday,0,Clear,0.7,0.6515,0.58,0.0896,221,354,575,240,575,575
11648,2012-05-05,Summer,2012,May,12,0,Saturday,0,Clear,0.72,0.6667,0.58,0.1045,220,330,550,240,550,550
11649,2012-05-05,Summer,2012,May,13,0,Saturday,0,Clear,0.74,0.6818,0.55,0.1343,217,307,524,240,524,524
11650,2012-05-05,Summer,2012,May,14,0,Saturday,0,Light_rainsnow,0.7,0.6515,0.61,0.2985,187,241,428,240,428,428
11651,2012-05-05,Summer,2012,May,15,0,Saturday,0,Light_rainsnow,0.66,0.6212,0.74,0.194,241,300,541,240,541,541
11652,2012-05-05,Summer,2012,May,16,0,Saturday,0,Misty,0.68,0.6364,0.65,0.3881,230,310,540,240,540,540
11653,2012-05-05,Summer,2012,May,17,0,Saturday,0,Misty,0.68,0.6364,0.65,0.2985,204,298,502,240,502,502
11654,2012-05-05,Summer,2012,May,18,0,Saturday,0,Misty,0.66,0.6212,0.69,0.3582,156,278,434,240,434,434
11655,2012-05-05,Summer,2012,May,19,0,Saturday,0,Misty,0.62,0.5909,0.73,0.3284,151,254,405,240,405,405
11656,2012-05-05,Summer,2012,May,20,0,Saturday,0,Clear,0.6,0.5758,0.78,0.2537,100,209,309,240,309,309
11657,2012-05-05,Summer,2012,May,21,0,Saturday,0,Misty,0.58,0.5455,0.78,0.2239,86,183,269,240,269,269
11658,2012-05-05,Summer,2012,May,22,0,Saturday,0,Misty,0.58,0.5455,0.78,0.194,67,150,217,240,217,217
11659,2012-05-05,Summer,2012,May,23,0,Saturday,0,Misty,0.56,0.5303,0.83,0.2836,35,114,149,240,149,149
11660,2012-05-06,Summer,2012,May,0,0,Sunday,0,Misty,0.56,0.5303,0.83,0.1343,23,111,134,239,134,134
11661,2012-05-06,Summer,2012,May,1,0,Sunday,0,Misty,0.54,0.5152,0.83,0.2239,37,84,121,239,121,121
11662,2012-05-06,Summer,2012,May,2,0,Sunday,0,Misty,0.54,0.5152,0.83,0.2836,29,64,93,239,93,93
11663,2012-05-06,Summer,2012,May,3,0,Sunday,0,Misty,0.54,0.5152,0.83,0.194,9,19,28,239,28,28
11664,2012-05-06,Summer,2012,May,4,0,Sunday,0,Light_rainsnow,0.52,0.5,0.83,0.1642,9,7,16,239,16,16
11665,2012-05-06,Summer,2012,May,5,0,Sunday,0,Light_rainsnow,0.52,0.5,0.83,0.1642,1,10,11,239,11,11
11666,2012-05-06,Summer,2012,May,6,0,Sunday,0,Light_rainsnow,0.52,0.5,0.83,0.2239,3,14,17,239,17,17
11667,2012-05-06,Summer,2012,May,7,0,Sunday,0,Light_rainsnow,0.52,0.5,0.83,0.1642,5,31,36,239,36,36
11668,2012-05-06,Summer,2012,May,8,0,Sunday,0,Misty,0.5,0.4848,0.88,0.1343,23,91,114,239,114,114
11669,2012-05-06,Summer,2012,May,9,0,Sunday,0,Misty,0.52,0.5,0.83,0.1642,63,128,191,239,191,191
11670,2012-05-06,Summer,2012,May,10,0,Sunday,0,Misty,0.54,0.5152,0.77,0.1045,112,221,333,239,333,333
11671,2012-05-06,Summer,2012,May,11,0,Sunday,0,Clear,0.56,0.5303,0.73,0.1045,144,270,414,239,414,414
11672,2012-05-06,Summer,2012,May,12,0,Sunday,0,Misty,0.6,0.6061,0.64,0.0896,207,351,558,239,558,558
11673,2012-05-06,Summer,2012,May,13,0,Sunday,0,Misty,0.6,0.6061,0.64,0.0,197,368,565,239,565,565
11674,2012-05-06,Summer,2012,May,14,0,Sunday,0,Misty,0.6,0.6061,0.64,0.1045,226,292,518,239,518,518
11675,2012-05-06,Summer,2012,May,15,0,Sunday,0,Misty,0.62,0.6061,0.61,0.1045,229,342,571,239,571,571
11676,2012-05-06,Summer,2012,May,16,0,Sunday,0,Misty,0.62,0.6061,0.61,0.0,181,363,544,239,544,544
11677,2012-05-06,Summer,2012,May,17,0,Sunday,0,Misty,0.62,0.6061,0.65,0.1343,195,316,511,239,511,511
11678,2012-05-06,Summer,2012,May,18,0,Sunday,0,Misty,0.62,0.6061,0.61,0.194,131,332,463,239,463,463
11679,2012-05-06,Summer,2012,May,19,0,Sunday,0,Misty,0.6,0.6061,0.64,0.1642,117,266,383,239,383,383
11680,2012-05-06,Summer,2012,May,20,0,Sunday,0,Clear,0.6,0.6061,0.64,0.194,73,203,276,239,276,276
11681,2012-05-06,Summer,2012,May,21,0,Sunday,0,Clear,0.56,0.5303,0.73,0.194,55,148,203,239,203,203
11682,2012-05-06,Summer,2012,May,22,0,Sunday,0,Clear,0.56,0.5303,0.73,0.1642,44,113,157,239,157,157
11683,2012-05-06,Summer,2012,May,23,0,Sunday,0,Clear,0.52,0.5,0.77,0.194,22,80,102,239,102,102
11684,2012-05-07,Summer,2012,May,0,0,Monday,1,Misty,0.52,0.5,0.77,0.1343,13,21,34,238,34,34
11685,2012-05-07,Summer,2012,May,1,0,Monday,1,Misty,0.52,0.5,0.77,0.194,1,8,9,238,9,9
11686,2012-05-07,Summer,2012,May,2,0,Monday,1,Clear,0.5,0.4848,0.77,0.194,1,5,6,238,6,6
11687,2012-05-07,Summer,2012,May,3,0,Monday,1,Clear,0.5,0.4848,0.77,0.194,2,3,5,238,5,5
11688,2012-05-07,Summer,2012,May,4,0,Monday,1,Misty,0.46,0.4545,0.88,0.1343,0,2,2,238,2,2
11689,2012-05-07,Summer,2012,May,5,0,Monday,1,Clear,0.46,0.4545,0.88,0.1045,2,21,23,238,23,23
11690,2012-05-07,Summer,2012,May,6,0,Monday,1,Clear,0.46,0.4545,0.88,0.1045,8,134,142,238,142,142
11691,2012-05-07,Summer,2012,May,7,0,Monday,1,Misty,0.48,0.4697,0.82,0.1045,18,367,385,238,385,385
11692,2012-05-07,Summer,2012,May,8,0,Monday,1,Misty,0.5,0.4848,0.82,0.194,31,608,639,238,639,639
11693,2012-05-07,Summer,2012,May,9,0,Monday,1,Misty,0.5,0.4848,0.82,0.2239,61,289,350,238,350,350
11694,2012-05-07,Summer,2012,May,10,0,Monday,1,Misty,0.52,0.5,0.77,0.194,62,128,190,238,190,190
11695,2012-05-07,Summer,2012,May,11,0,Monday,1,Misty,0.54,0.5152,0.73,0.194,64,149,213,238,213,213
11696,2012-05-07,Summer,2012,May,12,0,Monday,1,Misty,0.56,0.5303,0.68,0.2239,74,189,263,238,263,263
11697,2012-05-07,Summer,2012,May,13,0,Monday,1,Misty,0.6,0.6212,0.53,0.3284,75,197,272,238,272,272
11698,2012-05-07,Summer,2012,May,14,0,Monday,1,Misty,0.62,0.6212,0.5,0.3582,59,180,239,238,239,239
11699,2012-05-07,Summer,2012,May,15,0,Monday,1,Misty,0.62,0.6212,0.53,0.2985,76,186,262,238,262,262
11700,2012-05-07,Summer,2012,May,16,0,Monday,1,Misty,0.6,0.6212,0.53,0.3881,68,320,388,238,388,388
11701,2012-05-07,Summer,2012,May,17,0,Monday,1,Misty,0.6,0.6212,0.53,0.3284,102,667,769,238,769,769
11702,2012-05-07,Summer,2012,May,18,0,Monday,1,Misty,0.6,0.6212,0.53,0.3582,78,602,680,238,680,680
11703,2012-05-07,Summer,2012,May,19,0,Monday,1,Clear,0.58,0.5455,0.56,0.3284,83,463,546,238,546,546
11704,2012-05-07,Summer,2012,May,20,0,Monday,1,Clear,0.54,0.5152,0.52,0.2836,46,277,323,238,323,323
11705,2012-05-07,Summer,2012,May,21,0,Monday,1,Misty,0.54,0.5152,0.45,0.2239,37,210,247,238,247,247
11706,2012-05-07,Summer,2012,May,22,0,Monday,1,Misty,0.54,0.5152,0.45,0.2537,26,147,173,238,173,173
11707,2012-05-07,Summer,2012,May,23,0,Monday,1,Misty,0.54,0.5152,0.45,0.194,21,92,113,238,113,113
11708,2012-05-08,Summer,2012,May,0,0,Tuesday,1,Misty,0.52,0.5,0.52,0.2537,10,28,38,237,38,38
11709,2012-05-08,Summer,2012,May,1,0,Tuesday,1,Misty,0.52,0.5,0.59,0.2239,6,3,9,237,9,9
11710,2012-05-08,Summer,2012,May,2,0,Tuesday,1,Misty,0.52,0.5,0.63,0.2985,9,7,16,237,16,16
11711,2012-05-08,Summer,2012,May,3,0,Tuesday,1,Misty,0.52,0.5,0.68,0.2836,2,4,6,237,6,6
11712,2012-05-08,Summer,2012,May,4,0,Tuesday,1,Misty,0.52,0.5,0.68,0.3284,0,5,5,237,5,5
11713,2012-05-08,Summer,2012,May,5,0,Tuesday,1,Misty,0.52,0.5,0.72,0.2836,0,20,20,237,20,20
11714,2012-05-08,Summer,2012,May,6,0,Tuesday,1,Clear,0.5,0.4848,0.77,0.2985,7,158,165,237,165,165
11715,2012-05-08,Summer,2012,May,7,0,Tuesday,1,Clear,0.52,0.5,0.72,0.2836,21,442,463,237,463,463
11716,2012-05-08,Summer,2012,May,8,0,Tuesday,1,Misty,0.54,0.5152,0.73,0.2985,36,605,641,237,641,641
11717,2012-05-08,Summer,2012,May,9,0,Tuesday,1,Misty,0.56,0.5303,0.68,0.3582,37,258,295,237,295,295
11718,2012-05-08,Summer,2012,May,10,0,Tuesday,1,Misty,0.58,0.5455,0.68,0.4179,46,111,157,237,157,157
11719,2012-05-08,Summer,2012,May,11,0,Tuesday,1,Misty,0.6,0.6061,0.64,0.3881,60,157,217,237,217,217
11720,2012-05-08,Summer,2012,May,12,0,Tuesday,1,Misty,0.62,0.6061,0.65,0.3284,60,203,263,237,263,263
11721,2012-05-08,Summer,2012,May,13,0,Tuesday,1,Light_rainsnow,0.64,0.6061,0.65,0.2537,53,166,219,237,219,219
11722,2012-05-08,Summer,2012,May,14,0,Tuesday,1,Light_rainsnow,0.62,0.6061,0.69,0.3284,8,63,71,237,71,71
11723,2012-05-08,Summer,2012,May,15,0,Tuesday,1,Light_rainsnow,0.62,0.5909,0.73,0.2537,40,94,134,237,134,134
11724,2012-05-08,Summer,2012,May,16,0,Tuesday,1,Light_rainsnow,0.64,0.6061,0.73,0.2239,54,335,389,237,389,389
11725,2012-05-08,Summer,2012,May,17,0,Tuesday,1,Misty,0.64,0.6061,0.69,0.2836,77,640,717,237,717,717
11726,2012-05-08,Summer,2012,May,18,0,Tuesday,1,Misty,0.64,0.6061,0.69,0.2836,69,641,710,237,710,710
11727,2012-05-08,Summer,2012,May,19,0,Tuesday,1,Misty,0.64,0.6061,0.69,0.2836,59,399,458,237,458,458
11728,2012-05-08,Summer,2012,May,20,0,Tuesday,1,Misty,0.64,0.6061,0.69,0.2836,40,262,302,237,302,302
11729,2012-05-08,Summer,2012,May,21,0,Tuesday,1,Misty,0.64,0.6061,0.65,0.2836,21,202,223,237,223,223
11730,2012-05-08,Summer,2012,May,22,0,Tuesday,1,Light_rainsnow,0.6,0.5758,0.78,0.2537,13,134,147,237,147,147
11731,2012-05-08,Summer,2012,May,23,0,Tuesday,1,Light_rainsnow,0.6,0.5758,0.78,0.3284,10,53,63,237,63,63
11732,2012-05-09,Summer,2012,May,0,0,Wednesday,1,Misty,0.58,0.5455,0.83,0.194,8,27,35,236,35,35
11733,2012-05-09,Summer,2012,May,1,0,Wednesday,1,Misty,0.6,0.5758,0.78,0.2537,3,11,14,236,14,14
11734,2012-05-09,Summer,2012,May,2,0,Wednesday,1,Light_rainsnow,0.56,0.5303,0.88,0.4478,0,1,1,236,1,1
11735,2012-05-09,Summer,2012,May,3,0,Wednesday,1,Light_rainsnow,0.56,0.5303,0.88,0.1642,0,2,2,236,2,2
11736,2012-05-09,Summer,2012,May,4,0,Wednesday,1,Light_rainsnow,0.56,0.5303,0.88,0.2239,0,5,5,236,5,5
11737,2012-05-09,Summer,2012,May,5,0,Wednesday,1,Misty,0.56,0.5303,0.88,0.1343,1,27,28,236,28,28
11738,2012-05-09,Summer,2012,May,6,0,Wednesday,1,Misty,0.56,0.5303,0.88,0.1045,5,121,126,236,126,126
11739,2012-05-09,Summer,2012,May,7,0,Wednesday,1,Misty,0.56,0.5303,0.94,0.194,17,401,418,236,418,418
11740,2012-05-09,Summer,2012,May,8,0,Wednesday,1,Misty,0.6,0.5606,0.83,0.1343,28,594,622,236,622,622
11741,2012-05-09,Summer,2012,May,9,0,Wednesday,1,Misty,0.6,0.5606,0.83,0.0,40,285,325,236,325,325
11742,2012-05-09,Summer,2012,May,10,0,Wednesday,1,Misty,0.62,0.6061,0.65,0.2537,40,113,153,236,153,153
11743,2012-05-09,Summer,2012,May,11,0,Wednesday,1,Misty,0.62,0.6212,0.59,0.2985,45,156,201,236,201,201
11744,2012-05-09,Summer,2012,May,12,0,Wednesday,1,Misty,0.62,0.6212,0.57,0.2239,58,222,280,236,280,280
11745,2012-05-09,Summer,2012,May,13,0,Wednesday,1,Misty,0.64,0.6212,0.53,0.2537,50,216,266,236,266,266
11746,2012-05-09,Summer,2012,May,14,0,Wednesday,1,Misty,0.64,0.6212,0.53,0.2537,68,175,243,236,243,243
11747,2012-05-09,Summer,2012,May,15,0,Wednesday,1,Misty,0.64,0.6212,0.53,0.1045,68,191,259,236,259,259
11748,2012-05-09,Summer,2012,May,16,0,Wednesday,1,Misty,0.66,0.6212,0.5,0.194,68,289,357,236,357,357
11749,2012-05-09,Summer,2012,May,17,0,Wednesday,1,Misty,0.64,0.6212,0.53,0.1343,76,629,705,236,705,705
11750,2012-05-09,Summer,2012,May,18,0,Wednesday,1,Light_rainsnow,0.52,0.5,0.77,0.5821,23,349,372,236,372,372
11751,2012-05-09,Summer,2012,May,19,0,Wednesday,1,Light_rainsnow,0.5,0.4848,0.77,0.3582,2,96,98,236,98,98
11752,2012-05-09,Summer,2012,May,20,0,Wednesday,1,Light_rainsnow,0.5,0.4848,0.82,0.2239,3,48,51,236,51,51
11753,2012-05-09,Summer,2012,May,21,0,Wednesday,1,Light_rainsnow,0.5,0.4848,0.82,0.1642,4,30,34,236,34,34
11754,2012-05-09,Summer,2012,May,22,0,Wednesday,1,Light_rainsnow,0.48,0.4697,0.82,0.1045,5,62,67,236,67,67
11755,2012-05-09,Summer,2012,May,23,0,Wednesday,1,Light_rainsnow,0.48,0.4697,0.82,0.194,8,47,55,236,55,55
11756,2012-05-10,Summer,2012,May,0,0,Thursday,1,Light_rainsnow,0.5,0.4848,0.77,0.1642,2,31,33,235,33,33
11757,2012-05-10,Summer,2012,May,1,0,Thursday,1,Misty,0.48,0.4697,0.88,0.1343,2,9,11,235,11,11
11758,2012-05-10,Summer,2012,May,2,0,Thursday,1,Misty,0.48,0.4697,0.88,0.1045,0,3,3,235,3,3
11759,2012-05-10,Summer,2012,May,3,0,Thursday,1,Clear,0.46,0.4545,0.88,0.2239,0,3,3,235,3,3
11760,2012-05-10,Summer,2012,May,4,0,Thursday,1,Clear,0.46,0.4545,0.77,0.194,0,2,2,235,2,2
11761,2012-05-10,Summer,2012,May,5,0,Thursday,1,Clear,0.46,0.4545,0.72,0.2985,1,23,24,235,24,24
11762,2012-05-10,Summer,2012,May,6,0,Thursday,1,Clear,0.44,0.4394,0.72,0.2239,9,130,139,235,139,139
11763,2012-05-10,Summer,2012,May,7,0,Thursday,1,Clear,0.44,0.4394,0.72,0.2985,8,393,401,235,401,401
11764,2012-05-10,Summer,2012,May,8,0,Thursday,1,Clear,0.46,0.4545,0.67,0.3582,27,603,630,235,630,630
11765,2012-05-10,Summer,2012,May,9,0,Thursday,1,Clear,0.5,0.4848,0.59,0.4627,62,299,361,235,361,361
11766,2012-05-10,Summer,2012,May,10,0,Thursday,1,Clear,0.5,0.4848,0.51,0.4179,42,112,154,235,154,154
11767,2012-05-10,Summer,2012,May,11,0,Thursday,1,Clear,0.52,0.5,0.48,0.5224,77,179,256,235,256,256
11768,2012-05-10,Summer,2012,May,12,0,Thursday,1,Clear,0.52,0.5,0.48,0.4179,65,207,272,235,272,272
11769,2012-05-10,Summer,2012,May,13,0,Thursday,1,Clear,0.54,0.5152,0.39,0.4478,90,228,318,235,318,318
11770,2012-05-10,Summer,2012,May,14,0,Thursday,1,Clear,0.56,0.5303,0.37,0.4179,61,186,247,235,247,247
11771,2012-05-10,Summer,2012,May,15,0,Thursday,1,Clear,0.54,0.5152,0.37,0.3881,79,192,271,235,271,271
11772,2012-05-10,Summer,2012,May,16,0,Thursday,1,Clear,0.58,0.5455,0.3,0.4627,87,334,421,235,421,421
11773,2012-05-10,Summer,2012,May,17,0,Thursday,1,Clear,0.6,0.6212,0.31,0.3881,84,648,732,235,732,732
11774,2012-05-10,Summer,2012,May,18,0,Thursday,1,Clear,0.56,0.5303,0.35,0.5224,109,661,770,235,770,770
11775,2012-05-10,Summer,2012,May,19,0,Thursday,1,Clear,0.54,0.5152,0.37,0.3582,84,469,553,235,553,553
11776,2012-05-10,Summer,2012,May,20,0,Thursday,1,Clear,0.52,0.5,0.4,0.3284,59,315,374,235,374,374
11777,2012-05-10,Summer,2012,May,21,0,Thursday,1,Clear,0.5,0.4848,0.42,0.194,19,211,230,235,230,230
11778,2012-05-10,Summer,2012,May,22,0,Thursday,1,Clear,0.5,0.4848,0.42,0.1045,36,196,232,235,232,232
11779,2012-05-10,Summer,2012,May,23,0,Thursday,1,Clear,0.48,0.4697,0.48,0.1045,23,112,135,235,135,135
11780,2012-05-11,Summer,2012,May,0,0,Friday,1,Clear,0.46,0.4545,0.55,0.1045,17,47,64,234,64,64
11781,2012-05-11,Summer,2012,May,1,0,Friday,1,Clear,0.46,0.4545,0.51,0.1343,14,32,46,234,46,46
11782,2012-05-11,Summer,2012,May,2,0,Friday,1,Clear,0.46,0.4545,0.44,0.1642,15,16,31,234,31,31
11783,2012-05-11,Summer,2012,May,3,0,Friday,1,Clear,0.46,0.4545,0.41,0.2836,5,8,13,234,13,13
11784,2012-05-11,Summer,2012,May,4,0,Friday,1,Clear,0.42,0.4242,0.5,0.194,3,6,9,234,9,9
11785,2012-05-11,Summer,2012,May,5,0,Friday,1,Clear,0.42,0.4242,0.47,0.1642,3,23,26,234,26,26
11786,2012-05-11,Summer,2012,May,6,0,Friday,1,Clear,0.42,0.4242,0.5,0.2537,7,128,135,234,135,135
11787,2012-05-11,Summer,2012,May,7,0,Friday,1,Clear,0.42,0.4242,0.5,0.2537,6,345,351,234,351,351
11788,2012-05-11,Summer,2012,May,8,0,Friday,1,Clear,0.46,0.4545,0.44,0.2537,41,579,620,234,620,620
11789,2012-05-11,Summer,2012,May,9,0,Friday,1,Clear,0.48,0.4697,0.41,0.2985,34,288,322,234,322,322
11790,2012-05-11,Summer,2012,May,10,0,Friday,1,Clear,0.52,0.5,0.36,0.3284,69,141,210,234,210,210
11791,2012-05-11,Summer,2012,May,11,0,Friday,1,Clear,0.56,0.5303,0.35,0.2537,88,203,291,234,291,291
11792,2012-05-11,Summer,2012,May,12,0,Friday,1,Clear,0.56,0.5303,0.28,0.4179,89,259,348,234,348,348
11793,2012-05-11,Summer,2012,May,13,0,Friday,1,Clear,0.6,0.6061,0.26,0.3881,100,263,363,234,363,363
11794,2012-05-11,Summer,2012,May,14,0,Friday,1,Clear,0.62,0.6061,0.23,0.2239,116,218,334,234,334,334
11795,2012-05-11,Summer,2012,May,15,0,Friday,1,Clear,0.62,0.6061,0.25,0.194,140,299,439,234,439,439
11796,2012-05-11,Summer,2012,May,16,0,Friday,1,Clear,0.62,0.6061,0.25,0.3284,128,397,525,234,525,525
11797,2012-05-11,Summer,2012,May,17,0,Friday,1,Clear,0.64,0.6061,0.23,0.2537,102,677,779,234,779,779
11798,2012-05-11,Summer,2012,May,18,0,Friday,1,Clear,0.64,0.6061,0.23,0.2836,78,518,596,234,596,596
11799,2012-05-11,Summer,2012,May,19,0,Friday,1,Clear,0.64,0.6061,0.23,0.2537,73,430,503,234,503,503
11800,2012-05-11,Summer,2012,May,20,0,Friday,1,Clear,0.62,0.6061,0.25,0.1343,64,277,341,234,341,341
11801,2012-05-11,Summer,2012,May,21,0,Friday,1,Clear,0.6,0.6061,0.28,0.1045,45,225,270,234,270,270
11802,2012-05-11,Summer,2012,May,22,0,Friday,1,Clear,0.56,0.5303,0.35,0.2239,44,190,234,234,234,234
11803,2012-05-11,Summer,2012,May,23,0,Friday,1,Clear,0.54,0.5152,0.37,0.194,38,142,180,234,180,180
11804,2012-05-12,Summer,2012,May,0,0,Saturday,0,Clear,0.52,0.5,0.42,0.1642,25,111,136,233,136,136
11805,2012-05-12,Summer,2012,May,1,0,Saturday,0,Clear,0.5,0.4848,0.48,0.0,14,79,93,233,93,93
11806,2012-05-12,Summer,2012,May,2,0,Saturday,0,Clear,0.46,0.4545,0.59,0.1343,10,46,56,233,56,56
11807,2012-05-12,Summer,2012,May,3,0,Saturday,0,Clear,0.48,0.4697,0.59,0.0,14,20,34,233,34,34
11808,2012-05-12,Summer,2012,May,4,0,Saturday,0,Clear,0.44,0.4394,0.67,0.1045,3,6,9,233,9,9
11809,2012-05-12,Summer,2012,May,5,0,Saturday,0,Clear,0.42,0.4242,0.67,0.1343,5,8,13,233,13,13
11810,2012-05-12,Summer,2012,May,6,0,Saturday,0,Clear,0.42,0.4242,0.67,0.0896,10,23,33,233,33,33
11811,2012-05-12,Summer,2012,May,7,0,Saturday,0,Clear,0.42,0.4242,0.71,0.1343,10,57,67,233,67,67
11812,2012-05-12,Summer,2012,May,8,0,Saturday,0,Clear,0.52,0.5,0.48,0.0,22,156,178,233,178,178
11813,2012-05-12,Summer,2012,May,9,0,Saturday,0,Clear,0.54,0.5152,0.49,0.0,87,248,335,233,335,335
11814,2012-05-12,Summer,2012,May,10,0,Saturday,0,Clear,0.56,0.5303,0.49,0.0896,132,279,411,233,411,411
11815,2012-05-12,Summer,2012,May,11,0,Saturday,0,Clear,0.62,0.6212,0.41,0.0896,157,365,522,233,522,522
11816,2012-05-12,Summer,2012,May,12,0,Saturday,0,Clear,0.64,0.6212,0.36,0.1642,206,353,559,233,559,559
11817,2012-05-12,Summer,2012,May,13,0,Saturday,0,Clear,0.64,0.6212,0.36,0.194,293,366,659,233,659,659
11818,2012-05-12,Summer,2012,May,14,0,Saturday,0,Clear,0.66,0.6212,0.36,0.194,257,358,615,233,615,615
11819,2012-05-12,Summer,2012,May,15,0,Saturday,0,Clear,0.68,0.6212,0.24,0.194,269,321,590,233,590,590
11820,2012-05-12,Summer,2012,May,16,0,Saturday,0,Misty,0.7,0.6364,0.21,0.194,254,337,591,233,591,591
11821,2012-05-12,Summer,2012,May,17,0,Saturday,0,Misty,0.66,0.6212,0.36,0.194,233,343,576,233,576,576
11822,2012-05-12,Summer,2012,May,18,0,Saturday,0,Misty,0.66,0.6212,0.31,0.194,164,382,546,233,546,546
11823,2012-05-12,Summer,2012,May,19,0,Saturday,0,Misty,0.64,0.6212,0.36,0.1642,166,273,439,233,439,439
11824,2012-05-12,Summer,2012,May,20,0,Saturday,0,Clear,0.62,0.6212,0.46,0.1642,113,174,287,233,287,287
11825,2012-05-12,Summer,2012,May,21,0,Saturday,0,Misty,0.6,0.6061,0.6,0.1343,74,156,230,233,230,230
11826,2012-05-12,Summer,2012,May,22,0,Saturday,0,Clear,0.56,0.5303,0.68,0.1343,62,212,274,233,274,274
11827,2012-05-12,Summer,2012,May,23,0,Saturday,0,Clear,0.58,0.5455,0.56,0.0896,42,134,176,233,176,176
11828,2012-05-13,Summer,2012,May,0,0,Sunday,0,Clear,0.56,0.5303,0.64,0.1642,19,79,98,232,98,98
11829,2012-05-13,Summer,2012,May,1,0,Sunday,0,Misty,0.54,0.5152,0.68,0.1343,22,72,94,232,94,94
11830,2012-05-13,Summer,2012,May,2,0,Sunday,0,Misty,0.54,0.5152,0.68,0.1642,22,60,82,232,82,82
11831,2012-05-13,Summer,2012,May,3,0,Sunday,0,Misty,0.54,0.5152,0.64,0.1343,2,26,28,232,28,28
11832,2012-05-13,Summer,2012,May,4,0,Sunday,0,Misty,0.54,0.5152,0.68,0.194,2,7,9,232,9,9
11833,2012-05-13,Summer,2012,May,5,0,Sunday,0,Clear,0.52,0.5,0.72,0.194,4,8,12,232,12,12
11834,2012-05-13,Summer,2012,May,6,0,Sunday,0,Clear,0.52,0.5,0.68,0.1642,6,15,21,232,21,21
11835,2012-05-13,Summer,2012,May,7,0,Sunday,0,Clear,0.52,0.5,0.68,0.1642,18,42,60,232,60,60
11836,2012-05-13,Summer,2012,May,8,0,Sunday,0,Clear,0.56,0.5303,0.64,0.1642,32,124,156,232,156,156
11837,2012-05-13,Summer,2012,May,9,0,Sunday,0,Clear,0.6,0.6212,0.56,0.1343,79,143,222,232,222,222
11838,2012-05-13,Summer,2012,May,10,0,Sunday,0,Clear,0.6,0.6061,0.6,0.2537,128,222,350,232,350,350
11839,2012-05-13,Summer,2012,May,11,0,Sunday,0,Clear,0.62,0.6212,0.57,0.2537,150,278,428,232,428,428
11840,2012-05-13,Summer,2012,May,12,0,Sunday,0,Clear,0.64,0.6212,0.57,0.2239,189,342,531,232,531,531
11841,2012-05-13,Summer,2012,May,13,0,Sunday,0,Clear,0.68,0.6364,0.54,0.2537,255,347,602,232,602,602
11842,2012-05-13,Summer,2012,May,14,0,Sunday,0,Clear,0.7,0.6515,0.48,0.1343,228,324,552,232,552,552
11843,2012-05-13,Summer,2012,May,15,0,Sunday,0,Clear,0.72,0.6515,0.45,0.3582,190,309,499,232,499,499
11844,2012-05-13,Summer,2012,May,16,0,Sunday,0,Clear,0.72,0.6515,0.42,0.2537,225,339,564,232,564,564
11845,2012-05-13,Summer,2012,May,17,0,Sunday,0,Clear,0.7,0.6364,0.45,0.4179,191,287,478,232,478,478
11846,2012-05-13,Summer,2012,May,18,0,Sunday,0,Misty,0.68,0.6364,0.44,0.3582,129,260,389,232,389,389
11847,2012-05-13,Summer,2012,May,19,0,Sunday,0,Misty,0.66,0.6212,0.5,0.4179,107,232,339,232,339,339
11848,2012-05-13,Summer,2012,May,20,0,Sunday,0,Misty,0.66,0.6212,0.5,0.2836,67,163,230,232,230,230
11849,2012-05-13,Summer,2012,May,21,0,Sunday,0,Misty,0.64,0.6212,0.53,0.194,48,121,169,232,169,169
11850,2012-05-13,Summer,2012,May,22,0,Sunday,0,Misty,0.62,0.6061,0.61,0.1642,42,89,131,232,131,131
11851,2012-05-13,Summer,2012,May,23,0,Sunday,0,Misty,0.62,0.6212,0.57,0.2239,17,57,74,232,74,74
11852,2012-05-14,Summer,2012,May,0,0,Monday,1,Misty,0.6,0.6212,0.56,0.2537,21,14,35,231,35,35
11853,2012-05-14,Summer,2012,May,1,0,Monday,1,Misty,0.6,0.6061,0.6,0.2836,5,6,11,231,11,11
11854,2012-05-14,Summer,2012,May,2,0,Monday,1,Clear,0.6,0.6061,0.6,0.2985,1,1,2,231,2,2
11855,2012-05-14,Summer,2012,May,3,0,Monday,1,Misty,0.58,0.5455,0.68,0.3284,0,2,2,231,2,2
11856,2012-05-14,Summer,2012,May,4,0,Monday,1,Misty,0.54,0.5152,0.77,0.2239,3,3,6,231,6,6
11857,2012-05-14,Summer,2012,May,5,0,Monday,1,Misty,0.54,0.5152,0.77,0.1642,1,25,26,231,26,26
11858,2012-05-14,Summer,2012,May,6,0,Monday,1,Light_rainsnow,0.52,0.5,0.94,0.2985,3,62,65,231,65,65
11859,2012-05-14,Summer,2012,May,7,0,Monday,1,Light_rainsnow,0.52,0.5,0.94,0.194,3,72,75,231,75,75
11860,2012-05-14,Summer,2012,May,8,0,Monday,1,Light_rainsnow,0.54,0.5152,0.88,0.2239,1,155,156,231,156,156
11861,2012-05-14,Summer,2012,May,9,0,Monday,1,Light_rainsnow,0.54,0.5152,0.88,0.2836,5,105,110,231,110,110
11862,2012-05-14,Summer,2012,May,10,0,Monday,1,Light_rainsnow,0.54,0.5152,0.88,0.2537,6,53,59,231,59,59
11863,2012-05-14,Summer,2012,May,11,0,Monday,1,Misty,0.56,0.5303,0.83,0.2239,12,67,79,231,79,79
11864,2012-05-14,Summer,2012,May,12,0,Monday,1,Misty,0.56,0.5303,0.88,0.2836,53,132,185,231,185,185
11865,2012-05-14,Summer,2012,May,13,0,Monday,1,Misty,0.62,0.5909,0.73,0.2239,33,143,176,231,176,176
11866,2012-05-14,Summer,2012,May,14,0,Monday,1,Misty,0.62,0.5909,0.73,0.2537,43,128,171,231,171,171
11867,2012-05-14,Summer,2012,May,15,0,Monday,1,Misty,0.62,0.5909,0.73,0.1642,40,156,196,231,196,196
11868,2012-05-14,Summer,2012,May,16,0,Monday,1,Light_rainsnow,0.62,0.6061,0.69,0.2836,20,91,111,231,111,111
11869,2012-05-14,Summer,2012,May,17,0,Monday,1,Light_rainsnow,0.56,0.5303,0.88,0.2537,25,204,229,231,229,229
11870,2012-05-14,Summer,2012,May,18,0,Monday,1,Misty,0.58,0.5455,0.83,0.0,17,283,300,231,300,300
11871,2012-05-14,Summer,2012,May,19,0,Monday,1,Light_rainsnow,0.58,0.5455,0.88,0.1343,10,294,304,231,304,304
11872,2012-05-14,Summer,2012,May,20,0,Monday,1,Misty,0.58,0.5455,0.88,0.194,11,178,189,231,189,189
11873,2012-05-14,Summer,2012,May,21,0,Monday,1,Misty,0.58,0.5455,0.83,0.0896,7,145,152,231,152,152
11874,2012-05-14,Summer,2012,May,22,0,Monday,1,Misty,0.58,0.5455,0.78,0.0896,11,118,129,231,129,129
11875,2012-05-14,Summer,2012,May,23,0,Monday,1,Misty,0.58,0.5455,0.78,0.1045,11,64,75,231,75,75
11876,2012-05-15,Summer,2012,May,0,0,Tuesday,1,Misty,0.56,0.5303,0.88,0.1343,7,25,32,230,32,32
11877,2012-05-15,Summer,2012,May,1,0,Tuesday,1,Light_rainsnow,0.56,0.5303,0.88,0.1343,5,14,19,230,19,19
11878,2012-05-15,Summer,2012,May,2,0,Tuesday,1,Misty,0.56,0.5303,0.88,0.1343,1,3,4,230,4,4
11879,2012-05-15,Summer,2012,May,3,0,Tuesday,1,Light_rainsnow,0.58,0.5455,0.83,0.1343,1,5,6,230,6,6
11880,2012-05-15,Summer,2012,May,4,0,Tuesday,1,Light_rainsnow,0.56,0.5303,0.94,0.0,1,4,5,230,5,5
11881,2012-05-15,Summer,2012,May,5,0,Tuesday,1,Light_rainsnow,0.56,0.5303,0.94,0.2239,0,8,8,230,8,8
11882,2012-05-15,Summer,2012,May,6,0,Tuesday,1,Light_rainsnow,0.56,0.5303,0.94,0.2239,2,22,24,230,24,24
11883,2012-05-15,Summer,2012,May,7,0,Tuesday,1,Light_rainsnow,0.56,0.5303,0.94,0.1343,1,91,92,230,92,92
11884,2012-05-15,Summer,2012,May,8,0,Tuesday,1,Misty,0.58,0.5455,0.88,0.0896,8,401,409,230,409,409
11885,2012-05-15,Summer,2012,May,9,0,Tuesday,1,Misty,0.58,0.5455,0.88,0.0896,28,327,355,230,355,355
11886,2012-05-15,Summer,2012,May,10,0,Tuesday,1,Clear,0.62,0.5909,0.78,0.1045,27,144,171,230,171,171
11887,2012-05-15,Summer,2012,May,11,0,Tuesday,1,Clear,0.64,0.5909,0.78,0.194,38,186,224,230,224,224
11888,2012-05-15,Summer,2012,May,12,0,Tuesday,1,Clear,0.64,0.6061,0.73,0.194,44,220,264,230,264,264
11889,2012-05-15,Summer,2012,May,13,0,Tuesday,1,Light_rainsnow,0.64,0.6061,0.73,0.194,35,204,239,230,239,239
11890,2012-05-15,Summer,2012,May,14,0,Tuesday,1,Misty,0.64,0.6061,0.73,0.194,39,145,184,230,184,184
11891,2012-05-15,Summer,2012,May,15,0,Tuesday,1,Misty,0.7,0.6515,0.61,0.0896,51,205,256,230,256,256
11892,2012-05-15,Summer,2012,May,16,0,Tuesday,1,Clear,0.68,0.6364,0.65,0.1642,74,300,374,230,374,374
11893,2012-05-15,Summer,2012,May,17,0,Tuesday,1,Clear,0.68,0.6364,0.65,0.1045,75,603,678,230,678,678
11894,2012-05-15,Summer,2012,May,18,0,Tuesday,1,Clear,0.7,0.6515,0.61,0.0896,68,665,733,230,733,733
11895,2012-05-15,Summer,2012,May,19,0,Tuesday,1,Clear,0.66,0.6212,0.69,0.1642,57,455,512,230,512,512
11896,2012-05-15,Summer,2012,May,20,0,Tuesday,1,Light_rainsnow,0.64,0.6061,0.73,0.1343,30,233,263,230,263,263
11897,2012-05-15,Summer,2012,May,21,0,Tuesday,1,Light_rainsnow,0.64,0.6061,0.73,0.2836,11,98,109,230,109,109
11898,2012-05-15,Summer,2012,May,22,0,Tuesday,1,Clear,0.58,0.5455,0.78,0.2239,9,74,83,230,83,83
11899,2012-05-15,Summer,2012,May,23,0,Tuesday,1,Light_rainsnow,0.56,0.5303,0.88,0.1045,13,58,71,230,71,71
11900,2012-05-16,Summer,2012,May,0,0,Wednesday,1,Misty,0.58,0.5455,0.88,0.0,12,27,39,229,39,39
11901,2012-05-16,Summer,2012,May,1,0,Wednesday,1,Misty,0.58,0.5455,0.88,0.1343,7,14,21,229,21,21
11902,2012-05-16,Summer,2012,May,2,0,Wednesday,1,Clear,0.56,0.5303,0.94,0.194,5,14,19,229,19,19
11903,2012-05-16,Summer,2012,May,3,0,Wednesday,1,Clear,0.56,0.5303,0.88,0.1045,1,5,6,229,6,6
11904,2012-05-16,Summer,2012,May,4,0,Wednesday,1,Clear,0.54,0.5152,0.94,0.1343,1,3,4,229,4,4
11905,2012-05-16,Summer,2012,May,5,0,Wednesday,1,Clear,0.54,0.5152,0.94,0.1045,4,34,38,229,38,38
11906,2012-05-16,Summer,2012,May,6,0,Wednesday,1,Clear,0.54,0.5152,0.94,0.0896,8,150,158,229,158,158
11907,2012-05-16,Summer,2012,May,7,0,Wednesday,1,Clear,0.56,0.5303,0.83,0.0,14,426,440,229,440,440
11908,2012-05-16,Summer,2012,May,8,0,Wednesday,1,Clear,0.58,0.5455,0.83,0.0,33,617,650,229,650,650
11909,2012-05-16,Summer,2012,May,9,0,Wednesday,1,Misty,0.6,0.5758,0.78,0.1343,33,314,347,229,347,347
11910,2012-05-16,Summer,2012,May,10,0,Wednesday,1,Clear,0.66,0.6212,0.61,0.0,43,149,192,229,192,192
11911,2012-05-16,Summer,2012,May,11,0,Wednesday,1,Clear,0.7,0.6515,0.54,0.1343,55,212,267,229,267,267
11912,2012-05-16,Summer,2012,May,12,0,Wednesday,1,Clear,0.7,0.6515,0.54,0.194,59,271,330,229,330,330
11913,2012-05-16,Summer,2012,May,13,0,Wednesday,1,Clear,0.72,0.6515,0.42,0.0,77,273,350,229,350,350
11914,2012-05-16,Summer,2012,May,14,0,Wednesday,1,Clear,0.72,0.6515,0.42,0.0896,42,221,263,229,263,263
11915,2012-05-16,Summer,2012,May,15,0,Wednesday,1,Misty,0.72,0.6667,0.48,0.1045,52,222,274,229,274,274
11916,2012-05-16,Summer,2012,May,16,0,Wednesday,1,Clear,0.72,0.6515,0.45,0.1045,70,376,446,229,446,446
11917,2012-05-16,Summer,2012,May,17,0,Wednesday,1,Clear,0.72,0.6667,0.51,0.194,104,769,873,229,873,873
11918,2012-05-16,Summer,2012,May,18,0,Wednesday,1,Clear,0.72,0.6667,0.51,0.2239,97,749,846,229,846,846
11919,2012-05-16,Summer,2012,May,19,0,Wednesday,1,Clear,0.7,0.6515,0.54,0.2836,91,499,590,229,590,590
11920,2012-05-16,Summer,2012,May,20,0,Wednesday,1,Clear,0.66,0.6212,0.65,0.2537,61,398,459,229,459,459
11921,2012-05-16,Summer,2012,May,21,0,Wednesday,1,Clear,0.64,0.6061,0.73,0.194,63,330,393,229,393,393
11922,2012-05-16,Summer,2012,May,22,0,Wednesday,1,Clear,0.64,0.6061,0.73,0.1642,33,253,286,229,286,286
11923,2012-05-16,Summer,2012,May,23,0,Wednesday,1,Clear,0.62,0.5909,0.78,0.1045,26,107,133,229,133,133
11924,2012-05-17,Summer,2012,May,0,0,Thursday,1,Clear,0.6,0.5758,0.78,0.1343,30,49,79,228,79,79
11925,2012-05-17,Summer,2012,May,1,0,Thursday,1,Clear,0.6,0.5606,0.83,0.1642,12,16,28,228,28,28
11926,2012-05-17,Summer,2012,May,2,0,Thursday,1,Clear,0.6,0.5758,0.78,0.1642,8,8,16,228,16,16
11927,2012-05-17,Summer,2012,May,3,0,Thursday,1,Clear,0.6,0.5909,0.73,0.2537,0,3,3,228,3,3
11928,2012-05-17,Summer,2012,May,4,0,Thursday,1,Clear,0.6,0.6061,0.64,0.3284,3,13,16,228,16,16
11929,2012-05-17,Summer,2012,May,5,0,Thursday,1,Clear,0.56,0.5303,0.68,0.3284,1,34,35,228,35,35
11930,2012-05-17,Summer,2012,May,6,0,Thursday,1,Clear,0.54,0.5152,0.73,0.3582,10,149,159,228,159,159
11931,2012-05-17,Summer,2012,May,7,0,Thursday,1,Clear,0.54,0.5152,0.73,0.3881,25,449,474,228,474,474
11932,2012-05-17,Summer,2012,May,8,0,Thursday,1,Clear,0.52,0.5,0.55,0.4478,29,605,634,228,634,634
11933,2012-05-17,Summer,2012,May,9,0,Thursday,1,Clear,0.54,0.5152,0.52,0.4179,57,289,346,228,346,346
11934,2012-05-17,Summer,2012,May,10,0,Thursday,1,Clear,0.56,0.5303,0.52,0.2537,43,162,205,228,205,205
11935,2012-05-17,Summer,2012,May,11,0,Thursday,1,Clear,0.58,0.5455,0.49,0.2239,77,202,279,228,279,279
11936,2012-05-17,Summer,2012,May,12,0,Thursday,1,Clear,0.6,0.6212,0.43,0.194,72,276,348,228,348,348
11937,2012-05-17,Summer,2012,May,13,0,Thursday,1,Clear,0.62,0.6212,0.41,0.194,86,241,327,228,327,327
11938,2012-05-17,Summer,2012,May,14,0,Thursday,1,Clear,0.64,0.6212,0.38,0.194,68,202,270,228,270,270
11939,2012-05-17,Summer,2012,May,15,0,Thursday,1,Clear,0.64,0.6212,0.36,0.2537,83,233,316,228,316,316
11940,2012-05-17,Summer,2012,May,16,0,Thursday,1,Clear,0.66,0.6212,0.31,0.194,86,344,430,228,430,430
11941,2012-05-17,Summer,2012,May,17,0,Thursday,1,Clear,0.66,0.6212,0.31,0.1343,133,719,852,228,852,852
11942,2012-05-17,Summer,2012,May,18,0,Thursday,1,Clear,0.66,0.6212,0.27,0.1642,134,734,868,228,868,868
11943,2012-05-17,Summer,2012,May,19,0,Thursday,1,Clear,0.64,0.6212,0.31,0.194,86,451,537,228,537,537
11944,2012-05-17,Summer,2012,May,20,0,Thursday,1,Clear,0.6,0.6212,0.4,0.194,83,363,446,228,446,446
11945,2012-05-17,Summer,2012,May,21,0,Thursday,1,Clear,0.58,0.5455,0.4,0.1045,45,254,299,228,299,299
11946,2012-05-17,Summer,2012,May,22,0,Thursday,1,Clear,0.56,0.5303,0.43,0.0896,42,209,251,228,251,251
11947,2012-05-17,Summer,2012,May,23,0,Thursday,1,Clear,0.54,0.5152,0.49,0.1343,29,137,166,228,166,166
11948,2012-05-18,Summer,2012,May,0,0,Friday,1,Clear,0.52,0.5,0.59,0.1045,13,57,70,227,70,70
11949,2012-05-18,Summer,2012,May,1,0,Friday,1,Clear,0.5,0.4848,0.59,0.0896,16,33,49,227,49,49
11950,2012-05-18,Summer,2012,May,2,0,Friday,1,Clear,0.48,0.4697,0.67,0.1343,12,9,21,227,21,21
11951,2012-05-18,Summer,2012,May,3,0,Friday,1,Clear,0.46,0.4545,0.72,0.0896,6,8,14,227,14,14
11952,2012-05-18,Summer,2012,May,4,0,Friday,1,Clear,0.46,0.4545,0.77,0.1642,0,11,11,227,11,11
11953,2012-05-18,Summer,2012,May,5,0,Friday,1,Clear,0.46,0.4545,0.77,0.1045,1,33,34,227,34,34
11954,2012-05-18,Summer,2012,May,6,0,Friday,1,Clear,0.44,0.4394,0.77,0.1343,14,168,182,227,182,182
11955,2012-05-18,Summer,2012,May,7,0,Friday,1,Clear,0.46,0.4545,0.82,0.1045,40,475,515,227,515,515
11956,2012-05-18,Summer,2012,May,8,0,Friday,1,Clear,0.52,0.5,0.59,0.1343,49,696,745,227,745,745
11957,2012-05-18,Summer,2012,May,9,0,Friday,1,Clear,0.56,0.5303,0.56,0.1045,57,304,361,227,361,361
11958,2012-05-18,Summer,2012,May,10,0,Friday,1,Clear,0.6,0.6212,0.46,0.1343,74,181,255,227,255,255
11959,2012-05-18,Summer,2012,May,11,0,Friday,1,Clear,0.62,0.6212,0.43,0.0,109,225,334,227,334,334
11960,2012-05-18,Summer,2012,May,12,0,Friday,1,Clear,0.62,0.6212,0.41,0.194,108,252,360,227,360,360
11961,2012-05-18,Summer,2012,May,13,0,Friday,1,Clear,0.64,0.6212,0.36,0.1642,98,297,395,227,395,395
11962,2012-05-18,Summer,2012,May,14,0,Friday,1,Clear,0.66,0.6212,0.34,0.1343,108,242,350,227,350,350
11963,2012-05-18,Summer,2012,May,15,0,Friday,1,Clear,0.66,0.6212,0.36,0.194,131,260,391,227,391,391
11964,2012-05-18,Summer,2012,May,16,0,Friday,1,Clear,0.66,0.6212,0.34,0.2537,151,417,568,227,568,568
11965,2012-05-18,Summer,2012,May,17,0,Friday,1,Clear,0.66,0.6212,0.34,0.1343,124,688,812,227,812,812
11966,2012-05-18,Summer,2012,May,18,0,Friday,1,Clear,0.64,0.6212,0.38,0.2239,99,570,669,227,669,669
11967,2012-05-18,Summer,2012,May,19,0,Friday,1,Clear,0.62,0.6212,0.41,0.194,91,392,483,227,483,483
11968,2012-05-18,Summer,2012,May,20,0,Friday,1,Clear,0.62,0.6212,0.41,0.1642,73,264,337,227,337,337
11969,2012-05-18,Summer,2012,May,21,0,Friday,1,Clear,0.6,0.6212,0.4,0.0,49,209,258,227,258,258
11970,2012-05-18,Summer,2012,May,22,0,Friday,1,Clear,0.56,0.5303,0.52,0.3284,57,194,251,227,251,251
11971,2012-05-18,Summer,2012,May,23,0,Friday,1,Clear,0.52,0.5,0.55,0.0,41,133,174,227,174,174
11972,2012-05-19,Summer,2012,May,0,0,Saturday,0,Clear,0.52,0.5,0.48,0.1045,30,118,148,226,148,148
11973,2012-05-19,Summer,2012,May,1,0,Saturday,0,Clear,0.5,0.4848,0.48,0.0,20,84,104,226,104,104
11974,2012-05-19,Summer,2012,May,2,0,Saturday,0,Clear,0.5,0.4848,0.51,0.1045,13,56,69,226,69,69
11975,2012-05-19,Summer,2012,May,3,0,Saturday,0,Clear,0.5,0.4848,0.48,0.1045,10,23,33,226,33,33
11976,2012-05-19,Summer,2012,May,4,0,Saturday,0,Clear,0.48,0.4697,0.59,0.0896,6,8,14,226,14,14
11977,2012-05-19,Summer,2012,May,5,0,Saturday,0,Clear,0.46,0.4545,0.67,0.0,1,11,12,226,12,12
11978,2012-05-19,Summer,2012,May,6,0,Saturday,0,Clear,0.44,0.4394,0.72,0.0896,12,38,50,226,50,50
11979,2012-05-19,Summer,2012,May,7,0,Saturday,0,Clear,0.46,0.4545,0.67,0.1045,28,67,95,226,95,95
11980,2012-05-19,Summer,2012,May,8,0,Saturday,0,Clear,0.52,0.5,0.52,0.1642,33,162,195,226,195,195
11981,2012-05-19,Summer,2012,May,9,0,Saturday,0,Clear,0.56,0.5303,0.43,0.1642,79,213,292,226,292,292
11982,2012-05-19,Summer,2012,May,10,0,Saturday,0,Clear,0.56,0.5303,0.43,0.0,177,275,452,226,452,452
11983,2012-05-19,Summer,2012,May,11,0,Saturday,0,Clear,0.62,0.6212,0.38,0.0896,235,351,586,226,586,586
11984,2012-05-19,Summer,2012,May,12,0,Saturday,0,Clear,0.66,0.6212,0.36,0.0,276,366,642,226,642,642
11985,2012-05-19,Summer,2012,May,13,0,Saturday,0,Clear,0.7,0.6364,0.37,0.1343,332,372,704,226,704,704
11986,2012-05-19,Summer,2012,May,14,0,Saturday,0,Clear,0.72,0.6515,0.3,0.0896,361,369,730,226,730,730
11987,2012-05-19,Summer,2012,May,15,0,Saturday,0,Clear,0.72,0.6515,0.3,0.1045,356,316,672,226,672,672
11988,2012-05-19,Summer,2012,May,16,0,Saturday,0,Clear,0.74,0.6515,0.3,0.1045,331,311,642,226,642,642
11989,2012-05-19,Summer,2012,May,17,0,Saturday,0,Clear,0.74,0.6515,0.3,0.0896,279,347,626,226,626,626
11990,2012-05-19,Summer,2012,May,18,0,Saturday,0,Clear,0.74,0.6515,0.33,0.0896,254,391,645,226,645,645
11991,2012-05-19,Summer,2012,May,19,0,Saturday,0,Clear,0.7,0.6364,0.39,0.1343,203,229,432,226,432,432
11992,2012-05-19,Summer,2012,May,20,0,Saturday,0,Clear,0.68,0.6364,0.41,0.0896,118,197,315,226,315,315
11993,2012-05-19,Summer,2012,May,21,0,Saturday,0,Clear,0.64,0.6212,0.5,0.0,81,178,259,226,259,259
11994,2012-05-19,Summer,2012,May,22,0,Saturday,0,Clear,0.64,0.6212,0.47,0.0,104,234,338,226,338,338
11995,2012-05-19,Summer,2012,May,23,0,Saturday,0,Clear,0.6,0.6212,0.56,0.1642,71,168,239,226,239,239
11996,2012-05-20,Summer,2012,May,0,0,Sunday,0,Clear,0.58,0.5455,0.53,0.1045,42,128,170,225,170,170
11997,2012-05-20,Summer,2012,May,1,0,Sunday,0,Clear,0.56,0.5303,0.52,0.0,28,102,130,225,130,130
11998,2012-05-20,Summer,2012,May,2,0,Sunday,0,Clear,0.56,0.5303,0.52,0.0,36,62,98,225,98,98
11999,2012-05-20,Summer,2012,May,3,0,Sunday,0,Clear,0.54,0.5152,0.56,0.0896,26,40,66,225,66,66
12000,2012-05-20,Summer,2012,May,4,0,Sunday,0,Clear,0.52,0.5,0.68,0.0896,2,14,16,225,16,16
12001,2012-05-20,Summer,2012,May,5,0,Sunday,0,Clear,0.5,0.4848,0.72,0.1045,1,7,8,225,8,8
12002,2012-05-20,Summer,2012,May,6,0,Sunday,0,Clear,0.5,0.4848,0.63,0.1343,4,21,25,225,25,25
12003,2012-05-20,Summer,2012,May,7,0,Sunday,0,Clear,0.52,0.5,0.68,0.194,35,55,90,225,90,90
12004,2012-05-20,Summer,2012,May,8,0,Sunday,0,Clear,0.56,0.5303,0.56,0.1642,51,120,171,225,171,171
12005,2012-05-20,Summer,2012,May,9,0,Sunday,0,Clear,0.62,0.6212,0.32,0.2537,129,184,313,225,313,313
12006,2012-05-20,Summer,2012,May,10,0,Sunday,0,Clear,0.66,0.6212,0.34,0.2985,174,258,432,225,432,432
12007,2012-05-20,Summer,2012,May,11,0,Sunday,0,Clear,0.66,0.6212,0.36,0.3284,258,323,581,225,581,581
12008,2012-05-20,Summer,2012,May,12,0,Sunday,0,Clear,0.68,0.6364,0.36,0.3284,247,390,637,225,637,637
12009,2012-05-20,Summer,2012,May,13,0,Sunday,0,Clear,0.7,0.6364,0.37,0.2836,244,363,607,225,607,607
12010,2012-05-20,Summer,2012,May,14,0,Sunday,0,Clear,0.72,0.6515,0.39,0.3881,236,307,543,225,543,543
12011,2012-05-20,Summer,2012,May,15,0,Sunday,0,Misty,0.7,0.6364,0.39,0.4179,246,256,502,225,502,502
12012,2012-05-20,Summer,2012,May,16,0,Sunday,0,Clear,0.72,0.6515,0.42,0.3582,238,339,577,225,577,577
12013,2012-05-20,Summer,2012,May,17,0,Sunday,0,Clear,0.72,0.6515,0.45,0.3284,209,340,549,225,549,549
12014,2012-05-20,Summer,2012,May,18,0,Sunday,0,Clear,0.7,0.6515,0.51,0.3284,146,328,474,225,474,474
12015,2012-05-20,Summer,2012,May,19,0,Sunday,0,Clear,0.66,0.6212,0.61,0.4179,142,260,402,225,402,402
12016,2012-05-20,Summer,2012,May,20,0,Sunday,0,Clear,0.66,0.6212,0.61,0.4179,83,191,274,225,274,274
12017,2012-05-20,Summer,2012,May,21,0,Sunday,0,Clear,0.64,0.6061,0.69,0.3881,51,182,233,225,233,233
12018,2012-05-20,Summer,2012,May,22,0,Sunday,0,Clear,0.62,0.5909,0.73,0.3284,44,101,145,225,145,145
12019,2012-05-20,Summer,2012,May,23,0,Sunday,0,Light_rainsnow,0.6,0.5758,0.78,0.3582,32,54,86,225,86,86
12020,2012-05-21,Summer,2012,May,0,0,Monday,1,Light_rainsnow,0.58,0.5455,0.88,0.2985,12,28,40,224,40,40
12021,2012-05-21,Summer,2012,May,1,0,Monday,1,Light_rainsnow,0.58,0.5455,0.88,0.3582,4,11,15,224,15,15
12022,2012-05-21,Summer,2012,May,2,0,Monday,1,Light_rainsnow,0.56,0.5303,0.94,0.2537,2,9,11,224,11,11
12023,2012-05-21,Summer,2012,May,3,0,Monday,1,Misty,0.56,0.5303,0.88,0.2985,0,2,2,224,2,2
12024,2012-05-21,Summer,2012,May,4,0,Monday,1,Light_rainsnow,0.56,0.5303,0.88,0.2985,2,5,7,224,7,7
12025,2012-05-21,Summer,2012,May,5,0,Monday,1,Light_rainsnow,0.56,0.5303,0.88,0.2985,1,14,15,224,15,15
12026,2012-05-21,Summer,2012,May,6,0,Monday,1,Light_rainsnow,0.56,0.5303,0.88,0.2985,3,76,79,224,79,79
12027,2012-05-21,Summer,2012,May,7,0,Monday,1,Light_rainsnow,0.56,0.5303,0.88,0.2985,7,146,153,224,153,153
12028,2012-05-21,Summer,2012,May,8,0,Monday,1,Light_rainsnow,0.56,0.5303,0.88,0.2537,12,258,270,224,270,270
12029,2012-05-21,Summer,2012,May,9,0,Monday,1,Light_rainsnow,0.56,0.5303,0.88,0.2239,14,172,186,224,186,186
12030,2012-05-21,Summer,2012,May,10,0,Monday,1,Light_rainsnow,0.58,0.5455,0.88,0.2836,28,71,99,224,99,99
12031,2012-05-21,Summer,2012,May,11,0,Monday,1,Misty,0.6,0.5606,0.83,0.1642,24,82,106,224,106,106
12032,2012-05-21,Summer,2012,May,12,0,Monday,1,Misty,0.6,0.5606,0.83,0.2537,46,124,170,224,170,170
12033,2012-05-21,Summer,2012,May,13,0,Monday,1,Light_rainsnow,0.6,0.5606,0.83,0.2537,49,135,184,224,184,184
12034,2012-05-21,Summer,2012,May,14,0,Monday,1,Light_rainsnow,0.6,0.5606,0.83,0.194,45,135,180,224,180,180
12035,2012-05-21,Summer,2012,May,15,0,Monday,1,Misty,0.64,0.6061,0.73,0.194,67,158,225,224,225,225
12036,2012-05-21,Summer,2012,May,16,0,Monday,1,Misty,0.64,0.6061,0.73,0.2537,46,269,315,224,315,315
12037,2012-05-21,Summer,2012,May,17,0,Monday,1,Misty,0.66,0.6212,0.69,0.2537,40,468,508,224,508,508
12038,2012-05-21,Summer,2012,May,18,0,Monday,1,Clear,0.64,0.6061,0.73,0.1045,52,478,530,224,530,530
12039,2012-05-21,Summer,2012,May,19,0,Monday,1,Clear,0.66,0.6212,0.69,0.0896,57,391,448,224,448,448
12040,2012-05-21,Summer,2012,May,20,0,Monday,1,Clear,0.64,0.6061,0.69,0.1343,44,292,336,224,336,336
12041,2012-05-21,Summer,2012,May,21,0,Monday,1,Clear,0.62,0.6061,0.69,0.0896,31,210,241,224,241,241
12042,2012-05-21,Summer,2012,May,22,0,Monday,1,Misty,0.62,0.5909,0.73,0.1642,26,116,142,224,142,142
12043,2012-05-21,Summer,2012,May,23,0,Monday,1,Clear,0.62,0.5909,0.73,0.2836,18,79,97,224,97,97
12044,2012-05-22,Summer,2012,May,0,0,Tuesday,1,Clear,0.58,0.5455,0.83,0.2537,10,26,36,223,36,36
12045,2012-05-22,Summer,2012,May,1,0,Tuesday,1,Misty,0.58,0.5455,0.83,0.1343,11,16,27,223,27,27
12046,2012-05-22,Summer,2012,May,2,0,Tuesday,1,Misty,0.58,0.5455,0.83,0.1045,1,10,11,223,11,11
12047,2012-05-22,Summer,2012,May,3,0,Tuesday,1,Misty,0.58,0.5455,0.83,0.1045,0,5,5,223,5,5
12048,2012-05-22,Summer,2012,May,4,0,Tuesday,1,Misty,0.56,0.5303,0.88,0.1642,0,7,7,223,7,7
12049,2012-05-22,Summer,2012,May,5,0,Tuesday,1,Light_rainsnow,0.56,0.5303,0.88,0.194,0,17,17,223,17,17
12050,2012-05-22,Summer,2012,May,6,0,Tuesday,1,Light_rainsnow,0.56,0.5303,0.88,0.1045,8,129,137,223,137,137
12051,2012-05-22,Summer,2012,May,7,0,Tuesday,1,Light_rainsnow,0.56,0.5303,0.88,0.1045,9,315,324,223,324,324
12052,2012-05-22,Summer,2012,May,8,0,Tuesday,1,Misty,0.56,0.5303,0.88,0.1343,20,570,590,223,590,590
12053,2012-05-22,Summer,2012,May,9,0,Tuesday,1,Misty,0.6,0.5606,0.83,0.1045,46,287,333,223,333,333
12054,2012-05-22,Summer,2012,May,10,0,Tuesday,1,Misty,0.6,0.5758,0.78,0.0896,52,148,200,223,200,200
12055,2012-05-22,Summer,2012,May,11,0,Tuesday,1,Misty,0.6,0.5758,0.78,0.0,39,150,189,223,189,189
12056,2012-05-22,Summer,2012,May,12,0,Tuesday,1,Misty,0.62,0.5909,0.78,0.1045,76,178,254,223,254,254
12057,2012-05-22,Summer,2012,May,13,0,Tuesday,1,Misty,0.64,0.6061,0.73,0.0,48,195,243,223,243,243
12058,2012-05-22,Summer,2012,May,14,0,Tuesday,1,Misty,0.64,0.6061,0.73,0.1045,73,149,222,223,222,222
12059,2012-05-22,Summer,2012,May,15,0,Tuesday,1,Clear,0.7,0.6515,0.61,0.0896,54,191,245,223,245,245
12060,2012-05-22,Summer,2012,May,16,0,Tuesday,1,Clear,0.68,0.6364,0.61,0.1045,70,316,386,223,386,386
12061,2012-05-22,Summer,2012,May,17,0,Tuesday,1,Clear,0.72,0.6667,0.54,0.0,69,716,785,223,785,785
12062,2012-05-22,Summer,2012,May,18,0,Tuesday,1,Clear,0.68,0.6364,0.61,0.1343,76,709,785,223,785,785
12063,2012-05-22,Summer,2012,May,19,0,Tuesday,1,Clear,0.66,0.6212,0.69,0.2239,44,320,364,223,364,364
12064,2012-05-22,Summer,2012,May,20,0,Tuesday,1,Clear,0.64,0.6061,0.73,0.2537,54,319,373,223,373,373
12065,2012-05-22,Summer,2012,May,21,0,Tuesday,1,Clear,0.62,0.5909,0.78,0.1343,28,233,261,223,261,261
12066,2012-05-22,Summer,2012,May,22,0,Tuesday,1,Clear,0.62,0.5909,0.73,0.0896,17,157,174,223,174,174
12067,2012-05-22,Summer,2012,May,23,0,Tuesday,1,Clear,0.62,0.5909,0.73,0.1045,14,91,105,223,105,105
12068,2012-05-23,Summer,2012,May,0,0,Wednesday,1,Clear,0.62,0.5909,0.78,0.1343,19,28,47,222,47,47
12069,2012-05-23,Summer,2012,May,1,0,Wednesday,1,Clear,0.6,0.5606,0.83,0.1642,23,9,32,222,32,32
12070,2012-05-23,Summer,2012,May,2,0,Wednesday,1,Misty,0.6,0.5606,0.83,0.1642,2,10,12,222,12,12
12071,2012-05-23,Summer,2012,May,3,0,Wednesday,1,Clear,0.6,0.5758,0.78,0.1045,0,5,5,222,5,5
12072,2012-05-23,Summer,2012,May,4,0,Wednesday,1,Light_rainsnow,0.58,0.5455,0.83,0.194,0,3,3,222,3,3
12073,2012-05-23,Summer,2012,May,5,0,Wednesday,1,Light_rainsnow,0.56,0.5303,0.88,0.2537,6,29,35,222,35,35
12074,2012-05-23,Summer,2012,May,6,0,Wednesday,1,Clear,0.56,0.5303,0.88,0.1045,6,154,160,222,160,160
12075,2012-05-23,Summer,2012,May,7,0,Wednesday,1,Clear,0.58,0.5455,0.83,0.0,16,452,468,222,468,468
12076,2012-05-23,Summer,2012,May,8,0,Wednesday,1,Clear,0.58,0.5455,0.83,0.0,38,681,719,222,719,719
12077,2012-05-23,Summer,2012,May,9,0,Wednesday,1,Misty,0.62,0.5909,0.78,0.0,39,258,297,222,297,297
12078,2012-05-23,Summer,2012,May,10,0,Wednesday,1,Clear,0.62,0.5909,0.78,0.0896,52,139,191,222,191,191
12079,2012-05-23,Summer,2012,May,11,0,Wednesday,1,Clear,0.64,0.6061,0.73,0.0,46,151,197,222,197,197
12080,2012-05-23,Summer,2012,May,12,0,Wednesday,1,Misty,0.66,0.6212,0.69,0.0896,42,206,248,222,248,248
12081,2012-05-23,Summer,2012,May,13,0,Wednesday,1,Misty,0.66,0.6212,0.74,0.1642,69,201,270,222,270,270
12082,2012-05-23,Summer,2012,May,14,0,Wednesday,1,Clear,0.68,0.6364,0.65,0.1343,67,181,248,222,248,248
12083,2012-05-23,Summer,2012,May,15,0,Wednesday,1,Misty,0.7,0.6515,0.61,0.0,65,192,257,222,257,257
12084,2012-05-23,Summer,2012,May,16,0,Wednesday,1,Light_rainsnow,0.7,0.6515,0.61,0.0896,62,216,278,222,278,278
12085,2012-05-23,Summer,2012,May,17,0,Wednesday,1,Light_rainsnow,0.64,0.6061,0.69,0.1045,45,240,285,222,285,285
12086,2012-05-23,Summer,2012,May,18,0,Wednesday,1,Light_rainsnow,0.64,0.6061,0.69,0.1045,31,296,327,222,327,327
12087,2012-05-23,Summer,2012,May,19,0,Wednesday,1,Misty,0.62,0.5758,0.83,0.1642,40,336,376,222,376,376
12088,2012-05-23,Summer,2012,May,20,0,Wednesday,1,Misty,0.62,0.5758,0.83,0.0896,28,267,295,222,295,295
12089,2012-05-23,Summer,2012,May,21,0,Wednesday,1,Misty,0.62,0.5758,0.83,0.0,24,221,245,222,245,245
12090,2012-05-23,Summer,2012,May,22,0,Wednesday,1,Misty,0.62,0.5758,0.83,0.1642,23,136,159,222,159,159
12091,2012-05-23,Summer,2012,May,23,0,Wednesday,1,Clear,0.6,0.5606,0.83,0.1343,23,83,106,222,106,106
12092,2012-05-24,Summer,2012,May,0,0,Thursday,1,Clear,0.6,0.5606,0.83,0.0896,7,49,56,221,56,56
12093,2012-05-24,Summer,2012,May,1,0,Thursday,1,Clear,0.6,0.5455,0.88,0.0896,9,21,30,221,30,30
12094,2012-05-24,Summer,2012,May,2,0,Thursday,1,Clear,0.6,0.5455,0.88,0.0,1,15,16,221,16,16
12095,2012-05-24,Summer,2012,May,3,0,Thursday,1,Misty,0.6,0.5455,0.88,0.1045,1,3,4,221,4,4
12096,2012-05-24,Summer,2012,May,4,0,Thursday,1,Misty,0.6,0.5455,0.88,0.1642,0,5,5,221,5,5
12097,2012-05-24,Summer,2012,May,5,0,Thursday,1,Misty,0.6,0.5455,0.88,0.1642,1,29,30,221,30,30
12098,2012-05-24,Summer,2012,May,6,0,Thursday,1,Misty,0.6,0.5455,0.88,0.1642,10,146,156,221,156,156
12099,2012-05-24,Summer,2012,May,7,0,Thursday,1,Clear,0.6,0.5606,0.83,0.1045,22,393,415,221,415,415
12100,2012-05-24,Summer,2012,May,8,0,Thursday,1,Clear,0.62,0.5909,0.73,0.1343,33,659,692,221,692,692
12101,2012-05-24,Summer,2012,May,9,0,Thursday,1,Clear,0.62,0.5909,0.73,0.1642,34,267,301,221,301,301
12102,2012-05-24,Summer,2012,May,10,0,Thursday,1,Clear,0.64,0.6061,0.65,0.1343,47,138,185,221,185,185
12103,2012-05-24,Summer,2012,May,11,0,Thursday,1,Clear,0.66,0.6212,0.65,0.1343,61,160,221,221,221,221
12104,2012-05-24,Summer,2012,May,12,0,Thursday,1,Clear,0.7,0.6515,0.58,0.1045,76,213,289,221,289,289
12105,2012-05-24,Summer,2012,May,13,0,Thursday,1,Clear,0.72,0.6667,0.54,0.1642,69,233,302,221,302,302
12106,2012-05-24,Summer,2012,May,14,0,Thursday,1,Clear,0.74,0.6818,0.55,0.2239,72,180,252,221,252,252
12107,2012-05-24,Summer,2012,May,15,0,Thursday,1,Clear,0.74,0.6818,0.55,0.2537,69,222,291,221,291,291
12108,2012-05-24,Summer,2012,May,16,0,Thursday,1,Clear,0.74,0.6818,0.55,0.3582,61,329,390,221,390,390
12109,2012-05-24,Summer,2012,May,17,0,Thursday,1,Clear,0.74,0.6818,0.55,0.2836,120,678,798,221,798,798
12110,2012-05-24,Summer,2012,May,18,0,Thursday,1,Clear,0.72,0.6667,0.54,0.3284,118,634,752,221,752,752
12111,2012-05-24,Summer,2012,May,19,0,Thursday,1,Clear,0.7,0.6515,0.61,0.2985,76,416,492,221,492,492
12112,2012-05-24,Summer,2012,May,20,0,Thursday,1,Misty,0.66,0.6212,0.69,0.2836,55,343,398,221,398,398
12113,2012-05-24,Summer,2012,May,21,0,Thursday,1,Light_rainsnow,0.64,0.5909,0.78,0.1642,48,237,285,221,285,285
12114,2012-05-24,Summer,2012,May,22,0,Thursday,1,Misty,0.64,0.5909,0.78,0.1045,33,210,243,221,243,243
12115,2012-05-24,Summer,2012,May,23,0,Thursday,1,Misty,0.64,0.5909,0.78,0.1343,36,131,167,221,167,167
12116,2012-05-25,Summer,2012,May,0,0,Friday,1,Clear,0.62,0.5758,0.83,0.1343,10,63,73,220,73,73
12117,2012-05-25,Summer,2012,May,1,0,Friday,1,Clear,0.62,0.5758,0.83,0.0896,8,34,42,220,42,42
12118,2012-05-25,Summer,2012,May,2,0,Friday,1,Misty,0.62,0.5758,0.83,0.0,7,16,23,220,23,23
12119,2012-05-25,Summer,2012,May,3,0,Friday,1,Misty,0.62,0.5606,0.88,0.1045,8,6,14,220,14,14
12120,2012-05-25,Summer,2012,May,4,0,Friday,1,Misty,0.62,0.5606,0.88,0.0,3,6,9,220,9,9
12121,2012-05-25,Summer,2012,May,5,0,Friday,1,Misty,0.62,0.5606,0.88,0.0896,2,28,30,220,30,30
12122,2012-05-25,Summer,2012,May,6,0,Friday,1,Misty,0.62,0.5606,0.88,0.1045,5,108,113,220,113,113
12123,2012-05-25,Summer,2012,May,7,0,Friday,1,Misty,0.62,0.5606,0.88,0.1642,7,352,359,220,359,359
12124,2012-05-25,Summer,2012,May,8,0,Friday,1,Misty,0.64,0.5758,0.89,0.1045,32,551,583,220,583,583
12125,2012-05-25,Summer,2012,May,9,0,Friday,1,Misty,0.64,0.5758,0.89,0.1343,52,288,340,220,340,340
12126,2012-05-25,Summer,2012,May,10,0,Friday,1,Clear,0.68,0.6364,0.79,0.1642,69,163,232,220,232,232
12127,2012-05-25,Summer,2012,May,11,0,Friday,1,Clear,0.68,0.6364,0.79,0.1343,90,193,283,220,283,283
12128,2012-05-25,Summer,2012,May,12,0,Friday,1,Clear,0.72,0.6818,0.66,0.1045,84,237,321,220,321,321
12129,2012-05-25,Summer,2012,May,13,0,Friday,1,Clear,0.74,0.6818,0.62,0.1343,86,247,333,220,333,333
12130,2012-05-25,Summer,2012,May,14,0,Friday,1,Clear,0.74,0.6818,0.58,0.1343,104,263,367,220,367,367
12131,2012-05-25,Summer,2012,May,15,0,Friday,1,Clear,0.76,0.7121,0.62,0.194,106,360,466,220,466,466
12132,2012-05-25,Summer,2012,May,16,0,Friday,1,Clear,0.78,0.7121,0.52,0.2239,137,447,584,220,584,584
12133,2012-05-25,Summer,2012,May,17,0,Friday,1,Clear,0.76,0.7121,0.62,0.2836,124,529,653,220,653,653
12134,2012-05-25,Summer,2012,May,18,0,Friday,1,Clear,0.76,0.7121,0.62,0.194,131,391,522,220,522,522
12135,2012-05-25,Summer,2012,May,19,0,Friday,1,Clear,0.74,0.6818,0.62,0.2537,111,293,404,220,404,404
12136,2012-05-25,Summer,2012,May,20,0,Friday,1,Clear,0.7,0.6515,0.65,0.1642,80,270,350,220,350,350
12137,2012-05-25,Summer,2012,May,21,0,Friday,1,Clear,0.7,0.6515,0.65,0.1343,62,193,255,220,255,255
12138,2012-05-25,Summer,2012,May,22,0,Friday,1,Clear,0.66,0.6212,0.74,0.1045,65,147,212,220,212,212
12139,2012-05-25,Summer,2012,May,23,0,Friday,1,Clear,0.66,0.6061,0.78,0.2239,34,132,166,220,166,166
12140,2012-05-26,Summer,2012,May,0,0,Saturday,0,Clear,0.64,0.5758,0.83,0.1642,18,98,116,219,116,116
12141,2012-05-26,Summer,2012,May,1,0,Saturday,0,Clear,0.64,0.5758,0.83,0.1343,18,64,82,219,82,82
12142,2012-05-26,Summer,2012,May,2,0,Saturday,0,Clear,0.64,0.5758,0.89,0.1343,9,55,64,219,64,64
12143,2012-05-26,Summer,2012,May,3,0,Saturday,0,Clear,0.62,0.5606,0.88,0.1045,9,22,31,219,31,31
12144,2012-05-26,Summer,2012,May,4,0,Saturday,0,Clear,0.62,0.5606,0.88,0.1343,0,2,2,219,2,2
12145,2012-05-26,Summer,2012,May,5,0,Saturday,0,Clear,0.62,0.5758,0.83,0.2537,0,10,10,219,10,10
12146,2012-05-26,Summer,2012,May,6,0,Saturday,0,Clear,0.62,0.5606,0.88,0.194,6,25,31,219,31,31
12147,2012-05-26,Summer,2012,May,7,0,Saturday,0,Misty,0.62,0.5606,0.88,0.1642,10,44,54,219,54,54
12148,2012-05-26,Summer,2012,May,8,0,Saturday,0,Clear,0.64,0.5909,0.78,0.1343,38,103,141,219,141,141
12149,2012-05-26,Summer,2012,May,9,0,Saturday,0,Clear,0.64,0.5758,0.83,0.194,97,192,289,219,289,289
12150,2012-05-26,Summer,2012,May,10,0,Saturday,0,Clear,0.68,0.6364,0.79,0.2239,181,256,437,219,437,437
12151,2012-05-26,Summer,2012,May,11,0,Saturday,0,Clear,0.7,0.6667,0.74,0.194,208,312,520,219,520,520
12152,2012-05-26,Summer,2012,May,12,0,Saturday,0,Clear,0.74,0.697,0.66,0.2239,236,293,529,219,529,529
12153,2012-05-26,Summer,2012,May,13,0,Saturday,0,Clear,0.76,0.7273,0.66,0.194,265,274,539,219,539,539
12154,2012-05-26,Summer,2012,May,14,0,Saturday,0,Clear,0.76,0.7273,0.66,0.2239,307,257,564,219,564,564
12155,2012-05-26,Summer,2012,May,15,0,Saturday,0,Clear,0.76,0.7273,0.66,0.2836,274,239,513,219,513,513
12156,2012-05-26,Summer,2012,May,16,0,Saturday,0,Clear,0.78,0.7273,0.55,0.2537,261,243,504,219,504,504
12157,2012-05-26,Summer,2012,May,17,0,Saturday,0,Misty,0.78,0.7121,0.52,0.2537,235,227,462,219,462,462
12158,2012-05-26,Summer,2012,May,18,0,Saturday,0,Misty,0.76,0.697,0.52,0.194,199,216,415,219,415,415
12159,2012-05-26,Summer,2012,May,19,0,Saturday,0,Misty,0.74,0.697,0.66,0.2239,159,214,373,219,373,373
12160,2012-05-26,Summer,2012,May,20,0,Saturday,0,Misty,0.74,0.6818,0.55,0.194,103,152,255,219,255,255
12161,2012-05-26,Summer,2012,May,21,0,Saturday,0,Misty,0.72,0.6818,0.62,0.194,100,151,251,219,251,251
12162,2012-05-26,Summer,2012,May,22,0,Saturday,0,Clear,0.7,0.6667,0.74,0.2537,86,118,204,219,204,204
12163,2012-05-26,Summer,2012,May,23,0,Saturday,0,Clear,0.7,0.6667,0.74,0.2537,36,114,150,219,150,150
12164,2012-05-27,Summer,2012,May,0,0,Sunday,0,Misty,0.68,0.6364,0.69,0.1642,48,89,137,218,137,137
12165,2012-05-27,Summer,2012,May,1,0,Sunday,0,Clear,0.66,0.6212,0.74,0.2239,17,61,78,218,78,78
12166,2012-05-27,Summer,2012,May,2,0,Sunday,0,Clear,0.64,0.6061,0.73,0.2239,16,45,61,218,61,61
12167,2012-05-27,Summer,2012,May,3,0,Sunday,0,Clear,0.64,0.6061,0.73,0.1642,11,25,36,218,36,36
12168,2012-05-27,Summer,2012,May,4,0,Sunday,0,Clear,0.62,0.5758,0.83,0.194,4,7,11,218,11,11
12169,2012-05-27,Summer,2012,May,5,0,Sunday,0,Clear,0.62,0.5758,0.83,0.194,2,5,7,218,7,7
12170,2012-05-27,Summer,2012,May,6,0,Sunday,0,Clear,0.62,0.5758,0.83,0.1642,8,14,22,218,22,22
12171,2012-05-27,Summer,2012,May,7,0,Sunday,0,Clear,0.62,0.5606,0.88,0.1642,22,30,52,218,52,52
12172,2012-05-27,Summer,2012,May,8,0,Sunday,0,Clear,0.64,0.5758,0.83,0.194,69,82,151,218,151,151
12173,2012-05-27,Summer,2012,May,9,0,Sunday,0,Clear,0.66,0.6061,0.83,0.2239,130,140,270,218,270,270
12174,2012-05-27,Summer,2012,May,10,0,Sunday,0,Clear,0.68,0.6364,0.74,0.2537,209,215,424,218,424,424
12175,2012-05-27,Summer,2012,May,11,0,Sunday,0,Clear,0.72,0.6818,0.66,0.2239,268,251,519,218,519,519
12176,2012-05-27,Summer,2012,May,12,0,Sunday,0,Clear,0.74,0.697,0.66,0.2537,301,269,570,218,570,570
12177,2012-05-27,Summer,2012,May,13,0,Sunday,0,Clear,0.76,0.7121,0.58,0.194,270,228,498,218,498,498
12178,2012-05-27,Summer,2012,May,14,0,Sunday,0,Clear,0.76,0.7121,0.58,0.2537,317,230,547,218,547,547
12179,2012-05-27,Summer,2012,May,15,0,Sunday,0,Clear,0.78,0.7121,0.52,0.2836,290,245,535,218,535,535
12180,2012-05-27,Summer,2012,May,16,0,Sunday,0,Clear,0.78,0.7121,0.52,0.2836,258,243,501,218,501,501
12181,2012-05-27,Summer,2012,May,17,0,Sunday,0,Clear,0.78,0.7121,0.49,0.2985,275,247,522,218,522,522
12182,2012-05-27,Summer,2012,May,18,0,Sunday,0,Clear,0.76,0.7121,0.58,0.2985,266,252,518,218,518,518
12183,2012-05-27,Summer,2012,May,19,0,Sunday,0,Clear,0.76,0.7121,0.58,0.194,230,212,442,218,442,442
12184,2012-05-27,Summer,2012,May,20,0,Sunday,0,Clear,0.74,0.6818,0.55,0.1642,168,224,392,218,392,392
12185,2012-05-27,Summer,2012,May,21,0,Sunday,0,Light_rainsnow,0.66,0.6212,0.69,0.4179,64,79,143,218,143,143
12186,2012-05-27,Summer,2012,May,22,0,Sunday,0,Light_rainsnow,0.62,0.5758,0.83,0.0,9,50,59,218,59,59
12187,2012-05-27,Summer,2012,May,23,0,Sunday,0,Light_rainsnow,0.62,0.5758,0.83,0.1343,31,65,96,218,96,96
12188,2012-05-28,Summer,2012,May,0,1,Monday,0,Clear,0.62,0.5758,0.83,0.2239,21,44,65,217,65,65
12189,2012-05-28,Summer,2012,May,1,1,Monday,0,Misty,0.62,0.5909,0.78,0.2985,14,45,59,217,59,59
12190,2012-05-28,Summer,2012,May,2,1,Monday,0,Clear,0.6,0.5606,0.83,0.2239,20,28,48,217,48,48
12191,2012-05-28,Summer,2012,May,3,1,Monday,0,Clear,0.62,0.5909,0.73,0.1642,6,12,18,217,18,18
12192,2012-05-28,Summer,2012,May,4,1,Monday,0,Clear,0.6,0.5758,0.78,0.1343,2,4,6,217,6,6
12193,2012-05-28,Summer,2012,May,5,1,Monday,0,Clear,0.6,0.5758,0.78,0.1343,4,5,9,217,9,9
12194,2012-05-28,Summer,2012,May,6,1,Monday,0,Clear,0.62,0.5909,0.73,0.1642,6,14,20,217,20,20
12195,2012-05-28,Summer,2012,May,7,1,Monday,0,Clear,0.62,0.5909,0.78,0.1045,24,43,67,217,67,67
12196,2012-05-28,Summer,2012,May,8,1,Monday,0,Clear,0.66,0.6212,0.69,0.0,62,93,155,217,155,155
12197,2012-05-28,Summer,2012,May,9,1,Monday,0,Clear,0.7,0.6515,0.61,0.0,121,142,263,217,263,263
12198,2012-05-28,Summer,2012,May,10,1,Monday,0,Clear,0.7,0.6515,0.61,0.0,189,175,364,217,364,364
12199,2012-05-28,Summer,2012,May,11,1,Monday,0,Clear,0.72,0.6818,0.66,0.1343,254,222,476,217,476,476
12200,2012-05-28,Summer,2012,May,12,1,Monday,0,Clear,0.76,0.7121,0.62,0.1343,233,292,525,217,525,525
12201,2012-05-28,Summer,2012,May,13,1,Monday,0,Clear,0.8,0.7879,0.63,0.2836,272,284,556,217,556,556
12202,2012-05-28,Summer,2012,May,14,1,Monday,0,Clear,0.8,0.7879,0.63,0.2836,238,227,465,217,465,465
12203,2012-05-28,Summer,2012,May,15,1,Monday,0,Clear,0.82,0.7879,0.56,0.2985,181,279,460,217,460,460
12204,2012-05-28,Summer,2012,May,16,1,Monday,0,Clear,0.82,0.7879,0.56,0.3284,223,278,501,217,501,501
12205,2012-05-28,Summer,2012,May,17,1,Monday,0,Clear,0.82,0.7879,0.56,0.2985,158,247,405,217,405,405
12206,2012-05-28,Summer,2012,May,18,1,Monday,0,Clear,0.8,0.7727,0.59,0.2985,132,251,383,217,383,383
12207,2012-05-28,Summer,2012,May,19,1,Monday,0,Clear,0.8,0.7576,0.55,0.2985,148,247,395,217,395,395
12208,2012-05-28,Summer,2012,May,20,1,Monday,0,Clear,0.78,0.7424,0.62,0.2985,114,203,317,217,317,317
12209,2012-05-28,Summer,2012,May,21,1,Monday,0,Clear,0.76,0.7273,0.66,0.2836,66,181,247,217,247,247
12210,2012-05-28,Summer,2012,May,22,1,Monday,0,Clear,0.74,0.697,0.7,0.1642,47,110,157,217,157,157
12211,2012-05-28,Summer,2012,May,23,1,Monday,0,Clear,0.72,0.697,0.74,0.1642,22,60,82,217,82,82
12212,2012-05-29,Summer,2012,May,0,0,Tuesday,1,Clear,0.7,0.6667,0.79,0.194,12,33,45,216,45,45
12213,2012-05-29,Summer,2012,May,1,0,Tuesday,1,Clear,0.7,0.6667,0.79,0.194,1,13,14,216,14,14
12214,2012-05-29,Summer,2012,May,2,0,Tuesday,1,Clear,0.68,0.6364,0.83,0.1343,0,8,8,216,8,8
12215,2012-05-29,Summer,2012,May,3,0,Tuesday,1,Clear,0.68,0.6364,0.79,0.2836,1,2,3,216,3,3
12216,2012-05-29,Summer,2012,May,4,0,Tuesday,1,Clear,0.66,0.6061,0.78,0.2239,0,5,5,216,5,5
12217,2012-05-29,Summer,2012,May,5,0,Tuesday,1,Clear,0.66,0.6061,0.78,0.2239,1,32,33,216,33,33
12218,2012-05-29,Summer,2012,May,6,0,Tuesday,1,Clear,0.66,0.6061,0.78,0.2239,9,145,154,216,154,154
12219,2012-05-29,Summer,2012,May,7,0,Tuesday,1,Clear,0.66,0.6061,0.78,0.2239,19,431,450,216,450,450
12220,2012-05-29,Summer,2012,May,8,0,Tuesday,1,Clear,0.7,0.6667,0.74,0.194,46,588,634,216,634,634
12221,2012-05-29,Summer,2012,May,9,0,Tuesday,1,Clear,0.72,0.6818,0.7,0.2537,26,231,257,216,257,257
12222,2012-05-29,Summer,2012,May,10,0,Tuesday,1,Clear,0.74,0.697,0.7,0.2985,67,116,183,216,183,183
12223,2012-05-29,Summer,2012,May,11,0,Tuesday,1,Clear,0.76,0.7121,0.62,0.2985,50,147,197,216,197,197
12224,2012-05-29,Summer,2012,May,12,0,Tuesday,1,Clear,0.8,0.7576,0.55,0.3284,56,181,237,216,237,237
12225,2012-05-29,Summer,2012,May,13,0,Tuesday,1,Clear,0.82,0.7727,0.52,0.3881,63,176,239,216,239,239
12226,2012-05-29,Summer,2012,May,14,0,Tuesday,1,Clear,0.82,0.7727,0.52,0.4179,80,158,238,216,238,238
12227,2012-05-29,Summer,2012,May,15,0,Tuesday,1,Clear,0.82,0.7727,0.49,0.3881,71,185,256,216,256,256
12228,2012-05-29,Summer,2012,May,16,0,Tuesday,1,Clear,0.82,0.7727,0.49,0.4925,73,320,393,216,393,393
12229,2012-05-29,Summer,2012,May,17,0,Tuesday,1,Clear,0.82,0.7576,0.46,0.4179,107,674,781,216,781,781
12230,2012-05-29,Summer,2012,May,18,0,Tuesday,1,Clear,0.8,0.7424,0.49,0.4925,78,632,710,216,710,710
12231,2012-05-29,Summer,2012,May,19,0,Tuesday,1,Clear,0.78,0.7121,0.52,0.3582,69,457,526,216,526,526
12232,2012-05-29,Summer,2012,May,20,0,Tuesday,1,Light_rainsnow,0.7,0.6515,0.61,0.5224,36,168,204,216,204,204
12233,2012-05-29,Summer,2012,May,21,0,Tuesday,1,Light_rainsnow,0.6,0.5455,0.88,0.4478,3,68,71,216,71,71
12234,2012-05-29,Summer,2012,May,22,0,Tuesday,1,Misty,0.62,0.5606,0.88,0.0896,2,53,55,216,55,55
12235,2012-05-29,Summer,2012,May,23,0,Tuesday,1,Light_rainsnow,0.62,0.5455,0.94,0.0,10,40,50,216,50,50
12236,2012-05-30,Summer,2012,May,0,0,Wednesday,1,Light_rainsnow,0.64,0.5758,0.89,0.1045,4,32,36,215,36,36
12237,2012-05-30,Summer,2012,May,1,0,Wednesday,1,Light_rainsnow,0.64,0.5758,0.89,0.194,0,4,4,215,4,4
12238,2012-05-30,Summer,2012,May,2,0,Wednesday,1,Light_rainsnow,0.62,0.5455,0.94,0.0896,1,4,5,215,5,5
12239,2012-05-30,Summer,2012,May,3,0,Wednesday,1,Light_rainsnow,0.62,0.5606,0.88,0.1343,0,5,5,215,5,5
12240,2012-05-30,Summer,2012,May,4,0,Wednesday,1,Misty,0.62,0.5606,0.88,0.1343,0,6,6,215,6,6
12241,2012-05-30,Summer,2012,May,5,0,Wednesday,1,Misty,0.62,0.5909,0.78,0.1343,1,40,41,215,41,41
12242,2012-05-30,Summer,2012,May,6,0,Wednesday,1,Misty,0.6,0.5758,0.78,0.1045,5,139,144,215,144,144
12243,2012-05-30,Summer,2012,May,7,0,Wednesday,1,Light_rainsnow,0.6,0.5758,0.78,0.194,14,469,483,215,483,483
12244,2012-05-30,Summer,2012,May,8,0,Wednesday,1,Misty,0.6,0.5909,0.73,0.1642,29,642,671,215,671,671
12245,2012-05-30,Summer,2012,May,9,0,Wednesday,1,Misty,0.62,0.6061,0.69,0.194,23,282,305,215,305,305
12246,2012-05-30,Summer,2012,May,10,0,Wednesday,1,Misty,0.62,0.6061,0.69,0.2836,39,138,177,215,177,177
12247,2012-05-30,Summer,2012,May,11,0,Wednesday,1,Misty,0.66,0.6212,0.65,0.194,53,155,208,215,208,208
12248,2012-05-30,Summer,2012,May,12,0,Wednesday,1,Clear,0.7,0.6515,0.54,0.0,33,220,253,215,253,253
12249,2012-05-30,Summer,2012,May,13,0,Wednesday,1,Clear,0.7,0.6515,0.51,0.0,53,236,289,215,289,289
12250,2012-05-30,Summer,2012,May,14,0,Wednesday,1,Clear,0.72,0.6515,0.42,0.1343,44,208,252,215,252,252
12251,2012-05-30,Summer,2012,May,15,0,Wednesday,1,Clear,0.72,0.6667,0.51,0.1343,54,221,275,215,275,275
12252,2012-05-30,Summer,2012,May,16,0,Wednesday,1,Clear,0.72,0.6667,0.51,0.1642,46,352,398,215,398,398
12253,2012-05-30,Summer,2012,May,17,0,Wednesday,1,Clear,0.74,0.6667,0.48,0.0896,83,756,839,215,839,839
12254,2012-05-30,Summer,2012,May,18,0,Wednesday,1,Clear,0.74,0.6667,0.48,0.1642,50,746,796,215,796,796
12255,2012-05-30,Summer,2012,May,19,0,Wednesday,1,Clear,0.72,0.6667,0.54,0.1642,50,506,556,215,556,556
12256,2012-05-30,Summer,2012,May,20,0,Wednesday,1,Misty,0.54,0.5152,0.6,0.1343,57,374,431,215,431,431
12257,2012-05-30,Summer,2012,May,21,0,Wednesday,1,Clear,0.68,0.6364,0.57,0.1045,41,263,304,215,304,304
12258,2012-05-30,Summer,2012,May,22,0,Wednesday,1,Clear,0.66,0.6212,0.69,0.1045,26,191,217,215,217,217
12259,2012-05-30,Summer,2012,May,23,0,Wednesday,1,Clear,0.66,0.6212,0.65,0.1045,39,121,160,215,160,160
12260,2012-05-31,Summer,2012,May,0,0,Thursday,1,Clear,0.64,0.6061,0.69,0.1343,13,48,61,214,61,61
12261,2012-05-31,Summer,2012,May,1,0,Thursday,1,Clear,0.64,0.6061,0.69,0.0896,4,22,26,214,26,26
12262,2012-05-31,Summer,2012,May,2,0,Thursday,1,Clear,0.64,0.6061,0.65,0.0896,6,8,14,214,14,14
12263,2012-05-31,Summer,2012,May,3,0,Thursday,1,Clear,0.62,0.6061,0.69,0.0896,0,8,8,214,8,8
12264,2012-05-31,Summer,2012,May,4,0,Thursday,1,Clear,0.62,0.6061,0.69,0.0,0,8,8,214,8,8
12265,2012-05-31,Summer,2012,May,5,0,Thursday,1,Clear,0.62,0.6061,0.69,0.2537,1,32,33,214,33,33
12266,2012-05-31,Summer,2012,May,6,0,Thursday,1,Clear,0.6,0.5909,0.73,0.2239,7,171,178,214,178,178
12267,2012-05-31,Summer,2012,May,7,0,Thursday,1,Clear,0.6,0.6061,0.64,0.2836,18,489,507,214,507,507
12268,2012-05-31,Summer,2012,May,8,0,Thursday,1,Clear,0.62,0.6212,0.57,0.2537,18,675,693,214,693,693
12269,2012-05-31,Summer,2012,May,9,0,Thursday,1,Clear,0.66,0.6212,0.47,0.2537,47,264,311,214,311,311
12270,2012-05-31,Summer,2012,May,10,0,Thursday,1,Clear,0.7,0.6364,0.39,0.3881,65,155,220,214,220,220
12271,2012-05-31,Summer,2012,May,11,0,Thursday,1,Clear,0.72,0.6515,0.37,0.2836,65,153,218,214,218,218
12272,2012-05-31,Summer,2012,May,12,0,Thursday,1,Clear,0.72,0.6515,0.37,0.194,62,230,292,214,292,292
12273,2012-05-31,Summer,2012,May,13,0,Thursday,1,Clear,0.74,0.6515,0.35,0.1343,77,216,293,214,293,293
12274,2012-05-31,Summer,2012,May,14,0,Thursday,1,Clear,0.76,0.6667,0.31,0.194,61,193,254,214,254,254
12275,2012-05-31,Summer,2012,May,15,0,Thursday,1,Clear,0.76,0.6667,0.33,0.2985,81,209,290,214,290,290
12276,2012-05-31,Summer,2012,May,16,0,Thursday,1,Clear,0.76,0.6667,0.33,0.2836,103,384,487,214,487,487
12277,2012-05-31,Summer,2012,May,17,0,Thursday,1,Clear,0.76,0.6667,0.31,0.1642,85,742,827,214,827,827
12278,2012-05-31,Summer,2012,May,18,0,Thursday,1,Clear,0.74,0.6515,0.3,0.194,85,700,785,214,785,785
12279,2012-05-31,Summer,2012,May,19,0,Thursday,1,Clear,0.72,0.6515,0.34,0.1642,104,487,591,214,591,591
12280,2012-05-31,Summer,2012,May,20,0,Thursday,1,Clear,0.68,0.6364,0.44,0.1642,88,391,479,214,479,479
12281,2012-05-31,Summer,2012,May,21,0,Thursday,1,Clear,0.68,0.6364,0.44,0.1642,41,318,359,214,359,359
12282,2012-05-31,Summer,2012,May,22,0,Thursday,1,Clear,0.66,0.6212,0.5,0.1642,43,221,264,214,264,264
12283,2012-05-31,Summer,2012,May,23,0,Thursday,1,Clear,0.66,0.6212,0.54,0.2239,26,114,140,214,140,140
12284,2012-06-01,Summer,2012,Jun,0,0,Friday,1,Clear,0.66,0.6212,0.5,0.2537,10,76,86,213,86,86
12285,2012-06-01,Summer,2012,Jun,1,0,Friday,1,Clear,0.64,0.6212,0.53,0.2239,0,34,34,213,34,34
12286,2012-06-01,Summer,2012,Jun,2,0,Friday,1,Clear,0.64,0.6212,0.57,0.2239,3,13,16,213,16,16
12287,2012-06-01,Summer,2012,Jun,3,0,Friday,1,Misty,0.62,0.5909,0.73,0.0896,0,4,4,213,4,4
12288,2012-06-01,Summer,2012,Jun,4,0,Friday,1,Misty,0.62,0.5909,0.73,0.0896,1,5,6,213,6,6
12289,2012-06-01,Summer,2012,Jun,5,0,Friday,1,Misty,0.62,0.5909,0.78,0.0896,4,41,45,213,45,45
12290,2012-06-01,Summer,2012,Jun,6,0,Friday,1,Light_rainsnow,0.62,0.5606,0.88,0.1343,5,136,141,213,141,141
12291,2012-06-01,Summer,2012,Jun,7,0,Friday,1,Misty,0.64,0.5758,0.89,0.194,33,369,402,213,402,402
12292,2012-06-01,Summer,2012,Jun,8,0,Friday,1,Misty,0.64,0.5758,0.89,0.194,19,675,694,213,694,694
12293,2012-06-01,Summer,2012,Jun,9,0,Friday,1,Misty,0.64,0.5758,0.83,0.2239,24,274,298,213,298,298
12294,2012-06-01,Summer,2012,Jun,10,0,Friday,1,Misty,0.66,0.6061,0.78,0.2836,49,155,204,213,204,204
12295,2012-06-01,Summer,2012,Jun,11,0,Friday,1,Misty,0.7,0.6667,0.74,0.2836,42,193,235,213,235,235
12296,2012-06-01,Summer,2012,Jun,12,0,Friday,1,Misty,0.7,0.6667,0.74,0.3582,72,238,310,213,310,310
12297,2012-06-01,Summer,2012,Jun,13,0,Friday,1,Clear,0.72,0.6818,0.7,0.2985,76,240,316,213,316,316
12298,2012-06-01,Summer,2012,Jun,14,0,Friday,1,Light_rainsnow,0.72,0.6818,0.66,0.2836,55,199,254,213,254,254
12299,2012-06-01,Summer,2012,Jun,15,0,Friday,1,Light_rainsnow,0.72,0.6818,0.66,0.2836,45,213,258,213,258,258
12300,2012-06-01,Summer,2012,Jun,16,0,Friday,1,Light_rainsnow,0.74,0.6818,0.58,0.4478,36,186,222,213,222,222
12301,2012-06-01,Summer,2012,Jun,17,0,Friday,1,Light_rainsnow,0.7,0.6515,0.7,0.2537,25,202,227,213,227,227
12302,2012-06-01,Summer,2012,Jun,18,0,Friday,1,Light_rainsnow,0.62,0.5606,0.88,0.3582,10,100,110,213,110,110
12303,2012-06-01,Summer,2012,Jun,19,0,Friday,1,Light_rainsnow,0.62,0.5606,0.88,0.3582,4,41,45,213,45,45
12304,2012-06-01,Summer,2012,Jun,20,0,Friday,1,Light_rainsnow,0.62,0.5455,0.94,0.2537,1,38,39,213,39,39
12305,2012-06-01,Summer,2012,Jun,21,0,Friday,1,Light_rainsnow,0.64,0.5909,0.78,0.2537,12,73,85,213,85,85
12306,2012-06-01,Summer,2012,Jun,22,0,Friday,1,Light_rainsnow,0.6,0.5455,0.88,0.1343,1,22,23,213,23,23
12307,2012-06-01,Summer,2012,Jun,23,0,Friday,1,Light_rainsnow,0.6,0.5455,0.88,0.1343,6,67,73,213,73,73
12308,2012-06-02,Summer,2012,Jun,0,0,Saturday,0,Misty,0.56,0.5303,0.83,0.1343,5,81,86,212,86,86
12309,2012-06-02,Summer,2012,Jun,1,0,Saturday,0,Misty,0.56,0.5303,0.83,0.1045,15,61,76,212,76,76
12310,2012-06-02,Summer,2012,Jun,2,0,Saturday,0,Misty,0.54,0.5152,0.88,0.0,3,38,41,212,41,41
12311,2012-06-02,Summer,2012,Jun,3,0,Saturday,0,Clear,0.56,0.5303,0.73,0.2537,8,18,26,212,26,26
12312,2012-06-02,Summer,2012,Jun,4,0,Saturday,0,Clear,0.54,0.5152,0.68,0.2836,2,11,13,212,13,13
12313,2012-06-02,Summer,2012,Jun,5,0,Saturday,0,Clear,0.5,0.4848,0.72,0.194,1,11,12,212,12,12
12314,2012-06-02,Summer,2012,Jun,6,0,Saturday,0,Misty,0.5,0.4848,0.77,0.194,5,31,36,212,36,36
12315,2012-06-02,Summer,2012,Jun,7,0,Saturday,0,Clear,0.52,0.5,0.72,0.1045,9,77,86,212,86,86
12316,2012-06-02,Summer,2012,Jun,8,0,Saturday,0,Clear,0.54,0.5152,0.64,0.1642,30,180,210,212,210,210
12317,2012-06-02,Summer,2012,Jun,9,0,Saturday,0,Clear,0.56,0.5303,0.6,0.2537,89,243,332,212,332,332
12318,2012-06-02,Summer,2012,Jun,10,0,Saturday,0,Clear,0.6,0.6212,0.53,0.2985,145,348,493,212,493,493
12319,2012-06-02,Summer,2012,Jun,11,0,Saturday,0,Clear,0.58,0.5455,0.46,0.2836,179,357,536,212,536,536
12320,2012-06-02,Summer,2012,Jun,12,0,Saturday,0,Clear,0.62,0.6212,0.43,0.3582,250,418,668,212,668,668
12321,2012-06-02,Summer,2012,Jun,13,0,Saturday,0,Clear,0.62,0.6212,0.41,0.2537,279,400,679,212,679,679
12322,2012-06-02,Summer,2012,Jun,14,0,Saturday,0,Clear,0.64,0.6212,0.38,0.2985,259,388,647,212,647,647
12323,2012-06-02,Summer,2012,Jun,15,0,Saturday,0,Clear,0.64,0.6212,0.38,0.2537,297,405,702,212,702,702
12324,2012-06-02,Summer,2012,Jun,16,0,Saturday,0,Clear,0.64,0.6212,0.38,0.2537,275,369,644,212,644,644
12325,2012-06-02,Summer,2012,Jun,17,0,Saturday,0,Clear,0.64,0.6212,0.36,0.0,248,338,586,212,586,586
12326,2012-06-02,Summer,2012,Jun,18,0,Saturday,0,Clear,0.64,0.6212,0.36,0.0,171,341,512,212,512,512
12327,2012-06-02,Summer,2012,Jun,19,0,Saturday,0,Clear,0.64,0.6212,0.36,0.1642,185,369,554,212,554,554
12328,2012-06-02,Summer,2012,Jun,20,0,Saturday,0,Clear,0.62,0.6212,0.35,0.2836,139,260,399,212,399,399
12329,2012-06-02,Summer,2012,Jun,21,0,Saturday,0,Clear,0.6,0.6212,0.4,0.1045,96,220,316,212,316,316
12330,2012-06-02,Summer,2012,Jun,22,0,Saturday,0,Clear,0.58,0.5455,0.46,0.1343,52,176,228,212,228,228
12331,2012-06-02,Summer,2012,Jun,23,0,Saturday,0,Clear,0.56,0.5303,0.52,0.1045,53,185,238,212,238,238
12332,2012-06-03,Summer,2012,Jun,0,0,Sunday,0,Clear,0.54,0.5152,0.6,0.1642,27,142,169,211,169,169
12333,2012-06-03,Summer,2012,Jun,1,0,Sunday,0,Clear,0.54,0.5152,0.56,0.1343,21,100,121,211,121,121
12334,2012-06-03,Summer,2012,Jun,2,0,Sunday,0,Clear,0.52,0.5,0.59,0.1045,22,67,89,211,89,89
12335,2012-06-03,Summer,2012,Jun,3,0,Sunday,0,Clear,0.52,0.5,0.63,0.1045,16,34,50,211,50,50
12336,2012-06-03,Summer,2012,Jun,4,0,Sunday,0,Clear,0.5,0.4848,0.72,0.0896,1,12,13,211,13,13
12337,2012-06-03,Summer,2012,Jun,5,0,Sunday,0,Clear,0.5,0.4848,0.68,0.0,1,11,12,211,12,12
12338,2012-06-03,Summer,2012,Jun,6,0,Sunday,0,Clear,0.46,0.4545,0.82,0.1045,6,16,22,211,22,22
12339,2012-06-03,Summer,2012,Jun,7,0,Sunday,0,Clear,0.5,0.4848,0.68,0.1045,6,29,35,211,35,35
12340,2012-06-03,Summer,2012,Jun,8,0,Sunday,0,Clear,0.54,0.5152,0.6,0.0896,30,110,140,211,140,140
12341,2012-06-03,Summer,2012,Jun,9,0,Sunday,0,Clear,0.6,0.6212,0.46,0.194,70,230,300,211,300,300
12342,2012-06-03,Summer,2012,Jun,10,0,Sunday,0,Clear,0.62,0.6212,0.43,0.2239,127,277,404,211,404,404
12343,2012-06-03,Summer,2012,Jun,11,0,Sunday,0,Clear,0.64,0.6212,0.41,0.2537,199,312,511,211,511,511
12344,2012-06-03,Summer,2012,Jun,12,0,Sunday,0,Clear,0.66,0.6212,0.39,0.2985,276,408,684,211,684,684
12345,2012-06-03,Summer,2012,Jun,13,0,Sunday,0,Clear,0.68,0.6364,0.36,0.2836,265,421,686,211,686,686
12346,2012-06-03,Summer,2012,Jun,14,0,Sunday,0,Clear,0.68,0.6364,0.36,0.3284,267,411,678,211,678,678
12347,2012-06-03,Summer,2012,Jun,15,0,Sunday,0,Clear,0.7,0.6364,0.34,0.0,236,408,644,211,644,644
12348,2012-06-03,Summer,2012,Jun,16,0,Sunday,0,Clear,0.7,0.6364,0.34,0.2985,226,436,662,211,662,662
12349,2012-06-03,Summer,2012,Jun,17,0,Sunday,0,Clear,0.7,0.6364,0.34,0.2537,192,386,578,211,578,578
12350,2012-06-03,Summer,2012,Jun,18,0,Sunday,0,Clear,0.7,0.6364,0.34,0.2537,153,343,496,211,496,496
12351,2012-06-03,Summer,2012,Jun,19,0,Sunday,0,Clear,0.68,0.6364,0.34,0.2836,116,337,453,211,453,453
12352,2012-06-03,Summer,2012,Jun,20,0,Sunday,0,Clear,0.66,0.6212,0.39,0.194,84,230,314,211,314,314
12353,2012-06-03,Summer,2012,Jun,21,0,Sunday,0,Clear,0.62,0.6212,0.43,0.1642,66,180,246,211,246,246
12354,2012-06-03,Summer,2012,Jun,22,0,Sunday,0,Clear,0.62,0.6212,0.5,0.3881,61,165,226,211,226,226
12355,2012-06-03,Summer,2012,Jun,23,0,Sunday,0,Clear,0.58,0.5455,0.53,0.1045,26,82,108,211,108,108
12356,2012-06-04,Summer,2012,Jun,0,0,Monday,1,Clear,0.58,0.5455,0.53,0.0,11,38,49,210,49,49
12357,2012-06-04,Summer,2012,Jun,1,0,Monday,1,Light_rainsnow,0.56,0.5303,0.6,0.1642,4,10,14,210,14,14
12358,2012-06-04,Summer,2012,Jun,2,0,Monday,1,Clear,0.56,0.5303,0.6,0.2239,1,10,11,210,11,11
12359,2012-06-04,Summer,2012,Jun,3,0,Monday,1,Misty,0.56,0.5303,0.6,0.1642,0,5,5,210,5,5
12360,2012-06-04,Summer,2012,Jun,4,0,Monday,1,Clear,0.54,0.5152,0.64,0.0896,2,6,8,210,8,8
12361,2012-06-04,Summer,2012,Jun,5,0,Monday,1,Clear,0.52,0.5,0.68,0.0,2,33,35,210,35,35
12362,2012-06-04,Summer,2012,Jun,6,0,Monday,1,Clear,0.52,0.5,0.68,0.0,4,135,139,210,139,139
12363,2012-06-04,Summer,2012,Jun,7,0,Monday,1,Clear,0.56,0.5303,0.6,0.2239,13,504,517,210,517,517
12364,2012-06-04,Summer,2012,Jun,8,0,Monday,1,Clear,0.6,0.6212,0.49,0.2239,22,643,665,210,665,665
12365,2012-06-04,Summer,2012,Jun,9,0,Monday,1,Clear,0.62,0.6212,0.43,0.2836,38,244,282,210,282,282
12366,2012-06-04,Summer,2012,Jun,10,0,Monday,1,Clear,0.64,0.6212,0.41,0.4627,67,120,187,210,187,187
12367,2012-06-04,Summer,2012,Jun,11,0,Monday,1,Clear,0.64,0.6212,0.38,0.4925,71,168,239,210,239,239
12368,2012-06-04,Summer,2012,Jun,12,0,Monday,1,Clear,0.64,0.6212,0.41,0.4478,62,220,282,210,282,282
12369,2012-06-04,Summer,2012,Jun,13,0,Monday,1,Clear,0.64,0.6212,0.41,0.3582,85,189,274,210,274,274
12370,2012-06-04,Summer,2012,Jun,14,0,Monday,1,Clear,0.62,0.6212,0.41,0.4925,84,186,270,210,270,270
12371,2012-06-04,Summer,2012,Jun,15,0,Monday,1,Clear,0.66,0.6212,0.39,0.2985,77,215,292,210,292,292
12372,2012-06-04,Summer,2012,Jun,16,0,Monday,1,Clear,0.66,0.6212,0.39,0.4627,73,375,448,210,448,448
12373,2012-06-04,Summer,2012,Jun,17,0,Monday,1,Clear,0.64,0.6212,0.38,0.4478,101,733,834,210,834,834
12374,2012-06-04,Summer,2012,Jun,18,0,Monday,1,Clear,0.64,0.6212,0.38,0.3881,103,719,822,210,822,822
12375,2012-06-04,Summer,2012,Jun,19,0,Monday,1,Clear,0.62,0.6212,0.38,0.4179,91,554,645,210,645,645
12376,2012-06-04,Summer,2012,Jun,20,0,Monday,1,Clear,0.6,0.6212,0.4,0.3582,71,390,461,210,461,461
12377,2012-06-04,Summer,2012,Jun,21,0,Monday,1,Clear,0.58,0.5455,0.49,0.2537,40,225,265,210,265,265
12378,2012-06-04,Summer,2012,Jun,22,0,Monday,1,Clear,0.56,0.5303,0.52,0.2836,41,127,168,210,168,168
12379,2012-06-04,Summer,2012,Jun,23,0,Monday,1,Clear,0.58,0.5455,0.49,0.2985,8,78,86,210,86,86
12380,2012-06-05,Summer,2012,Jun,0,0,Tuesday,1,Clear,0.54,0.5152,0.68,0.4179,6,28,34,209,34,34
12381,2012-06-05,Summer,2012,Jun,1,0,Tuesday,1,Misty,0.52,0.5,0.77,0.3284,2,18,20,209,20,20
12382,2012-06-05,Summer,2012,Jun,2,0,Tuesday,1,Light_rainsnow,0.52,0.5,0.72,0.2985,0,8,8,209,8,8
12383,2012-06-05,Summer,2012,Jun,3,0,Tuesday,1,Light_rainsnow,0.5,0.4848,0.82,0.194,0,5,5,209,5,5
12384,2012-06-05,Summer,2012,Jun,4,0,Tuesday,1,Light_rainsnow,0.5,0.4848,0.82,0.194,1,4,5,209,5,5
12385,2012-06-05,Summer,2012,Jun,5,0,Tuesday,1,Light_rainsnow,0.48,0.4697,0.82,0.1642,1,35,36,209,36,36
12386,2012-06-05,Summer,2012,Jun,6,0,Tuesday,1,Clear,0.48,0.4697,0.82,0.2537,7,177,184,209,184,184
12387,2012-06-05,Summer,2012,Jun,7,0,Tuesday,1,Clear,0.48,0.4697,0.77,0.2985,29,540,569,209,569,569
12388,2012-06-05,Summer,2012,Jun,8,0,Tuesday,1,Misty,0.48,0.4697,0.77,0.2239,30,680,710,209,710,710
12389,2012-06-05,Summer,2012,Jun,9,0,Tuesday,1,Misty,0.52,0.5,0.72,0.2537,50,285,335,209,335,335
12390,2012-06-05,Summer,2012,Jun,10,0,Tuesday,1,Misty,0.52,0.5,0.63,0.2985,58,118,176,209,176,176
12391,2012-06-05,Summer,2012,Jun,11,0,Tuesday,1,Misty,0.56,0.5303,0.56,0.194,65,162,227,209,227,227
12392,2012-06-05,Summer,2012,Jun,12,0,Tuesday,1,Misty,0.54,0.5152,0.56,0.2239,45,202,247,209,247,247
12393,2012-06-05,Summer,2012,Jun,13,0,Tuesday,1,Misty,0.6,0.6212,0.46,0.1642,66,201,267,209,267,267
12394,2012-06-05,Summer,2012,Jun,14,0,Tuesday,1,Misty,0.58,0.5455,0.46,0.1642,82,194,276,209,276,276
12395,2012-06-05,Summer,2012,Jun,15,0,Tuesday,1,Misty,0.58,0.5455,0.46,0.1343,54,218,272,209,272,272
12396,2012-06-05,Summer,2012,Jun,16,0,Tuesday,1,Clear,0.6,0.6212,0.43,0.194,91,382,473,209,473,473
12397,2012-06-05,Summer,2012,Jun,17,0,Tuesday,1,Clear,0.6,0.6212,0.43,0.0,86,764,850,209,850,850
12398,2012-06-05,Summer,2012,Jun,18,0,Tuesday,1,Clear,0.6,0.6212,0.43,0.194,111,679,790,209,790,790
12399,2012-06-05,Summer,2012,Jun,19,0,Tuesday,1,Clear,0.58,0.5455,0.46,0.2537,68,445,513,209,513,513
12400,2012-06-05,Summer,2012,Jun,20,0,Tuesday,1,Clear,0.56,0.5303,0.49,0.2239,44,371,415,209,415,415
12401,2012-06-05,Summer,2012,Jun,21,0,Tuesday,1,Clear,0.54,0.5152,0.56,0.1642,30,253,283,209,283,283
12402,2012-06-05,Summer,2012,Jun,22,0,Tuesday,1,Clear,0.56,0.5303,0.52,0.1045,22,171,193,209,193,193
12403,2012-06-05,Summer,2012,Jun,23,0,Tuesday,1,Clear,0.54,0.5152,0.56,0.0896,20,93,113,209,113,113
12404,2012-06-06,Summer,2012,Jun,0,0,Wednesday,1,Clear,0.52,0.5,0.59,0.0896,3,46,49,208,49,49
12405,2012-06-06,Summer,2012,Jun,1,0,Wednesday,1,Clear,0.52,0.5,0.68,0.0,6,21,27,208,27,27
12406,2012-06-06,Summer,2012,Jun,2,0,Wednesday,1,Clear,0.5,0.4848,0.68,0.0,4,7,11,208,11,11
12407,2012-06-06,Summer,2012,Jun,3,0,Wednesday,1,Clear,0.46,0.4545,0.82,0.0,0,8,8,208,8,8
12408,2012-06-06,Summer,2012,Jun,4,0,Wednesday,1,Clear,0.46,0.4545,0.82,0.1045,3,7,10,208,10,10
12409,2012-06-06,Summer,2012,Jun,5,0,Wednesday,1,Clear,0.48,0.4697,0.77,0.0,1,37,38,208,38,38
12410,2012-06-06,Summer,2012,Jun,6,0,Wednesday,1,Clear,0.48,0.4697,0.77,0.0,7,165,172,208,172,172
12411,2012-06-06,Summer,2012,Jun,7,0,Wednesday,1,Clear,0.5,0.4848,0.72,0.0,16,531,547,208,547,547
12412,2012-06-06,Summer,2012,Jun,8,0,Wednesday,1,Clear,0.54,0.5152,0.68,0.0,31,637,668,208,668,668
12413,2012-06-06,Summer,2012,Jun,9,0,Wednesday,1,Clear,0.56,0.5303,0.6,0.0896,35,268,303,208,303,303
12414,2012-06-06,Summer,2012,Jun,10,0,Wednesday,1,Clear,0.6,0.6212,0.46,0.0896,55,148,203,208,203,203
12415,2012-06-06,Summer,2012,Jun,11,0,Wednesday,1,Clear,0.62,0.6212,0.43,0.0896,65,161,226,208,226,226
12416,2012-06-06,Summer,2012,Jun,12,0,Wednesday,1,Clear,0.62,0.6212,0.38,0.0,80,235,315,208,315,315
12417,2012-06-06,Summer,2012,Jun,13,0,Wednesday,1,Clear,0.62,0.6212,0.41,0.0896,73,230,303,208,303,303
12418,2012-06-06,Summer,2012,Jun,14,0,Wednesday,1,Clear,0.64,0.6212,0.38,0.0,111,191,302,208,302,302
12419,2012-06-06,Summer,2012,Jun,15,0,Wednesday,1,Clear,0.64,0.6212,0.38,0.0,75,225,300,208,300,300
12420,2012-06-06,Summer,2012,Jun,16,0,Wednesday,1,Clear,0.64,0.6212,0.41,0.1343,107,345,452,208,452,452
12421,2012-06-06,Summer,2012,Jun,17,0,Wednesday,1,Clear,0.62,0.6212,0.43,0.1343,72,652,724,208,724,724
12422,2012-06-06,Summer,2012,Jun,18,0,Wednesday,1,Light_rainsnow,0.6,0.6212,0.53,0.194,94,688,782,208,782,782
12423,2012-06-06,Summer,2012,Jun,19,0,Wednesday,1,Clear,0.56,0.5303,0.73,0.2985,52,486,538,208,538,538
12424,2012-06-06,Summer,2012,Jun,20,0,Wednesday,1,Clear,0.54,0.5152,0.73,0.2836,59,349,408,208,408,408
12425,2012-06-06,Summer,2012,Jun,21,0,Wednesday,1,Clear,0.54,0.5152,0.73,0.1642,38,260,298,208,298,298
12426,2012-06-06,Summer,2012,Jun,22,0,Wednesday,1,Clear,0.52,0.5,0.77,0.0896,27,221,248,208,248,248
12427,2012-06-06,Summer,2012,Jun,23,0,Wednesday,1,Clear,0.52,0.5,0.77,0.0,13,110,123,208,123,123
12428,2012-06-07,Summer,2012,Jun,0,0,Thursday,1,Clear,0.52,0.5,0.77,0.1343,9,50,59,207,59,59
12429,2012-06-07,Summer,2012,Jun,1,0,Thursday,1,Clear,0.52,0.5,0.77,0.1642,5,17,22,207,22,22
12430,2012-06-07,Summer,2012,Jun,2,0,Thursday,1,Clear,0.52,0.5,0.77,0.0896,0,12,12,207,12,12
12431,2012-06-07,Summer,2012,Jun,3,0,Thursday,1,Clear,0.5,0.4848,0.77,0.1045,0,5,5,207,5,5
12432,2012-06-07,Summer,2012,Jun,4,0,Thursday,1,Clear,0.46,0.4545,0.88,0.1045,0,6,6,207,6,6
12433,2012-06-07,Summer,2012,Jun,5,0,Thursday,1,Clear,0.48,0.4697,0.82,0.0896,0,34,34,207,34,34
12434,2012-06-07,Summer,2012,Jun,6,0,Thursday,1,Clear,0.46,0.4545,0.88,0.1045,5,165,170,207,170,170
12435,2012-06-07,Summer,2012,Jun,7,0,Thursday,1,Clear,0.5,0.4848,0.82,0.1642,20,506,526,207,526,526
12436,2012-06-07,Summer,2012,Jun,8,0,Thursday,1,Clear,0.52,0.5,0.77,0.0,20,661,681,207,681,681
12437,2012-06-07,Summer,2012,Jun,9,0,Thursday,1,Clear,0.58,0.5455,0.68,0.0,37,300,337,207,337,337
12438,2012-06-07,Summer,2012,Jun,10,0,Thursday,1,Clear,0.6,0.6061,0.64,0.0896,56,154,210,207,210,210
12439,2012-06-07,Summer,2012,Jun,11,0,Thursday,1,Clear,0.66,0.6212,0.47,0.2239,67,170,237,207,237,237
12440,2012-06-07,Summer,2012,Jun,12,0,Thursday,1,Clear,0.7,0.6364,0.42,0.0,62,274,336,207,336,336
12441,2012-06-07,Summer,2012,Jun,13,0,Thursday,1,Clear,0.7,0.6364,0.37,0.2836,65,250,315,207,315,315
12442,2012-06-07,Summer,2012,Jun,14,0,Thursday,1,Clear,0.72,0.6515,0.37,0.2537,67,198,265,207,265,265
12443,2012-06-07,Summer,2012,Jun,15,0,Thursday,1,Clear,0.74,0.6515,0.3,0.0,99,234,333,207,333,333
12444,2012-06-07,Summer,2012,Jun,16,0,Thursday,1,Clear,0.72,0.6515,0.34,0.2239,77,389,466,207,466,466
12445,2012-06-07,Summer,2012,Jun,17,0,Thursday,1,Clear,0.72,0.6515,0.34,0.2537,91,778,869,207,869,869
12446,2012-06-07,Summer,2012,Jun,18,0,Thursday,1,Clear,0.7,0.6364,0.34,0.2836,110,703,813,207,813,813
12447,2012-06-07,Summer,2012,Jun,19,0,Thursday,1,Clear,0.7,0.6364,0.34,0.2836,65,537,602,207,602,602
12448,2012-06-07,Summer,2012,Jun,20,0,Thursday,1,Clear,0.66,0.6212,0.36,0.2985,76,402,478,207,478,478
12449,2012-06-07,Summer,2012,Jun,21,0,Thursday,1,Clear,0.62,0.6212,0.41,0.3284,30,283,313,207,313,313
12450,2012-06-07,Summer,2012,Jun,22,0,Thursday,1,Clear,0.6,0.6212,0.46,0.1642,35,193,228,207,228,228
12451,2012-06-07,Summer,2012,Jun,23,0,Thursday,1,Clear,0.56,0.5303,0.52,0.1343,42,135,177,207,177,177
12452,2012-06-08,Summer,2012,Jun,0,0,Friday,1,Clear,0.56,0.5303,0.56,0.1642,18,59,77,206,77,77
12453,2012-06-08,Summer,2012,Jun,1,0,Friday,1,Clear,0.56,0.5303,0.56,0.1642,4,25,29,206,29,29
12454,2012-06-08,Summer,2012,Jun,2,0,Friday,1,Clear,0.56,0.5303,0.56,0.0,2,17,19,206,19,19
12455,2012-06-08,Summer,2012,Jun,3,0,Friday,1,Clear,0.54,0.5152,0.6,0.0896,0,8,8,206,8,8
12456,2012-06-08,Summer,2012,Jun,4,0,Friday,1,Clear,0.52,0.5,0.63,0.0,1,9,10,206,10,10
12457,2012-06-08,Summer,2012,Jun,5,0,Friday,1,Clear,0.5,0.4848,0.72,0.1045,1,28,29,206,29,29
12458,2012-06-08,Summer,2012,Jun,6,0,Friday,1,Clear,0.52,0.5,0.68,0.0896,8,131,139,206,139,139
12459,2012-06-08,Summer,2012,Jun,7,0,Friday,1,Clear,0.52,0.5,0.72,0.1045,19,409,428,206,428,428
12460,2012-06-08,Summer,2012,Jun,8,0,Friday,1,Clear,0.58,0.5455,0.6,0.0896,37,663,700,206,700,700
12461,2012-06-08,Summer,2012,Jun,9,0,Friday,1,Clear,0.62,0.6212,0.53,0.1642,47,335,382,206,382,382
12462,2012-06-08,Summer,2012,Jun,10,0,Friday,1,Clear,0.66,0.6212,0.47,0.2537,62,187,249,206,249,249
12463,2012-06-08,Summer,2012,Jun,11,0,Friday,1,Clear,0.7,0.6364,0.42,0.2537,65,199,264,206,264,264
12464,2012-06-08,Summer,2012,Jun,12,0,Friday,1,Clear,0.72,0.6515,0.39,0.3284,89,280,369,206,369,369
12465,2012-06-08,Summer,2012,Jun,13,0,Friday,1,Clear,0.74,0.6515,0.37,0.2537,129,287,416,206,416,416
12466,2012-06-08,Summer,2012,Jun,14,0,Friday,1,Clear,0.76,0.6667,0.31,0.3881,128,245,373,206,373,373
12467,2012-06-08,Summer,2012,Jun,15,0,Friday,1,Clear,0.76,0.6667,0.29,0.2836,98,299,397,206,397,397
12468,2012-06-08,Summer,2012,Jun,16,0,Friday,1,Clear,0.76,0.6667,0.29,0.2985,111,412,523,206,523,523
12469,2012-06-08,Summer,2012,Jun,17,0,Friday,1,Clear,0.76,0.6667,0.29,0.194,114,679,793,206,793,793
12470,2012-06-08,Summer,2012,Jun,18,0,Friday,1,Clear,0.76,0.6667,0.27,0.2239,147,576,723,206,723,723
12471,2012-06-08,Summer,2012,Jun,19,0,Friday,1,Clear,0.74,0.6515,0.3,0.2239,95,460,555,206,555,555
12472,2012-06-08,Summer,2012,Jun,20,0,Friday,1,Clear,0.72,0.6515,0.32,0.1343,117,291,408,206,408,408
12473,2012-06-08,Summer,2012,Jun,21,0,Friday,1,Clear,0.7,0.6364,0.37,0.1343,83,256,339,206,339,339
12474,2012-06-08,Summer,2012,Jun,22,0,Friday,1,Clear,0.68,0.6364,0.41,0.1045,61,230,291,206,291,291
12475,2012-06-08,Summer,2012,Jun,23,0,Friday,1,Clear,0.64,0.6212,0.57,0.1642,52,163,215,206,215,215
12476,2012-06-09,Summer,2012,Jun,0,0,Saturday,0,Clear,0.64,0.6212,0.53,0.1045,54,152,206,205,206,206
12477,2012-06-09,Summer,2012,Jun,1,0,Saturday,0,Clear,0.64,0.6212,0.53,0.0896,34,89,123,205,123,123
12478,2012-06-09,Summer,2012,Jun,2,0,Saturday,0,Clear,0.64,0.6212,0.5,0.2239,21,68,89,205,89,89
12479,2012-06-09,Summer,2012,Jun,3,0,Saturday,0,Clear,0.62,0.6212,0.57,0.0,12,28,40,205,40,40
12480,2012-06-09,Summer,2012,Jun,4,0,Saturday,0,Clear,0.62,0.6212,0.57,0.0,2,6,8,205,8,8
12481,2012-06-09,Summer,2012,Jun,5,0,Saturday,0,Clear,0.6,0.6212,0.56,0.1045,4,15,19,205,19,19
12482,2012-06-09,Summer,2012,Jun,6,0,Saturday,0,Clear,0.56,0.5303,0.64,0.1045,17,63,80,205,80,80
12483,2012-06-09,Summer,2012,Jun,7,0,Saturday,0,Clear,0.58,0.5455,0.64,0.1045,26,61,87,205,87,87
12484,2012-06-09,Summer,2012,Jun,8,0,Saturday,0,Clear,0.62,0.6061,0.61,0.1045,42,202,244,205,244,244
12485,2012-06-09,Summer,2012,Jun,9,0,Saturday,0,Clear,0.64,0.6212,0.57,0.1642,99,241,340,205,340,340
12486,2012-06-09,Summer,2012,Jun,10,0,Saturday,0,Clear,0.7,0.6515,0.51,0.1045,168,298,466,205,466,466
12487,2012-06-09,Summer,2012,Jun,11,0,Saturday,0,Clear,0.76,0.6667,0.35,0.0,218,351,569,205,569,569
12488,2012-06-09,Summer,2012,Jun,12,0,Saturday,0,Clear,0.8,0.697,0.29,0.2537,196,335,531,205,531,531
12489,2012-06-09,Summer,2012,Jun,13,0,Saturday,0,Clear,0.82,0.697,0.24,0.2836,236,349,585,205,585,585
12490,2012-06-09,Summer,2012,Jun,14,0,Saturday,0,Clear,0.82,0.697,0.23,0.194,239,354,593,205,593,593
12491,2012-06-09,Summer,2012,Jun,15,0,Saturday,0,Clear,0.84,0.7121,0.2,0.2985,218,337,555,205,555,555
12492,2012-06-09,Summer,2012,Jun,16,0,Saturday,0,Clear,0.82,0.697,0.24,0.194,219,315,534,205,534,534
12493,2012-06-09,Summer,2012,Jun,17,0,Saturday,0,Clear,0.84,0.7121,0.24,0.0,238,257,495,205,495,495
12494,2012-06-09,Summer,2012,Jun,18,0,Saturday,0,Clear,0.82,0.697,0.24,0.2239,175,276,451,205,451,451
12495,2012-06-09,Summer,2012,Jun,19,0,Saturday,0,Clear,0.8,0.697,0.29,0.1642,128,232,360,205,360,360
12496,2012-06-09,Summer,2012,Jun,20,0,Saturday,0,Clear,0.76,0.6667,0.35,0.2239,125,238,363,205,363,363
12497,2012-06-09,Summer,2012,Jun,21,0,Saturday,0,Clear,0.74,0.6515,0.4,0.194,105,211,316,205,316,316
12498,2012-06-09,Summer,2012,Jun,22,0,Saturday,0,Clear,0.7,0.6515,0.58,0.1642,63,151,214,205,214,214
12499,2012-06-09,Summer,2012,Jun,23,0,Saturday,0,Clear,0.68,0.6364,0.61,0.1642,69,161,230,205,230,230
12500,2012-06-10,Summer,2012,Jun,0,0,Sunday,0,Clear,0.66,0.6212,0.69,0.1045,33,125,158,204,158,158
12501,2012-06-10,Summer,2012,Jun,1,0,Sunday,0,Clear,0.64,0.6061,0.73,0.1343,32,84,116,204,116,116
12502,2012-06-10,Summer,2012,Jun,2,0,Sunday,0,Clear,0.64,0.6061,0.69,0.1343,17,56,73,204,73,73
12503,2012-06-10,Summer,2012,Jun,3,0,Sunday,0,Clear,0.64,0.6061,0.73,0.1045,6,23,29,204,29,29
12504,2012-06-10,Summer,2012,Jun,4,0,Sunday,0,Clear,0.62,0.5909,0.78,0.0896,1,9,10,204,10,10
12505,2012-06-10,Summer,2012,Jun,5,0,Sunday,0,Clear,0.62,0.6061,0.69,0.0896,3,10,13,204,13,13
12506,2012-06-10,Summer,2012,Jun,6,0,Sunday,0,Clear,0.62,0.5909,0.73,0.0,3,27,30,204,30,30
12507,2012-06-10,Summer,2012,Jun,7,0,Sunday,0,Clear,0.6,0.5758,0.78,0.1045,21,41,62,204,62,62
12508,2012-06-10,Summer,2012,Jun,8,0,Sunday,0,Clear,0.64,0.6061,0.73,0.0896,59,122,181,204,181,181
12509,2012-06-10,Summer,2012,Jun,9,0,Sunday,0,Clear,0.7,0.6515,0.58,0.0,91,175,266,204,266,266
12510,2012-06-10,Summer,2012,Jun,10,0,Sunday,0,Clear,0.76,0.6818,0.4,0.1045,148,265,413,204,413,413
12511,2012-06-10,Summer,2012,Jun,11,0,Sunday,0,Clear,0.76,0.6818,0.45,0.0896,184,315,499,204,499,499
12512,2012-06-10,Summer,2012,Jun,12,0,Sunday,0,Clear,0.82,0.7121,0.3,0.0,173,329,502,204,502,502
12513,2012-06-10,Summer,2012,Jun,13,0,Sunday,0,Clear,0.84,0.7273,0.28,0.1343,204,288,492,204,492,492
12514,2012-06-10,Summer,2012,Jun,14,0,Sunday,0,Clear,0.84,0.7273,0.3,0.1343,186,314,500,204,500,500
12515,2012-06-10,Summer,2012,Jun,15,0,Sunday,0,Clear,0.84,0.7273,0.3,0.2239,159,316,475,204,475,475
12516,2012-06-10,Summer,2012,Jun,16,0,Sunday,0,Clear,0.84,0.7424,0.36,0.2836,173,335,508,204,508,508
12517,2012-06-10,Summer,2012,Jun,17,0,Sunday,0,Clear,0.82,0.7424,0.41,0.2836,184,337,521,204,521,521
12518,2012-06-10,Summer,2012,Jun,18,0,Sunday,0,Clear,0.82,0.7273,0.38,0.2239,164,326,490,204,490,490
12519,2012-06-10,Summer,2012,Jun,19,0,Sunday,0,Clear,0.82,0.7121,0.28,0.2836,115,260,375,204,375,375
12520,2012-06-10,Summer,2012,Jun,20,0,Sunday,0,Clear,0.76,0.6818,0.48,0.1642,113,250,363,204,363,363
12521,2012-06-10,Summer,2012,Jun,21,0,Sunday,0,Clear,0.72,0.6818,0.62,0.1642,83,170,253,204,253,253
12522,2012-06-10,Summer,2012,Jun,22,0,Sunday,0,Clear,0.7,0.6515,0.65,0.1642,42,117,159,204,159,159
12523,2012-06-10,Summer,2012,Jun,23,0,Sunday,0,Clear,0.72,0.6667,0.58,0.1045,30,80,110,204,110,110
12524,2012-06-11,Summer,2012,Jun,0,0,Monday,1,Clear,0.7,0.6515,0.65,0.1045,8,33,41,203,41,41
12525,2012-06-11,Summer,2012,Jun,1,0,Monday,1,Clear,0.66,0.6212,0.74,0.1642,9,15,24,203,24,24
12526,2012-06-11,Summer,2012,Jun,2,0,Monday,1,Clear,0.66,0.6212,0.74,0.1045,5,12,17,203,17,17
12527,2012-06-11,Summer,2012,Jun,3,0,Monday,1,Clear,0.64,0.5909,0.78,0.1045,2,4,6,203,6,6
12528,2012-06-11,Summer,2012,Jun,4,0,Monday,1,Clear,0.64,0.5909,0.78,0.1343,0,7,7,203,7,7
12529,2012-06-11,Summer,2012,Jun,5,0,Monday,1,Clear,0.64,0.5909,0.78,0.1343,1,36,37,203,37,37
12530,2012-06-11,Summer,2012,Jun,6,0,Monday,1,Clear,0.62,0.5758,0.83,0.1045,8,136,144,203,144,144
12531,2012-06-11,Summer,2012,Jun,7,0,Monday,1,Clear,0.64,0.5909,0.78,0.1045,25,478,503,203,503,503
12532,2012-06-11,Summer,2012,Jun,8,0,Monday,1,Clear,0.66,0.6212,0.74,0.1343,38,613,651,203,651,651
12533,2012-06-11,Summer,2012,Jun,9,0,Monday,1,Clear,0.7,0.6515,0.65,0.1343,57,259,316,203,316,316
12534,2012-06-11,Summer,2012,Jun,10,0,Monday,1,Clear,0.72,0.6818,0.62,0.1642,52,95,147,203,147,147
12535,2012-06-11,Summer,2012,Jun,11,0,Monday,1,Misty,0.76,0.6818,0.48,0.2239,59,143,202,203,202,202
12536,2012-06-11,Summer,2012,Jun,12,0,Monday,1,Misty,0.8,0.7273,0.43,0.194,63,198,261,203,261,261
12537,2012-06-11,Summer,2012,Jun,13,0,Monday,1,Misty,0.8,0.7121,0.41,0.2985,63,185,248,203,248,248
12538,2012-06-11,Summer,2012,Jun,14,0,Monday,1,Misty,0.82,0.7273,0.34,0.2836,66,193,259,203,259,259
12539,2012-06-11,Summer,2012,Jun,15,0,Monday,1,Clear,0.8,0.7121,0.41,0.3582,72,187,259,203,259,259
12540,2012-06-11,Summer,2012,Jun,16,0,Monday,1,Misty,0.8,0.7121,0.41,0.4179,87,340,427,203,427,427
12541,2012-06-11,Summer,2012,Jun,17,0,Monday,1,Misty,0.8,0.7121,0.41,0.3582,85,715,800,203,800,800
12542,2012-06-11,Summer,2012,Jun,18,0,Monday,1,Misty,0.8,0.7273,0.43,0.2985,105,726,831,203,831,831
12543,2012-06-11,Summer,2012,Jun,19,0,Monday,1,Misty,0.76,0.6818,0.48,0.3284,89,507,596,203,596,596
12544,2012-06-11,Summer,2012,Jun,20,0,Monday,1,Misty,0.74,0.6667,0.48,0.2239,61,333,394,203,394,394
12545,2012-06-11,Summer,2012,Jun,21,0,Monday,1,Misty,0.72,0.6667,0.58,0.194,32,218,250,203,250,250
12546,2012-06-11,Summer,2012,Jun,22,0,Monday,1,Misty,0.72,0.6667,0.58,0.194,22,142,164,203,164,164
12547,2012-06-11,Summer,2012,Jun,23,0,Monday,1,Misty,0.7,0.6515,0.58,0.2239,8,72,80,203,80,80
12548,2012-06-12,Summer,2012,Jun,0,0,Tuesday,1,Misty,0.7,0.6515,0.58,0.2239,2,26,28,202,28,28
12549,2012-06-12,Summer,2012,Jun,1,0,Tuesday,1,Misty,0.68,0.6364,0.65,0.1642,5,11,16,202,16,16
12550,2012-06-12,Summer,2012,Jun,2,0,Tuesday,1,Misty,0.68,0.6364,0.65,0.194,0,6,6,202,6,6
12551,2012-06-12,Summer,2012,Jun,3,0,Tuesday,1,Misty,0.66,0.6212,0.69,0.2537,3,9,12,202,12,12
12552,2012-06-12,Summer,2012,Jun,4,0,Tuesday,1,Light_rainsnow,0.6,0.5455,0.88,0.1642,0,4,4,202,4,4
12553,2012-06-12,Summer,2012,Jun,5,0,Tuesday,1,Light_rainsnow,0.6,0.5455,0.88,0.1343,1,28,29,202,29,29
12554,2012-06-12,Summer,2012,Jun,6,0,Tuesday,1,Misty,0.6,0.5455,0.88,0.1343,6,130,136,202,136,136
12555,2012-06-12,Summer,2012,Jun,7,0,Tuesday,1,Light_rainsnow,0.62,0.5606,0.88,0.2537,16,287,303,202,303,303
12556,2012-06-12,Summer,2012,Jun,8,0,Tuesday,1,Misty,0.62,0.5606,0.88,0.2239,15,598,613,202,613,613
12557,2012-06-12,Summer,2012,Jun,9,0,Tuesday,1,Misty,0.64,0.5758,0.89,0.2836,31,254,285,202,285,285
12558,2012-06-12,Summer,2012,Jun,10,0,Tuesday,1,Light_rainsnow,0.64,0.5758,0.89,0.2836,29,96,125,202,125,125
12559,2012-06-12,Summer,2012,Jun,11,0,Tuesday,1,Light_rainsnow,0.66,0.6061,0.83,0.3582,8,57,65,202,65,65
12560,2012-06-12,Summer,2012,Jun,12,0,Tuesday,1,Light_rainsnow,0.66,0.6061,0.83,0.2537,19,76,95,202,95,95
12561,2012-06-12,Summer,2012,Jun,13,0,Tuesday,1,Light_rainsnow,0.66,0.6061,0.83,0.194,11,48,59,202,59,59
12562,2012-06-12,Summer,2012,Jun,14,0,Tuesday,1,Light_rainsnow,0.64,0.5758,0.89,0.2537,12,48,60,202,60,60
12563,2012-06-12,Summer,2012,Jun,15,0,Tuesday,1,Light_rainsnow,0.66,0.5909,0.89,0.194,22,94,116,202,116,116
12564,2012-06-12,Summer,2012,Jun,16,0,Tuesday,1,Misty,0.66,0.5909,0.89,0.2836,30,209,239,202,239,239
12565,2012-06-12,Summer,2012,Jun,17,0,Tuesday,1,Misty,0.66,0.5909,0.89,0.2836,56,625,681,202,681,681
12566,2012-06-12,Summer,2012,Jun,18,0,Tuesday,1,Clear,0.68,0.6364,0.83,0.194,57,596,653,202,653,653
12567,2012-06-12,Summer,2012,Jun,19,0,Tuesday,1,Clear,0.68,0.6364,0.83,0.194,47,444,491,202,491,491
12568,2012-06-12,Summer,2012,Jun,20,0,Tuesday,1,Clear,0.68,0.6364,0.83,0.194,36,350,386,202,386,386
12569,2012-06-12,Summer,2012,Jun,21,0,Tuesday,1,Clear,0.68,0.6364,0.83,0.1045,41,233,274,202,274,274
12570,2012-06-12,Summer,2012,Jun,22,0,Tuesday,1,Clear,0.66,0.5909,0.94,0.1045,19,188,207,202,207,207
12571,2012-06-12,Summer,2012,Jun,23,0,Tuesday,1,Light_rainsnow,0.66,0.5909,0.94,0.2239,11,78,89,202,89,89
12572,2012-06-13,Summer,2012,Jun,0,0,Wednesday,1,Misty,0.66,0.5909,0.94,0.194,7,27,34,201,34,34
12573,2012-06-13,Summer,2012,Jun,1,0,Wednesday,1,Clear,0.64,0.5909,0.78,0.0,7,21,28,201,28,28
12574,2012-06-13,Summer,2012,Jun,2,0,Wednesday,1,Clear,0.62,0.5758,0.83,0.1343,0,4,4,201,4,4
12575,2012-06-13,Summer,2012,Jun,3,0,Wednesday,1,Clear,0.62,0.5758,0.83,0.194,1,7,8,201,8,8
12576,2012-06-13,Summer,2012,Jun,4,0,Wednesday,1,Clear,0.6,0.5606,0.83,0.1343,1,9,10,201,10,10
12577,2012-06-13,Summer,2012,Jun,5,0,Wednesday,1,Clear,0.6,0.5606,0.83,0.194,2,38,40,201,40,40
12578,2012-06-13,Summer,2012,Jun,6,0,Wednesday,1,Clear,0.6,0.5606,0.83,0.2239,6,188,194,201,194,194
12579,2012-06-13,Summer,2012,Jun,7,0,Wednesday,1,Clear,0.6,0.5606,0.83,0.2985,25,480,505,201,505,505
12580,2012-06-13,Summer,2012,Jun,8,0,Wednesday,1,Misty,0.62,0.5909,0.73,0.5224,41,672,713,201,713,713
12581,2012-06-13,Summer,2012,Jun,9,0,Wednesday,1,Misty,0.64,0.6061,0.69,0.5821,54,298,352,201,352,352
12582,2012-06-13,Summer,2012,Jun,10,0,Wednesday,1,Misty,0.64,0.6061,0.65,0.4179,64,134,198,201,198,198
12583,2012-06-13,Summer,2012,Jun,11,0,Wednesday,1,Misty,0.66,0.6212,0.54,0.4478,64,182,246,201,246,246
12584,2012-06-13,Summer,2012,Jun,12,0,Wednesday,1,Misty,0.68,0.6364,0.44,0.4179,93,241,334,201,334,334
12585,2012-06-13,Summer,2012,Jun,13,0,Wednesday,1,Misty,0.7,0.6364,0.45,0.3881,52,203,255,201,255,255
12586,2012-06-13,Summer,2012,Jun,14,0,Wednesday,1,Misty,0.72,0.6515,0.37,0.4179,98,222,320,201,320,320
12587,2012-06-13,Summer,2012,Jun,15,0,Wednesday,1,Clear,0.72,0.6515,0.32,0.4925,65,216,281,201,281,281
12588,2012-06-13,Summer,2012,Jun,16,0,Wednesday,1,Clear,0.72,0.6515,0.3,0.4925,72,320,392,201,392,392
12589,2012-06-13,Summer,2012,Jun,17,0,Wednesday,1,Clear,0.72,0.6515,0.32,0.4925,75,782,857,201,857,857
12590,2012-06-13,Summer,2012,Jun,18,0,Wednesday,1,Clear,0.72,0.6515,0.32,0.4478,104,640,744,201,744,744
12591,2012-06-13,Summer,2012,Jun,19,0,Wednesday,1,Clear,0.7,0.6364,0.34,0.3881,123,548,671,201,671,671
12592,2012-06-13,Summer,2012,Jun,20,0,Wednesday,1,Clear,0.68,0.6364,0.36,0.4179,86,362,448,201,448,448
12593,2012-06-13,Summer,2012,Jun,21,0,Wednesday,1,Clear,0.64,0.6212,0.44,0.3582,79,317,396,201,396,396
12594,2012-06-13,Summer,2012,Jun,22,0,Wednesday,1,Clear,0.62,0.6212,0.5,0.2985,29,209,238,201,238,238
12595,2012-06-13,Summer,2012,Jun,23,0,Wednesday,1,Clear,0.62,0.6212,0.5,0.2836,25,128,153,201,153,153
12596,2012-06-14,Summer,2012,Jun,0,0,Thursday,1,Clear,0.6,0.6212,0.53,0.2985,3,45,48,200,48,48
12597,2012-06-14,Summer,2012,Jun,1,0,Thursday,1,Clear,0.6,0.6212,0.56,0.2239,4,17,21,200,21,21
12598,2012-06-14,Summer,2012,Jun,2,0,Thursday,1,Misty,0.62,0.6212,0.53,0.2537,1,8,9,200,9,9
12599,2012-06-14,Summer,2012,Jun,3,0,Thursday,1,Misty,0.62,0.6212,0.53,0.2836,1,4,5,200,5,5
12600,2012-06-14,Summer,2012,Jun,4,0,Thursday,1,Misty,0.6,0.6212,0.56,0.2537,0,6,6,200,6,6
12601,2012-06-14,Summer,2012,Jun,5,0,Thursday,1,Misty,0.6,0.6212,0.56,0.2537,0,40,40,200,40,40
12602,2012-06-14,Summer,2012,Jun,6,0,Thursday,1,Clear,0.58,0.5455,0.6,0.2836,12,169,181,200,181,181
12603,2012-06-14,Summer,2012,Jun,7,0,Thursday,1,Clear,0.6,0.6061,0.6,0.2836,26,480,506,200,506,506
12604,2012-06-14,Summer,2012,Jun,8,0,Thursday,1,Clear,0.6,0.6061,0.64,0.3284,37,682,719,200,719,719
12605,2012-06-14,Summer,2012,Jun,9,0,Thursday,1,Clear,0.62,0.6061,0.61,0.2239,45,312,357,200,357,357
12606,2012-06-14,Summer,2012,Jun,10,0,Thursday,1,Clear,0.64,0.6061,0.65,0.4179,47,132,179,200,179,179
12607,2012-06-14,Summer,2012,Jun,11,0,Thursday,1,Clear,0.66,0.6212,0.57,0.2537,60,168,228,200,228,228
12608,2012-06-14,Summer,2012,Jun,12,0,Thursday,1,Misty,0.66,0.6212,0.61,0.2239,55,210,265,200,265,265
12609,2012-06-14,Summer,2012,Jun,13,0,Thursday,1,Clear,0.68,0.6364,0.57,0.1642,71,213,284,200,284,284
12610,2012-06-14,Summer,2012,Jun,14,0,Thursday,1,Clear,0.7,0.6515,0.54,0.2836,84,214,298,200,298,298
12611,2012-06-14,Summer,2012,Jun,15,0,Thursday,1,Clear,0.74,0.6667,0.48,0.2985,111,213,324,200,324,324
12612,2012-06-14,Summer,2012,Jun,16,0,Thursday,1,Clear,0.72,0.6667,0.51,0.2836,70,368,438,200,438,438
12613,2012-06-14,Summer,2012,Jun,17,0,Thursday,1,Clear,0.72,0.6667,0.48,0.2239,117,750,867,200,867,867
12614,2012-06-14,Summer,2012,Jun,18,0,Thursday,1,Clear,0.74,0.6667,0.42,0.194,107,716,823,200,823,823
12615,2012-06-14,Summer,2012,Jun,19,0,Thursday,1,Clear,0.7,0.6515,0.48,0.2537,96,483,579,200,579,579
12616,2012-06-14,Summer,2012,Jun,20,0,Thursday,1,Clear,0.66,0.6212,0.65,0.2537,84,351,435,200,435,435
12617,2012-06-14,Summer,2012,Jun,21,0,Thursday,1,Clear,0.64,0.6061,0.65,0.1642,67,270,337,200,337,337
12618,2012-06-14,Summer,2012,Jun,22,0,Thursday,1,Misty,0.64,0.6061,0.65,0.2239,46,196,242,200,242,242
12619,2012-06-14,Summer,2012,Jun,23,0,Thursday,1,Misty,0.62,0.6061,0.69,0.1642,36,136,172,200,172,172
12620,2012-06-15,Summer,2012,Jun,0,0,Friday,1,Clear,0.6,0.5909,0.73,0.1642,26,68,94,199,94,94
12621,2012-06-15,Summer,2012,Jun,1,0,Friday,1,Clear,0.58,0.5455,0.78,0.194,9,42,51,199,51,51
12622,2012-06-15,Summer,2012,Jun,2,0,Friday,1,Clear,0.56,0.5303,0.83,0.1045,0,15,15,199,15,15
12623,2012-06-15,Summer,2012,Jun,3,0,Friday,1,Clear,0.56,0.5303,0.83,0.1642,2,3,5,199,5,5
12624,2012-06-15,Summer,2012,Jun,4,0,Friday,1,Clear,0.56,0.5303,0.83,0.1642,1,13,14,199,14,14
12625,2012-06-15,Summer,2012,Jun,5,0,Friday,1,Clear,0.54,0.5152,0.88,0.1045,2,31,33,199,33,33
12626,2012-06-15,Summer,2012,Jun,6,0,Friday,1,Clear,0.54,0.5152,0.83,0.1343,9,142,151,199,151,151
12627,2012-06-15,Summer,2012,Jun,7,0,Friday,1,Clear,0.56,0.5303,0.83,0.1642,17,413,430,199,430,430
12628,2012-06-15,Summer,2012,Jun,8,0,Friday,1,Clear,0.6,0.5909,0.69,0.1642,44,609,653,199,653,653
12629,2012-06-15,Summer,2012,Jun,9,0,Friday,1,Clear,0.62,0.6061,0.65,0.1642,58,308,366,199,366,366
12630,2012-06-15,Summer,2012,Jun,10,0,Friday,1,Clear,0.64,0.6212,0.57,0.1642,56,160,216,199,216,216
12631,2012-06-15,Summer,2012,Jun,11,0,Friday,1,Clear,0.66,0.6212,0.5,0.194,106,180,286,199,286,286
12632,2012-06-15,Summer,2012,Jun,12,0,Friday,1,Clear,0.7,0.6364,0.45,0.1642,111,292,403,199,403,403
12633,2012-06-15,Summer,2012,Jun,13,0,Friday,1,Clear,0.7,0.6364,0.42,0.2537,121,272,393,199,393,393
12634,2012-06-15,Summer,2012,Jun,14,0,Friday,1,Clear,0.72,0.6515,0.39,0.194,121,255,376,199,376,376
12635,2012-06-15,Summer,2012,Jun,15,0,Friday,1,Clear,0.72,0.6515,0.39,0.194,107,270,377,199,377,377
12636,2012-06-15,Summer,2012,Jun,16,0,Friday,1,Clear,0.72,0.6515,0.37,0.194,132,426,558,199,558,558
12637,2012-06-15,Summer,2012,Jun,17,0,Friday,1,Clear,0.74,0.6515,0.37,0.2836,125,698,823,199,823,823
12638,2012-06-15,Summer,2012,Jun,18,0,Friday,1,Clear,0.72,0.6515,0.39,0.2239,121,572,693,199,693,693
12639,2012-06-15,Summer,2012,Jun,19,0,Friday,1,Clear,0.7,0.6364,0.42,0.1642,98,369,467,199,467,467
12640,2012-06-15,Summer,2012,Jun,20,0,Friday,1,Clear,0.68,0.6364,0.44,0.194,89,296,385,199,385,385
12641,2012-06-15,Summer,2012,Jun,21,0,Friday,1,Clear,0.66,0.6212,0.5,0.1045,83,250,333,199,333,333
12642,2012-06-15,Summer,2012,Jun,22,0,Friday,1,Clear,0.64,0.6212,0.53,0.1343,79,242,321,199,321,321
12643,2012-06-15,Summer,2012,Jun,23,0,Friday,1,Clear,0.62,0.6212,0.53,0.2537,46,176,222,199,222,222
12644,2012-06-16,Summer,2012,Jun,0,0,Saturday,0,Clear,0.58,0.5455,0.56,0.1343,25,112,137,198,137,137
12645,2012-06-16,Summer,2012,Jun,1,0,Saturday,0,Clear,0.56,0.5303,0.56,0.0,16,79,95,198,95,95
12646,2012-06-16,Summer,2012,Jun,2,0,Saturday,0,Clear,0.58,0.5455,0.53,0.0,12,55,67,198,67,67
12647,2012-06-16,Summer,2012,Jun,3,0,Saturday,0,Clear,0.56,0.5303,0.6,0.0896,8,19,27,198,27,27
12648,2012-06-16,Summer,2012,Jun,4,0,Saturday,0,Clear,0.54,0.5152,0.68,0.1343,3,5,8,198,8,8
12649,2012-06-16,Summer,2012,Jun,5,0,Saturday,0,Clear,0.54,0.5152,0.68,0.1045,2,21,23,198,23,23
12650,2012-06-16,Summer,2012,Jun,6,0,Saturday,0,Clear,0.54,0.5152,0.68,0.194,11,36,47,198,47,47
12651,2012-06-16,Summer,2012,Jun,7,0,Saturday,0,Clear,0.54,0.5152,0.68,0.194,10,68,78,198,78,78
12652,2012-06-16,Summer,2012,Jun,8,0,Saturday,0,Clear,0.58,0.5455,0.64,0.1642,47,157,204,198,204,204
12653,2012-06-16,Summer,2012,Jun,9,0,Saturday,0,Clear,0.6,0.6061,0.6,0.0896,88,279,367,198,367,367
12654,2012-06-16,Summer,2012,Jun,10,0,Saturday,0,Clear,0.64,0.6212,0.47,0.194,139,296,435,198,435,435
12655,2012-06-16,Summer,2012,Jun,11,0,Saturday,0,Clear,0.66,0.6212,0.39,0.1642,213,353,566,198,566,566
12656,2012-06-16,Summer,2012,Jun,12,0,Saturday,0,Clear,0.68,0.6364,0.41,0.1045,254,349,603,198,603,603
12657,2012-06-16,Summer,2012,Jun,13,0,Saturday,0,Clear,0.72,0.6515,0.34,0.1642,293,324,617,198,617,617
12658,2012-06-16,Summer,2012,Jun,14,0,Saturday,0,Clear,0.72,0.6515,0.37,0.2239,264,309,573,198,573,573
12659,2012-06-16,Summer,2012,Jun,15,0,Saturday,0,Clear,0.74,0.6515,0.35,0.2537,295,288,583,198,583,583
12660,2012-06-16,Summer,2012,Jun,16,0,Saturday,0,Misty,0.72,0.6515,0.37,0.1045,238,304,542,198,542,542
12661,2012-06-16,Summer,2012,Jun,17,0,Saturday,0,Misty,0.72,0.6515,0.37,0.2537,244,349,593,198,593,593
12662,2012-06-16,Summer,2012,Jun,18,0,Saturday,0,Misty,0.72,0.6515,0.37,0.2239,256,315,571,198,571,571
12663,2012-06-16,Summer,2012,Jun,19,0,Saturday,0,Misty,0.7,0.6364,0.42,0.194,184,277,461,198,461,461
12664,2012-06-16,Summer,2012,Jun,20,0,Saturday,0,Misty,0.66,0.6212,0.47,0.194,123,229,352,198,352,352
12665,2012-06-16,Summer,2012,Jun,21,0,Saturday,0,Misty,0.64,0.6212,0.5,0.2239,98,192,290,198,290,290
12666,2012-06-16,Summer,2012,Jun,22,0,Saturday,0,Clear,0.62,0.6212,0.53,0.2985,91,189,280,198,280,280
12667,2012-06-16,Summer,2012,Jun,23,0,Saturday,0,Clear,0.6,0.6212,0.53,0.2985,49,134,183,198,183,183
12668,2012-06-17,Summer,2012,Jun,0,0,Sunday,0,Clear,0.56,0.5303,0.56,0.1343,31,117,148,197,148,148
12669,2012-06-17,Summer,2012,Jun,1,0,Sunday,0,Clear,0.56,0.5303,0.6,0.1642,21,67,88,197,88,88
12670,2012-06-17,Summer,2012,Jun,2,0,Sunday,0,Clear,0.56,0.5303,0.56,0.0896,19,55,74,197,74,74
12671,2012-06-17,Summer,2012,Jun,3,0,Sunday,0,Clear,0.54,0.5152,0.64,0.1045,6,22,28,197,28,28
12672,2012-06-17,Summer,2012,Jun,4,0,Sunday,0,Clear,0.54,0.5152,0.64,0.0896,2,16,18,197,18,18
12673,2012-06-17,Summer,2012,Jun,5,0,Sunday,0,Clear,0.54,0.5152,0.68,0.1343,4,13,17,197,17,17
12674,2012-06-17,Summer,2012,Jun,6,0,Sunday,0,Clear,0.52,0.5,0.72,0.1045,7,16,23,197,23,23
12675,2012-06-17,Summer,2012,Jun,7,0,Sunday,0,Clear,0.52,0.5,0.72,0.0896,18,30,48,197,48,48
12676,2012-06-17,Summer,2012,Jun,8,0,Sunday,0,Clear,0.56,0.5303,0.68,0.2537,24,95,119,197,119,119
12677,2012-06-17,Summer,2012,Jun,9,0,Sunday,0,Clear,0.56,0.5303,0.68,0.1642,91,183,274,197,274,274
12678,2012-06-17,Summer,2012,Jun,10,0,Sunday,0,Clear,0.58,0.5455,0.64,0.0,148,288,436,197,436,436
12679,2012-06-17,Summer,2012,Jun,11,0,Sunday,0,Clear,0.62,0.6212,0.57,0.1045,196,350,546,197,546,546
12680,2012-06-17,Summer,2012,Jun,12,0,Sunday,0,Clear,0.62,0.6212,0.57,0.0,260,355,615,197,615,615
12681,2012-06-17,Summer,2012,Jun,13,0,Sunday,0,Clear,0.64,0.6212,0.53,0.1642,267,347,614,197,614,614
12682,2012-06-17,Summer,2012,Jun,14,0,Sunday,0,Clear,0.64,0.6212,0.53,0.0,255,327,582,197,582,582
12683,2012-06-17,Summer,2012,Jun,15,0,Sunday,0,Clear,0.66,0.6212,0.5,0.2239,203,260,463,197,463,463
12684,2012-06-17,Summer,2012,Jun,16,0,Sunday,0,Clear,0.66,0.6212,0.54,0.2985,240,340,580,197,580,580
12685,2012-06-17,Summer,2012,Jun,17,0,Sunday,0,Clear,0.64,0.6212,0.57,0.2239,232,361,593,197,593,593
12686,2012-06-17,Summer,2012,Jun,18,0,Sunday,0,Clear,0.64,0.6212,0.53,0.194,203,310,513,197,513,513
12687,2012-06-17,Summer,2012,Jun,19,0,Sunday,0,Clear,0.64,0.6212,0.53,0.1642,146,244,390,197,390,390
12688,2012-06-17,Summer,2012,Jun,20,0,Sunday,0,Clear,0.62,0.6212,0.57,0.194,101,201,302,197,302,302
12689,2012-06-17,Summer,2012,Jun,21,0,Sunday,0,Clear,0.62,0.6212,0.57,0.194,76,170,246,197,246,246
12690,2012-06-17,Summer,2012,Jun,22,0,Sunday,0,Clear,0.6,0.6061,0.6,0.194,55,98,153,197,153,153
12691,2012-06-17,Summer,2012,Jun,23,0,Sunday,0,Clear,0.58,0.5455,0.64,0.194,29,79,108,197,108,108
12692,2012-06-18,Summer,2012,Jun,0,0,Monday,1,Clear,0.56,0.5303,0.73,0.2537,12,28,40,196,40,40
12693,2012-06-18,Summer,2012,Jun,1,0,Monday,1,Clear,0.54,0.5152,0.77,0.2239,9,5,14,196,14,14
12694,2012-06-18,Summer,2012,Jun,2,0,Monday,1,Clear,0.54,0.5152,0.77,0.2239,3,6,9,196,9,9
12695,2012-06-18,Summer,2012,Jun,3,0,Monday,1,Misty,0.52,0.5,0.83,0.2239,1,3,4,196,4,4
12696,2012-06-18,Summer,2012,Jun,4,0,Monday,1,Misty,0.54,0.5152,0.77,0.194,0,9,9,196,9,9
12697,2012-06-18,Summer,2012,Jun,5,0,Monday,1,Light_rainsnow,0.52,0.5,0.83,0.1343,1,22,23,196,23,23
12698,2012-06-18,Summer,2012,Jun,6,0,Monday,1,Light_rainsnow,0.52,0.5,0.88,0.1343,0,37,37,196,37,37
12699,2012-06-18,Summer,2012,Jun,7,0,Monday,1,Light_rainsnow,0.52,0.5,0.94,0.2239,10,135,145,196,145,145
12700,2012-06-18,Summer,2012,Jun,8,0,Monday,1,Misty,0.54,0.5152,0.83,0.194,27,447,474,196,474,474
12701,2012-06-18,Summer,2012,Jun,9,0,Monday,1,Misty,0.54,0.5152,0.83,0.2239,28,222,250,196,250,250
12702,2012-06-18,Summer,2012,Jun,10,0,Monday,1,Light_rainsnow,0.54,0.5152,0.88,0.1045,13,78,91,196,91,91
12703,2012-06-18,Summer,2012,Jun,11,0,Monday,1,Misty,0.54,0.5152,0.88,0.1642,25,96,121,196,121,121
12704,2012-06-18,Summer,2012,Jun,12,0,Monday,1,Light_rainsnow,0.56,0.5303,0.78,0.1343,29,139,168,196,168,168
12705,2012-06-18,Summer,2012,Jun,13,0,Monday,1,Misty,0.58,0.5455,0.73,0.1343,51,174,225,196,225,225
12706,2012-06-18,Summer,2012,Jun,14,0,Monday,1,Misty,0.58,0.5455,0.68,0.194,59,160,219,196,219,219
12707,2012-06-18,Summer,2012,Jun,15,0,Monday,1,Misty,0.6,0.5909,0.69,0.194,61,176,237,196,237,237
12708,2012-06-18,Summer,2012,Jun,16,0,Monday,1,Misty,0.6,0.5909,0.73,0.194,53,279,332,196,332,332
12709,2012-06-18,Summer,2012,Jun,17,0,Monday,1,Misty,0.6,0.5909,0.73,0.194,54,669,723,196,723,723
12710,2012-06-18,Summer,2012,Jun,18,0,Monday,1,Misty,0.62,0.6061,0.69,0.1642,47,595,642,196,642,642
12711,2012-06-18,Summer,2012,Jun,19,0,Monday,1,Misty,0.62,0.5909,0.73,0.0896,52,411,463,196,463,463
12712,2012-06-18,Summer,2012,Jun,20,0,Monday,1,Misty,0.62,0.5909,0.73,0.1343,45,317,362,196,362,362
12713,2012-06-18,Summer,2012,Jun,21,0,Monday,1,Misty,0.62,0.5909,0.73,0.1045,35,238,273,196,273,273
12714,2012-06-18,Summer,2012,Jun,22,0,Monday,1,Misty,0.62,0.5909,0.73,0.1642,21,143,164,196,164,164
12715,2012-06-18,Summer,2012,Jun,23,0,Monday,1,Light_rainsnow,0.6,0.5758,0.78,0.194,17,57,74,196,74,74
12716,2012-06-19,Summer,2012,Jun,0,0,Tuesday,1,Misty,0.6,0.5758,0.78,0.1642,5,30,35,195,35,35
12717,2012-06-19,Summer,2012,Jun,1,0,Tuesday,1,Misty,0.6,0.5758,0.78,0.1642,1,13,14,195,14,14
12718,2012-06-19,Summer,2012,Jun,2,0,Tuesday,1,Misty,0.6,0.5758,0.78,0.1343,1,14,15,195,15,15
12719,2012-06-19,Summer,2012,Jun,3,0,Tuesday,1,Misty,0.6,0.5758,0.78,0.1045,1,7,8,195,8,8
12720,2012-06-19,Summer,2012,Jun,4,0,Tuesday,1,Misty,0.6,0.5758,0.78,0.1343,1,9,10,195,10,10
12721,2012-06-19,Summer,2012,Jun,5,0,Tuesday,1,Misty,0.6,0.5758,0.78,0.194,3,34,37,195,37,37
12722,2012-06-19,Summer,2012,Jun,6,0,Tuesday,1,Misty,0.6,0.5758,0.78,0.1045,9,152,161,195,161,161
12723,2012-06-19,Summer,2012,Jun,7,0,Tuesday,1,Misty,0.6,0.5758,0.78,0.1343,18,462,480,195,480,480
12724,2012-06-19,Summer,2012,Jun,8,0,Tuesday,1,Misty,0.6,0.5758,0.78,0.1642,40,633,673,195,673,673
12725,2012-06-19,Summer,2012,Jun,9,0,Tuesday,1,Clear,0.64,0.6061,0.73,0.0896,40,288,328,195,328,328
12726,2012-06-19,Summer,2012,Jun,10,0,Tuesday,1,Clear,0.64,0.6061,0.73,0.0896,44,136,180,195,180,180
12727,2012-06-19,Summer,2012,Jun,11,0,Tuesday,1,Clear,0.66,0.6212,0.69,0.1343,56,174,230,195,230,230
12728,2012-06-19,Summer,2012,Jun,12,0,Tuesday,1,Clear,0.7,0.6515,0.65,0.0896,70,222,292,195,292,292
12729,2012-06-19,Summer,2012,Jun,13,0,Tuesday,1,Clear,0.74,0.6818,0.58,0.1343,69,203,272,195,272,272
12730,2012-06-19,Summer,2012,Jun,14,0,Tuesday,1,Clear,0.76,0.7121,0.58,0.1045,61,166,227,195,227,227
12731,2012-06-19,Summer,2012,Jun,15,0,Tuesday,1,Clear,0.78,0.7424,0.59,0.1642,72,187,259,195,259,259
12732,2012-06-19,Summer,2012,Jun,16,0,Tuesday,1,Clear,0.8,0.7576,0.55,0.2239,48,286,334,195,334,334
12733,2012-06-19,Summer,2012,Jun,17,0,Tuesday,1,Clear,0.8,0.7576,0.55,0.194,86,725,811,195,811,811
12734,2012-06-19,Summer,2012,Jun,18,0,Tuesday,1,Clear,0.8,0.7576,0.55,0.1642,91,704,795,195,795,795
12735,2012-06-19,Summer,2012,Jun,19,0,Tuesday,1,Clear,0.8,0.7727,0.59,0.2239,82,432,514,195,514,514
12736,2012-06-19,Summer,2012,Jun,20,0,Tuesday,1,Clear,0.8,0.7576,0.55,0.2537,59,399,458,195,458,458
12737,2012-06-19,Summer,2012,Jun,21,0,Tuesday,1,Clear,0.76,0.7121,0.62,0.1642,37,239,276,195,276,276
12738,2012-06-19,Summer,2012,Jun,22,0,Tuesday,1,Clear,0.72,0.697,0.79,0.0896,51,240,291,195,291,291
12739,2012-06-19,Summer,2012,Jun,23,0,Tuesday,1,Clear,0.72,0.697,0.79,0.1343,23,102,125,195,125,125
12740,2012-06-20,Summer,2012,Jun,0,0,Wednesday,1,Clear,0.7,0.6667,0.79,0.194,5,48,53,194,53,53
12741,2012-06-20,Summer,2012,Jun,1,0,Wednesday,1,Clear,0.68,0.6364,0.79,0.194,7,20,27,194,27,27
12742,2012-06-20,Summer,2012,Jun,2,0,Wednesday,1,Clear,0.66,0.6061,0.83,0.1642,1,5,6,194,6,6
12743,2012-06-20,Summer,2012,Jun,3,0,Wednesday,1,Clear,0.66,0.6061,0.83,0.1343,2,6,8,194,8,8
12744,2012-06-20,Summer,2012,Jun,4,0,Wednesday,1,Clear,0.66,0.6061,0.83,0.0896,1,6,7,194,7,7
12745,2012-06-20,Summer,2012,Jun,5,0,Wednesday,1,Clear,0.66,0.6061,0.83,0.0896,2,37,39,194,39,39
12746,2012-06-20,Summer,2012,Jun,6,0,Wednesday,1,Misty,0.64,0.5758,0.89,0.0896,9,156,165,194,165,165
12747,2012-06-20,Summer,2012,Jun,7,0,Wednesday,1,Misty,0.66,0.5909,0.89,0.0,20,444,464,194,464,464
12748,2012-06-20,Summer,2012,Jun,8,0,Wednesday,1,Misty,0.7,0.6667,0.79,0.1045,43,600,643,194,643,643
12749,2012-06-20,Summer,2012,Jun,9,0,Wednesday,1,Misty,0.72,0.697,0.74,0.0,40,276,316,194,316,316
12750,2012-06-20,Summer,2012,Jun,10,0,Wednesday,1,Clear,0.82,0.7727,0.52,0.1343,41,126,167,194,167,167
12751,2012-06-20,Summer,2012,Jun,11,0,Wednesday,1,Clear,0.84,0.7879,0.49,0.194,54,134,188,194,188,188
12752,2012-06-20,Summer,2012,Jun,12,0,Wednesday,1,Clear,0.86,0.803,0.47,0.1642,30,150,180,194,180,180
12753,2012-06-20,Summer,2012,Jun,13,0,Wednesday,1,Clear,0.86,0.7879,0.44,0.1045,48,163,211,194,211,211
12754,2012-06-20,Summer,2012,Jun,14,0,Wednesday,1,Clear,0.88,0.803,0.39,0.194,56,134,190,194,190,190
12755,2012-06-20,Summer,2012,Jun,15,0,Wednesday,1,Clear,0.9,0.8182,0.35,0.0,36,143,179,194,179,179
12756,2012-06-20,Summer,2012,Jun,16,0,Wednesday,1,Clear,0.9,0.8182,0.35,0.1045,51,284,335,194,335,335
12757,2012-06-20,Summer,2012,Jun,17,0,Wednesday,1,Clear,0.9,0.8182,0.37,0.0,80,611,691,194,691,691
12758,2012-06-20,Summer,2012,Jun,18,0,Wednesday,1,Clear,0.9,0.8182,0.37,0.0,81,591,672,194,672,672
12759,2012-06-20,Summer,2012,Jun,19,0,Wednesday,1,Clear,0.88,0.7879,0.37,0.2537,90,449,539,194,539,539
12760,2012-06-20,Summer,2012,Jun,20,0,Wednesday,1,Clear,0.86,0.7727,0.39,0.2239,81,326,407,194,407,407
12761,2012-06-20,Summer,2012,Jun,21,0,Wednesday,1,Clear,0.84,0.7576,0.44,0.0896,42,302,344,194,344,344
12762,2012-06-20,Summer,2012,Jun,22,0,Wednesday,1,Clear,0.82,0.7576,0.46,0.1045,31,226,257,194,257,257
12763,2012-06-20,Summer,2012,Jun,23,0,Wednesday,1,Clear,0.78,0.7424,0.59,0.1045,21,102,123,194,123,123
12764,2012-06-21,Fall,2012,Jun,0,0,Thursday,1,Clear,0.74,0.697,0.7,0.0896,16,53,69,193,69,69
12765,2012-06-21,Fall,2012,Jun,1,0,Thursday,1,Clear,0.72,0.697,0.79,0.1343,2,16,18,193,18,18
12766,2012-06-21,Fall,2012,Jun,2,0,Thursday,1,Clear,0.72,0.697,0.79,0.1045,11,7,18,193,18,18
12767,2012-06-21,Fall,2012,Jun,3,0,Thursday,1,Clear,0.72,0.697,0.74,0.0,3,8,11,193,11,11
12768,2012-06-21,Fall,2012,Jun,4,0,Thursday,1,Clear,0.7,0.6667,0.84,0.0896,1,11,12,193,12,12
12769,2012-06-21,Fall,2012,Jun,5,0,Thursday,1,Clear,0.7,0.6667,0.84,0.1045,3,37,40,193,40,40
12770,2012-06-21,Fall,2012,Jun,6,0,Thursday,1,Misty,0.7,0.6667,0.84,0.0896,3,147,150,193,150,150
12771,2012-06-21,Fall,2012,Jun,7,0,Thursday,1,Misty,0.7,0.6667,0.84,0.0896,26,437,463,193,463,463
12772,2012-06-21,Fall,2012,Jun,8,0,Thursday,1,Clear,0.74,0.697,0.7,0.0,27,563,590,193,590,590
12773,2012-06-21,Fall,2012,Jun,9,0,Thursday,1,Clear,0.8,0.7576,0.55,0.194,32,224,256,193,256,256
12774,2012-06-21,Fall,2012,Jun,10,0,Thursday,1,Clear,0.84,0.7879,0.49,0.1045,36,114,150,193,150,150
12775,2012-06-21,Fall,2012,Jun,11,0,Thursday,1,Clear,0.86,0.7879,0.41,0.1343,40,121,161,193,161,161
12776,2012-06-21,Fall,2012,Jun,12,0,Thursday,1,Clear,0.9,0.8182,0.35,0.194,33,182,215,193,215,215
12777,2012-06-21,Fall,2012,Jun,13,0,Thursday,1,Clear,0.9,0.8182,0.35,0.0,31,141,172,193,172,172
12778,2012-06-21,Fall,2012,Jun,14,0,Thursday,1,Clear,0.88,0.7879,0.37,0.1642,27,149,176,193,176,176
12779,2012-06-21,Fall,2012,Jun,15,0,Thursday,1,Clear,0.92,0.8333,0.33,0.1642,40,154,194,193,194,194
12780,2012-06-21,Fall,2012,Jun,16,0,Thursday,1,Clear,0.9,0.8182,0.35,0.1343,37,283,320,193,320,320
12781,2012-06-21,Fall,2012,Jun,17,0,Thursday,1,Clear,0.88,0.7879,0.37,0.0,80,535,615,193,615,615
12782,2012-06-21,Fall,2012,Jun,18,0,Thursday,1,Clear,0.86,0.7879,0.41,0.194,78,562,640,193,640,640
12783,2012-06-21,Fall,2012,Jun,19,0,Thursday,1,Clear,0.88,0.803,0.39,0.2239,84,415,499,193,499,499
12784,2012-06-21,Fall,2012,Jun,20,0,Thursday,1,Clear,0.86,0.7879,0.44,0.194,79,357,436,193,436,436
12785,2012-06-21,Fall,2012,Jun,21,0,Thursday,1,Clear,0.82,0.7727,0.52,0.194,55,256,311,193,311,311
12786,2012-06-21,Fall,2012,Jun,22,0,Thursday,1,Clear,0.8,0.7879,0.63,0.1642,22,221,243,193,243,243
12787,2012-06-21,Fall,2012,Jun,23,0,Thursday,1,Clear,0.8,0.7727,0.59,0.0896,12,134,146,193,146,146
12788,2012-06-22,Fall,2012,Jun,0,0,Friday,1,Misty,0.76,0.7273,0.7,0.1045,16,77,93,192,93,93
12789,2012-06-22,Fall,2012,Jun,1,0,Friday,1,Clear,0.76,0.7424,0.75,0.1642,3,28,31,192,31,31
12790,2012-06-22,Fall,2012,Jun,2,0,Friday,1,Clear,0.74,0.7121,0.79,0.0,0,12,12,192,12,12
12791,2012-06-22,Fall,2012,Jun,3,0,Friday,1,Clear,0.74,0.7121,0.79,0.0,1,6,7,192,7,7
12792,2012-06-22,Fall,2012,Jun,4,0,Friday,1,Misty,0.76,0.7273,0.66,0.0,3,7,10,192,10,10
12793,2012-06-22,Fall,2012,Jun,5,0,Friday,1,Misty,0.74,0.697,0.66,0.0896,3,35,38,192,38,38
12794,2012-06-22,Fall,2012,Jun,6,0,Friday,1,Misty,0.74,0.697,0.66,0.0,4,118,122,192,122,122
12795,2012-06-22,Fall,2012,Jun,7,0,Friday,1,Clear,0.74,0.6818,0.58,0.1642,19,340,359,192,359,359
12796,2012-06-22,Fall,2012,Jun,8,0,Friday,1,Clear,0.76,0.697,0.55,0.1343,49,564,613,192,613,613
12797,2012-06-22,Fall,2012,Jun,9,0,Friday,1,Clear,0.76,0.7121,0.58,0.2239,55,278,333,192,333,333
12798,2012-06-22,Fall,2012,Jun,10,0,Friday,1,Clear,0.8,0.7424,0.52,0.3582,52,133,185,192,185,185
12799,2012-06-22,Fall,2012,Jun,11,0,Friday,1,Clear,0.8,0.7424,0.49,0.1642,76,160,236,192,236,236
12800,2012-06-22,Fall,2012,Jun,12,0,Friday,1,Clear,0.84,0.7879,0.49,0.1343,63,191,254,192,254,254
12801,2012-06-22,Fall,2012,Jun,13,0,Friday,1,Clear,0.88,0.803,0.39,0.2239,72,228,300,192,300,300
12802,2012-06-22,Fall,2012,Jun,14,0,Friday,1,Clear,0.88,0.803,0.39,0.2239,65,198,263,192,263,263
12803,2012-06-22,Fall,2012,Jun,15,0,Friday,1,Clear,0.9,0.8182,0.35,0.3582,72,212,284,192,284,284
12804,2012-06-22,Fall,2012,Jun,16,0,Friday,1,Clear,0.9,0.803,0.31,0.2239,67,313,380,192,380,380
12805,2012-06-22,Fall,2012,Jun,17,0,Friday,1,Misty,0.82,0.7273,0.38,0.1642,95,551,646,192,646,646
12806,2012-06-22,Fall,2012,Jun,18,0,Friday,1,Misty,0.8,0.7576,0.55,0.194,62,443,505,192,505,505
12807,2012-06-22,Fall,2012,Jun,19,0,Friday,1,Misty,0.76,0.697,0.55,0.5224,45,317,362,192,362,362
12808,2012-06-22,Fall,2012,Jun,20,0,Friday,1,Misty,0.76,0.697,0.55,0.5224,31,171,202,192,202,202
12809,2012-06-22,Fall,2012,Jun,21,0,Friday,1,Light_rainsnow,0.68,0.6364,0.65,0.2836,40,177,217,192,217,217
12810,2012-06-22,Fall,2012,Jun,22,0,Friday,1,Clear,0.68,0.6364,0.69,0.1343,42,155,197,192,197,197
12811,2012-06-22,Fall,2012,Jun,23,0,Friday,1,Misty,0.66,0.6212,0.74,0.0,29,145,174,192,174,174
12812,2012-06-23,Fall,2012,Jun,0,0,Saturday,0,Clear,0.64,0.5758,0.83,0.0,14,102,116,191,116,116
12813,2012-06-23,Fall,2012,Jun,1,0,Saturday,0,Clear,0.66,0.6061,0.78,0.1343,16,107,123,191,123,123
12814,2012-06-23,Fall,2012,Jun,2,0,Saturday,0,Misty,0.64,0.5758,0.83,0.194,18,75,93,191,93,93
12815,2012-06-23,Fall,2012,Jun,3,0,Saturday,0,Misty,0.64,0.5758,0.83,0.0896,10,32,42,191,42,42
12816,2012-06-23,Fall,2012,Jun,4,0,Saturday,0,Misty,0.64,0.5758,0.83,0.1642,6,13,19,191,19,19
12817,2012-06-23,Fall,2012,Jun,5,0,Saturday,0,Misty,0.64,0.5758,0.83,0.194,1,11,12,191,12,12
12818,2012-06-23,Fall,2012,Jun,6,0,Saturday,0,Clear,0.64,0.5758,0.83,0.0896,10,37,47,191,47,47
12819,2012-06-23,Fall,2012,Jun,7,0,Saturday,0,Clear,0.64,0.5758,0.83,0.1642,19,59,78,191,78,78
12820,2012-06-23,Fall,2012,Jun,8,0,Saturday,0,Clear,0.68,0.6364,0.69,0.2239,34,133,167,191,167,167
12821,2012-06-23,Fall,2012,Jun,9,0,Saturday,0,Clear,0.72,0.6818,0.62,0.194,85,247,332,191,332,332
12822,2012-06-23,Fall,2012,Jun,10,0,Saturday,0,Clear,0.74,0.6818,0.55,0.194,177,317,494,191,494,494
12823,2012-06-23,Fall,2012,Jun,11,0,Saturday,0,Clear,0.76,0.6818,0.48,0.2239,167,349,516,191,516,516
12824,2012-06-23,Fall,2012,Jun,12,0,Saturday,0,Clear,0.8,0.7273,0.43,0.194,203,399,602,191,602,602
12825,2012-06-23,Fall,2012,Jun,13,0,Saturday,0,Clear,0.82,0.7273,0.34,0.194,226,338,564,191,564,564
12826,2012-06-23,Fall,2012,Jun,14,0,Saturday,0,Clear,0.78,0.6818,0.33,0.2537,238,371,609,191,609,609
12827,2012-06-23,Fall,2012,Jun,15,0,Saturday,0,Clear,0.84,0.7273,0.3,0.3284,217,266,483,191,483,483
12828,2012-06-23,Fall,2012,Jun,16,0,Saturday,0,Clear,0.84,0.7121,0.26,0.2985,196,317,513,191,513,513
12829,2012-06-23,Fall,2012,Jun,17,0,Saturday,0,Clear,0.82,0.7121,0.26,0.2537,214,316,530,191,530,530
12830,2012-06-23,Fall,2012,Jun,18,0,Saturday,0,Clear,0.82,0.7121,0.26,0.2985,194,287,481,191,481,481
12831,2012-06-23,Fall,2012,Jun,19,0,Saturday,0,Clear,0.8,0.697,0.27,0.194,185,240,425,191,425,425
12832,2012-06-23,Fall,2012,Jun,20,0,Saturday,0,Clear,0.78,0.6818,0.31,0.194,158,228,386,191,386,386
12833,2012-06-23,Fall,2012,Jun,21,0,Saturday,0,Clear,0.76,0.6667,0.33,0.1343,99,223,322,191,322,322
12834,2012-06-23,Fall,2012,Jun,22,0,Saturday,0,Clear,0.74,0.6515,0.37,0.1045,101,178,279,191,279,279
12835,2012-06-23,Fall,2012,Jun,23,0,Saturday,0,Clear,0.72,0.6515,0.44,0.0,69,156,225,191,225,225
12836,2012-06-24,Fall,2012,Jun,0,0,Sunday,0,Clear,0.7,0.6515,0.51,0.0,31,132,163,190,163,163
12837,2012-06-24,Fall,2012,Jun,1,0,Sunday,0,Misty,0.68,0.6364,0.54,0.0896,39,88,127,190,127,127
12838,2012-06-24,Fall,2012,Jun,2,0,Sunday,0,Misty,0.68,0.6364,0.51,0.0,34,80,114,190,114,114
12839,2012-06-24,Fall,2012,Jun,3,0,Sunday,0,Misty,0.66,0.6212,0.65,0.0896,19,41,60,190,60,60
12840,2012-06-24,Fall,2012,Jun,4,0,Sunday,0,Misty,0.66,0.6212,0.65,0.0,4,9,13,190,13,13
12841,2012-06-24,Fall,2012,Jun,5,0,Sunday,0,Clear,0.62,0.6061,0.69,0.1343,1,7,8,190,8,8
12842,2012-06-24,Fall,2012,Jun,6,0,Sunday,0,Clear,0.64,0.6061,0.65,0.1642,6,19,25,190,25,25
12843,2012-06-24,Fall,2012,Jun,7,0,Sunday,0,Clear,0.64,0.6061,0.69,0.1045,23,48,71,190,71,71
12844,2012-06-24,Fall,2012,Jun,8,0,Sunday,0,Clear,0.7,0.6515,0.58,0.0,38,103,141,190,141,141
12845,2012-06-24,Fall,2012,Jun,9,0,Sunday,0,Clear,0.72,0.6667,0.51,0.0,63,169,232,190,232,232
12846,2012-06-24,Fall,2012,Jun,10,0,Sunday,0,Clear,0.76,0.6818,0.4,0.0,161,291,452,190,452,452
12847,2012-06-24,Fall,2012,Jun,11,0,Sunday,0,Clear,0.76,0.6818,0.4,0.1343,215,291,506,190,506,506
12848,2012-06-24,Fall,2012,Jun,12,0,Sunday,0,Clear,0.8,0.697,0.33,0.2239,227,329,556,190,556,556
12849,2012-06-24,Fall,2012,Jun,13,0,Sunday,0,Clear,0.8,0.697,0.33,0.2836,237,348,585,190,585,585
12850,2012-06-24,Fall,2012,Jun,14,0,Sunday,0,Clear,0.84,0.7273,0.3,0.2985,253,298,551,190,551,551
12851,2012-06-24,Fall,2012,Jun,15,0,Sunday,0,Clear,0.86,0.7424,0.28,0.2239,197,290,487,190,487,487
12852,2012-06-24,Fall,2012,Jun,16,0,Sunday,0,Clear,0.84,0.7273,0.3,0.2537,181,280,461,190,461,461
12853,2012-06-24,Fall,2012,Jun,17,0,Sunday,0,Clear,0.84,0.7273,0.32,0.2537,203,329,532,190,532,532
12854,2012-06-24,Fall,2012,Jun,18,0,Sunday,0,Clear,0.82,0.7273,0.34,0.2537,186,348,534,190,534,534
12855,2012-06-24,Fall,2012,Jun,19,0,Sunday,0,Clear,0.8,0.7121,0.38,0.2985,176,247,423,190,423,423
12856,2012-06-24,Fall,2012,Jun,20,0,Sunday,0,Clear,0.78,0.697,0.46,0.2537,108,224,332,190,332,332
12857,2012-06-24,Fall,2012,Jun,21,0,Sunday,0,Clear,0.76,0.697,0.55,0.2239,76,177,253,190,253,253
12858,2012-06-24,Fall,2012,Jun,22,0,Sunday,0,Clear,0.74,0.6818,0.55,0.1045,53,125,178,190,178,178
12859,2012-06-24,Fall,2012,Jun,23,0,Sunday,0,Clear,0.74,0.6818,0.58,0.1045,20,67,87,190,87,87
12860,2012-06-25,Fall,2012,Jun,0,0,Monday,1,Clear,0.72,0.6818,0.62,0.2537,31,37,68,189,68,68
12861,2012-06-25,Fall,2012,Jun,1,0,Monday,1,Clear,0.7,0.6515,0.65,0.2239,11,20,31,189,31,31
12862,2012-06-25,Fall,2012,Jun,2,0,Monday,1,Clear,0.7,0.6515,0.7,0.2239,4,10,14,189,14,14
12863,2012-06-25,Fall,2012,Jun,3,0,Monday,1,Clear,0.68,0.6364,0.69,0.2537,1,4,5,189,5,5
12864,2012-06-25,Fall,2012,Jun,4,0,Monday,1,Clear,0.66,0.6061,0.78,0.2537,0,4,4,189,4,4
12865,2012-06-25,Fall,2012,Jun,5,0,Monday,1,Clear,0.66,0.6212,0.74,0.1642,1,42,43,189,43,43
12866,2012-06-25,Fall,2012,Jun,6,0,Monday,1,Clear,0.64,0.5909,0.78,0.1642,11,147,158,189,158,158
12867,2012-06-25,Fall,2012,Jun,7,0,Monday,1,Clear,0.66,0.6212,0.74,0.2239,30,455,485,189,485,485
12868,2012-06-25,Fall,2012,Jun,8,0,Monday,1,Clear,0.66,0.6212,0.69,0.194,53,555,608,189,608,608
12869,2012-06-25,Fall,2012,Jun,9,0,Monday,1,Clear,0.7,0.6515,0.65,0.194,37,231,268,189,268,268
12870,2012-06-25,Fall,2012,Jun,10,0,Monday,1,Clear,0.76,0.697,0.55,0.1642,58,126,184,189,184,184
12871,2012-06-25,Fall,2012,Jun,11,0,Monday,1,Clear,0.8,0.7273,0.43,0.3284,54,127,181,189,181,181
12872,2012-06-25,Fall,2012,Jun,12,0,Monday,1,Misty,0.76,0.6818,0.45,0.2985,74,196,270,189,270,270
12873,2012-06-25,Fall,2012,Jun,13,0,Monday,1,Clear,0.72,0.6667,0.51,0.2985,79,181,260,189,260,260
12874,2012-06-25,Fall,2012,Jun,14,0,Monday,1,Clear,0.78,0.697,0.43,0.2537,90,161,251,189,251,251
12875,2012-06-25,Fall,2012,Jun,15,0,Monday,1,Clear,0.78,0.6818,0.38,0.4627,65,168,233,189,233,233
12876,2012-06-25,Fall,2012,Jun,16,0,Monday,1,Clear,0.8,0.697,0.31,0.3881,104,310,414,189,414,414
12877,2012-06-25,Fall,2012,Jun,17,0,Monday,1,Clear,0.8,0.6818,0.24,0.4627,76,757,833,189,833,833
12878,2012-06-25,Fall,2012,Jun,18,0,Monday,1,Clear,0.76,0.6667,0.27,0.4478,100,691,791,189,791,791
12879,2012-06-25,Fall,2012,Jun,19,0,Monday,1,Clear,0.74,0.6515,0.27,0.4627,74,508,582,189,582,582
12880,2012-06-25,Fall,2012,Jun,20,0,Monday,1,Clear,0.72,0.6515,0.3,0.4478,100,375,475,189,475,475
12881,2012-06-25,Fall,2012,Jun,21,0,Monday,1,Clear,0.68,0.6212,0.3,0.3284,50,281,331,189,331,331
12882,2012-06-25,Fall,2012,Jun,22,0,Monday,1,Clear,0.66,0.6212,0.29,0.3881,21,166,187,189,187,187
12883,2012-06-25,Fall,2012,Jun,23,0,Monday,1,Clear,0.64,0.6212,0.33,0.3284,15,88,103,189,103,103
12884,2012-06-26,Fall,2012,Jun,0,0,Tuesday,1,Clear,0.62,0.6212,0.33,0.3284,8,29,37,188,37,37
12885,2012-06-26,Fall,2012,Jun,1,0,Tuesday,1,Clear,0.6,0.6212,0.35,0.3881,11,19,30,188,30,30
12886,2012-06-26,Fall,2012,Jun,2,0,Tuesday,1,Clear,0.56,0.5303,0.43,0.2836,2,7,9,188,9,9
12887,2012-06-26,Fall,2012,Jun,3,0,Tuesday,1,Clear,0.54,0.5152,0.45,0.2836,2,7,9,188,9,9
12888,2012-06-26,Fall,2012,Jun,4,0,Tuesday,1,Clear,0.54,0.5152,0.45,0.2985,1,9,10,188,10,10
12889,2012-06-26,Fall,2012,Jun,5,0,Tuesday,1,Clear,0.52,0.5,0.48,0.3881,3,36,39,188,39,39
12890,2012-06-26,Fall,2012,Jun,6,0,Tuesday,1,Clear,0.52,0.5,0.52,0.2985,12,176,188,188,188,188
12891,2012-06-26,Fall,2012,Jun,7,0,Tuesday,1,Clear,0.52,0.5,0.52,0.3582,21,531,552,188,552,552
12892,2012-06-26,Fall,2012,Jun,8,0,Tuesday,1,Clear,0.56,0.5303,0.49,0.3284,34,622,656,188,656,656
12893,2012-06-26,Fall,2012,Jun,9,0,Tuesday,1,Clear,0.58,0.5455,0.46,0.4179,30,298,328,188,328,328
12894,2012-06-26,Fall,2012,Jun,10,0,Tuesday,1,Clear,0.62,0.6212,0.41,0.3582,37,153,190,188,190,190
12895,2012-06-26,Fall,2012,Jun,11,0,Tuesday,1,Clear,0.64,0.6212,0.36,0.4179,46,189,235,188,235,235
12896,2012-06-26,Fall,2012,Jun,12,0,Tuesday,1,Clear,0.66,0.6212,0.34,0.4478,80,228,308,188,308,308
12897,2012-06-26,Fall,2012,Jun,13,0,Tuesday,1,Clear,0.7,0.6364,0.3,0.4627,74,232,306,188,306,306
12898,2012-06-26,Fall,2012,Jun,14,0,Tuesday,1,Clear,0.7,0.6364,0.3,0.4627,81,186,267,188,267,267
12899,2012-06-26,Fall,2012,Jun,15,0,Tuesday,1,Clear,0.72,0.6515,0.28,0.4627,88,229,317,188,317,317
12900,2012-06-26,Fall,2012,Jun,16,0,Tuesday,1,Clear,0.72,0.6364,0.26,0.4925,67,349,416,188,416,416
12901,2012-06-26,Fall,2012,Jun,17,0,Tuesday,1,Clear,0.72,0.6515,0.28,0.4179,104,796,900,188,900,900
12902,2012-06-26,Fall,2012,Jun,18,0,Tuesday,1,Clear,0.72,0.6515,0.28,0.3582,105,719,824,188,824,824
12903,2012-06-26,Fall,2012,Jun,19,0,Tuesday,1,Clear,0.72,0.6515,0.28,0.2239,83,529,612,188,612,612
12904,2012-06-26,Fall,2012,Jun,20,0,Tuesday,1,Clear,0.7,0.6364,0.3,0.2836,88,417,505,188,505,505
12905,2012-06-26,Fall,2012,Jun,21,0,Tuesday,1,Clear,0.68,0.6364,0.34,0.194,61,267,328,188,328,328
12906,2012-06-26,Fall,2012,Jun,22,0,Tuesday,1,Clear,0.66,0.6212,0.34,0.2537,26,219,245,188,245,245
12907,2012-06-26,Fall,2012,Jun,23,0,Tuesday,1,Clear,0.62,0.6212,0.41,0.1343,13,118,131,188,131,131
12908,2012-06-27,Fall,2012,Jun,0,0,Wednesday,1,Clear,0.62,0.6212,0.41,0.194,15,39,54,187,54,54
12909,2012-06-27,Fall,2012,Jun,1,0,Wednesday,1,Clear,0.6,0.6212,0.43,0.1642,5,18,23,187,23,23
12910,2012-06-27,Fall,2012,Jun,2,0,Wednesday,1,Clear,0.56,0.5303,0.49,0.1343,2,12,14,187,14,14
12911,2012-06-27,Fall,2012,Jun,3,0,Wednesday,1,Clear,0.58,0.5455,0.46,0.0896,1,7,8,187,8,8
12912,2012-06-27,Fall,2012,Jun,4,0,Wednesday,1,Clear,0.6,0.6212,0.4,0.2537,0,11,11,187,11,11
12913,2012-06-27,Fall,2012,Jun,5,0,Wednesday,1,Clear,0.6,0.6212,0.43,0.2836,2,34,36,187,36,36
12914,2012-06-27,Fall,2012,Jun,6,0,Wednesday,1,Clear,0.58,0.5455,0.46,0.2836,7,193,200,187,200,200
12915,2012-06-27,Fall,2012,Jun,7,0,Wednesday,1,Clear,0.6,0.6212,0.43,0.3582,29,498,527,187,527,527
12916,2012-06-27,Fall,2012,Jun,8,0,Wednesday,1,Clear,0.62,0.6212,0.43,0.3284,49,638,687,187,687,687
12917,2012-06-27,Fall,2012,Jun,9,0,Wednesday,1,Clear,0.66,0.6212,0.41,0.3582,29,253,282,187,282,282
12918,2012-06-27,Fall,2012,Jun,10,0,Wednesday,1,Clear,0.7,0.6364,0.37,0.2537,34,138,172,187,172,172
12919,2012-06-27,Fall,2012,Jun,11,0,Wednesday,1,Clear,0.74,0.6515,0.3,0.3284,64,145,209,187,209,209
12920,2012-06-27,Fall,2012,Jun,12,0,Wednesday,1,Clear,0.76,0.6667,0.29,0.2985,77,245,322,187,322,322
12921,2012-06-27,Fall,2012,Jun,13,0,Wednesday,1,Clear,0.8,0.697,0.27,0.3284,77,244,321,187,321,321
12922,2012-06-27,Fall,2012,Jun,14,0,Wednesday,1,Clear,0.8,0.6818,0.24,0.3582,78,192,270,187,270,270
12923,2012-06-27,Fall,2012,Jun,15,0,Wednesday,1,Clear,0.8,0.697,0.26,0.4627,61,188,249,187,249,249
12924,2012-06-27,Fall,2012,Jun,16,0,Wednesday,1,Clear,0.82,0.697,0.24,0.4478,55,337,392,187,392,392
12925,2012-06-27,Fall,2012,Jun,17,0,Wednesday,1,Clear,0.82,0.697,0.24,0.3881,113,730,843,187,843,843
12926,2012-06-27,Fall,2012,Jun,18,0,Wednesday,1,Clear,0.8,0.697,0.27,0.3284,85,719,804,187,804,804
12927,2012-06-27,Fall,2012,Jun,19,0,Wednesday,1,Clear,0.78,0.6818,0.29,0.3284,101,542,643,187,643,643
12928,2012-06-27,Fall,2012,Jun,20,0,Wednesday,1,Clear,0.76,0.6667,0.31,0.194,76,369,445,187,445,445
12929,2012-06-27,Fall,2012,Jun,21,0,Wednesday,1,Clear,0.74,0.6515,0.35,0.1343,54,313,367,187,367,367
12930,2012-06-27,Fall,2012,Jun,22,0,Wednesday,1,Clear,0.72,0.6515,0.39,0.0896,52,245,297,187,297,297
12931,2012-06-27,Fall,2012,Jun,23,0,Wednesday,1,Clear,0.68,0.6364,0.47,0.1343,11,148,159,187,159,159
12932,2012-06-28,Fall,2012,Jun,0,0,Thursday,1,Clear,0.66,0.6212,0.5,0.1045,2,52,54,186,54,54
12933,2012-06-28,Fall,2012,Jun,1,0,Thursday,1,Clear,0.66,0.6212,0.54,0.0,11,14,25,186,25,25
12934,2012-06-28,Fall,2012,Jun,2,0,Thursday,1,Clear,0.66,0.6212,0.5,0.0896,1,12,13,186,13,13
12935,2012-06-28,Fall,2012,Jun,3,0,Thursday,1,Clear,0.66,0.6212,0.5,0.0896,1,6,7,186,7,7
12936,2012-06-28,Fall,2012,Jun,4,0,Thursday,1,Clear,0.62,0.6061,0.61,0.1045,0,11,11,186,11,11
12937,2012-06-28,Fall,2012,Jun,5,0,Thursday,1,Clear,0.62,0.6212,0.57,0.0896,8,39,47,186,47,47
12938,2012-06-28,Fall,2012,Jun,6,0,Thursday,1,Clear,0.62,0.6212,0.57,0.0896,8,185,193,186,193,193
12939,2012-06-28,Fall,2012,Jun,7,0,Thursday,1,Clear,0.62,0.6061,0.61,0.1045,24,484,508,186,508,508
12940,2012-06-28,Fall,2012,Jun,8,0,Thursday,1,Clear,0.66,0.6212,0.5,0.1343,40,577,617,186,617,617
12941,2012-06-28,Fall,2012,Jun,9,0,Thursday,1,Clear,0.7,0.6515,0.54,0.1642,33,318,351,186,351,351
12942,2012-06-28,Fall,2012,Jun,10,0,Thursday,1,Clear,0.74,0.6667,0.48,0.194,40,144,184,186,184,184
12943,2012-06-28,Fall,2012,Jun,11,0,Thursday,1,Clear,0.8,0.697,0.31,0.194,41,170,211,186,211,211
12944,2012-06-28,Fall,2012,Jun,12,0,Thursday,1,Clear,0.84,0.7121,0.26,0.2836,49,227,276,186,276,276
12945,2012-06-28,Fall,2012,Jun,13,0,Thursday,1,Clear,0.86,0.7424,0.26,0.2239,31,205,236,186,236,236
12946,2012-06-28,Fall,2012,Jun,14,0,Thursday,1,Clear,0.86,0.7273,0.25,0.3284,66,188,254,186,254,254
12947,2012-06-28,Fall,2012,Jun,15,0,Thursday,1,Clear,0.86,0.7273,0.25,0.3284,24,195,219,186,219,219
12948,2012-06-28,Fall,2012,Jun,16,0,Thursday,1,Clear,0.88,0.7424,0.23,0.194,56,331,387,186,387,387
12949,2012-06-28,Fall,2012,Jun,17,0,Thursday,1,Clear,0.88,0.7424,0.22,0.194,71,634,705,186,705,705
12950,2012-06-28,Fall,2012,Jun,18,0,Thursday,1,Clear,0.86,0.7273,0.25,0.2239,100,597,697,186,697,697
12951,2012-06-28,Fall,2012,Jun,19,0,Thursday,1,Clear,0.84,0.7273,0.3,0.2985,79,492,571,186,571,571
12952,2012-06-28,Fall,2012,Jun,20,0,Thursday,1,Clear,0.82,0.7273,0.34,0.194,71,399,470,186,470,470
12953,2012-06-28,Fall,2012,Jun,21,0,Thursday,1,Clear,0.76,0.697,0.55,0.194,89,309,398,186,398,398
12954,2012-06-28,Fall,2012,Jun,22,0,Thursday,1,Clear,0.76,0.697,0.52,0.1642,50,224,274,186,274,274
12955,2012-06-28,Fall,2012,Jun,23,0,Thursday,1,Clear,0.74,0.6667,0.48,0.1343,26,145,171,186,171,171
12956,2012-06-29,Fall,2012,Jun,0,0,Friday,1,Clear,0.74,0.6667,0.48,0.1343,24,90,114,185,114,114
12957,2012-06-29,Fall,2012,Jun,1,0,Friday,1,Clear,0.74,0.6667,0.51,0.1642,9,33,42,185,42,42
12958,2012-06-29,Fall,2012,Jun,2,0,Friday,1,Clear,0.72,0.6667,0.58,0.194,3,15,18,185,18,18
12959,2012-06-29,Fall,2012,Jun,3,0,Friday,1,Clear,0.72,0.6667,0.58,0.194,3,5,8,185,8,8
12960,2012-06-29,Fall,2012,Jun,4,0,Friday,1,Clear,0.7,0.6515,0.65,0.1642,1,9,10,185,10,10
12961,2012-06-29,Fall,2012,Jun,5,0,Friday,1,Clear,0.7,0.6515,0.61,0.1045,6,39,45,185,45,45
12962,2012-06-29,Fall,2012,Jun,6,0,Friday,1,Misty,0.7,0.6515,0.61,0.1642,15,148,163,185,163,163
12963,2012-06-29,Fall,2012,Jun,7,0,Friday,1,Clear,0.7,0.6515,0.61,0.1045,19,361,380,185,380,380
12964,2012-06-29,Fall,2012,Jun,8,0,Friday,1,Misty,0.74,0.6818,0.55,0.1045,48,576,624,185,624,624
12965,2012-06-29,Fall,2012,Jun,9,0,Friday,1,Clear,0.76,0.697,0.55,0.1642,39,261,300,185,300,300
12966,2012-06-29,Fall,2012,Jun,10,0,Friday,1,Clear,0.9,0.8333,0.39,0.2985,32,139,171,185,171,171
12967,2012-06-29,Fall,2012,Jun,11,0,Friday,1,Misty,0.9,0.8485,0.42,0.2836,51,137,188,185,188,188
12968,2012-06-29,Fall,2012,Jun,12,0,Friday,1,Misty,0.92,0.8788,0.4,0.2537,53,173,226,185,226,226
12969,2012-06-29,Fall,2012,Jun,13,0,Friday,1,Clear,0.94,0.8788,0.38,0.194,45,194,239,185,239,239
12970,2012-06-29,Fall,2012,Jun,14,0,Friday,1,Clear,0.96,0.9091,0.36,0.2239,49,184,233,185,233,233
12971,2012-06-29,Fall,2012,Jun,15,0,Friday,1,Clear,0.96,0.9091,0.36,0.0,47,183,230,185,230,230
12972,2012-06-29,Fall,2012,Jun,16,0,Friday,1,Clear,0.96,0.9091,0.36,0.0,59,292,351,185,351,351
12973,2012-06-29,Fall,2012,Jun,17,0,Friday,1,Clear,0.98,0.9242,0.34,0.194,82,457,539,185,539,539
12974,2012-06-29,Fall,2012,Jun,18,0,Friday,1,Clear,0.96,0.8636,0.31,0.0,50,414,464,185,464,464
12975,2012-06-29,Fall,2012,Jun,19,0,Friday,1,Clear,0.9,0.8788,0.47,0.194,60,303,363,185,363,363
12976,2012-06-29,Fall,2012,Jun,20,0,Friday,1,Clear,0.92,0.8939,0.42,0.2537,53,255,308,185,308,308
12977,2012-06-29,Fall,2012,Jun,21,0,Friday,1,Misty,0.86,0.8333,0.53,0.194,41,195,236,185,236,236
12978,2012-06-29,Fall,2012,Jun,22,0,Friday,1,Light_rainsnow,0.82,0.8333,0.63,0.194,34,129,163,185,163,163
12979,2012-06-29,Fall,2012,Jun,23,0,Friday,1,Light_rainsnow,0.82,0.8333,0.63,0.194,6,42,48,185,48,48
12980,2012-06-30,Fall,2012,Jun,0,0,Saturday,0,Light_rainsnow,0.64,0.5758,0.89,0.1642,4,65,69,184,69,69
12981,2012-06-30,Fall,2012,Jun,1,0,Saturday,0,Light_rainsnow,0.64,0.5758,0.89,0.2239,3,55,58,184,58,58
12982,2012-06-30,Fall,2012,Jun,2,0,Saturday,0,Misty,0.64,0.5758,0.89,0.0,7,54,61,184,61,61
12983,2012-06-30,Fall,2012,Jun,3,0,Saturday,0,Misty,0.64,0.5758,0.89,0.0,3,20,23,184,23,23
12984,2012-06-30,Fall,2012,Jun,4,0,Saturday,0,Misty,0.62,0.5455,0.94,0.0,3,15,18,184,18,18
12985,2012-06-30,Fall,2012,Jun,5,0,Saturday,0,Clear,0.64,0.5758,0.89,0.1642,3,7,10,184,10,10
12986,2012-06-30,Fall,2012,Jun,6,0,Saturday,0,Clear,0.64,0.5758,0.89,0.1642,6,36,42,184,42,42
12987,2012-06-30,Fall,2012,Jun,7,0,Saturday,0,Clear,0.64,0.5758,0.89,0.1642,10,82,92,184,92,92
12988,2012-06-30,Fall,2012,Jun,8,0,Saturday,0,Clear,0.64,0.5758,0.89,0.1642,26,168,194,184,194,194
12989,2012-06-30,Fall,2012,Jun,9,0,Saturday,0,Clear,0.64,0.5758,0.89,0.1642,41,234,275,184,275,275
12990,2012-06-30,Fall,2012,Jun,10,0,Saturday,0,Clear,0.88,0.7727,0.3,0.2537,96,308,404,184,404,404
12991,2012-06-30,Fall,2012,Jun,11,0,Saturday,0,Clear,0.88,0.7727,0.3,0.2537,102,350,452,184,452,452
12992,2012-06-30,Fall,2012,Jun,12,0,Saturday,0,Clear,0.88,0.7727,0.3,0.2537,143,328,471,184,471,471
12993,2012-06-30,Fall,2012,Jun,13,0,Saturday,0,Clear,0.88,0.7727,0.3,0.2537,105,323,428,184,428,428
12994,2012-06-30,Fall,2012,Jun,14,0,Saturday,0,Clear,0.88,0.7727,0.3,0.2537,114,295,409,184,409,409
12995,2012-06-30,Fall,2012,Jun,15,0,Saturday,0,Clear,0.88,0.7727,0.3,0.2537,117,287,404,184,404,404
12996,2012-06-30,Fall,2012,Jun,16,0,Saturday,0,Clear,0.9,0.7879,0.29,0.1642,109,264,373,184,373,373
12997,2012-06-30,Fall,2012,Jun,17,0,Saturday,0,Clear,0.88,0.7727,0.32,0.1343,131,231,362,184,362,362
12998,2012-06-30,Fall,2012,Jun,18,0,Saturday,0,Clear,0.88,0.7879,0.35,0.0,91,248,339,184,339,339
12999,2012-06-30,Fall,2012,Jun,19,0,Saturday,0,Clear,0.84,0.7576,0.44,0.2537,134,240,374,184,374,374
13000,2012-06-30,Fall,2012,Jun,20,0,Saturday,0,Clear,0.82,0.7727,0.52,0.1642,88,204,292,184,292,292
13001,2012-06-30,Fall,2012,Jun,21,0,Saturday,0,Clear,0.82,0.7727,0.52,0.1642,48,165,213,184,213,213
13002,2012-06-30,Fall,2012,Jun,22,0,Saturday,0,Clear,0.78,0.7424,0.62,0.1642,38,134,172,184,172,172
13003,2012-06-30,Fall,2012,Jun,23,0,Saturday,0,Clear,0.78,0.7424,0.62,0.0896,33,119,152,184,152,152
13004,2012-07-01,Fall,2012,Jul,0,0,Sunday,0,Clear,0.76,0.7273,0.66,0.0,27,122,149,183,149,149
13005,2012-07-01,Fall,2012,Jul,1,0,Sunday,0,Clear,0.74,0.697,0.7,0.1343,12,81,93,183,93,93
13006,2012-07-01,Fall,2012,Jul,2,0,Sunday,0,Clear,0.72,0.697,0.74,0.0896,21,69,90,183,90,90
13007,2012-07-01,Fall,2012,Jul,3,0,Sunday,0,Clear,0.72,0.7121,0.84,0.1343,6,27,33,183,33,33
13008,2012-07-01,Fall,2012,Jul,4,0,Sunday,0,Clear,0.7,0.6667,0.79,0.194,0,4,4,183,4,4
13009,2012-07-01,Fall,2012,Jul,5,0,Sunday,0,Clear,0.68,0.6364,0.79,0.1045,3,7,10,183,10,10
13010,2012-07-01,Fall,2012,Jul,6,0,Sunday,0,Clear,0.7,0.6667,0.79,0.0896,8,19,27,183,27,27
13011,2012-07-01,Fall,2012,Jul,7,0,Sunday,0,Clear,0.74,0.697,0.7,0.0,13,37,50,183,50,50
13012,2012-07-01,Fall,2012,Jul,8,0,Sunday,0,Clear,0.78,0.7424,0.62,0.1045,36,106,142,183,142,142
13013,2012-07-01,Fall,2012,Jul,9,0,Sunday,0,Clear,0.82,0.7879,0.56,0.0,51,168,219,183,219,219
13014,2012-07-01,Fall,2012,Jul,10,0,Sunday,0,Clear,0.86,0.7879,0.44,0.2985,98,268,366,183,366,366
13015,2012-07-01,Fall,2012,Jul,11,0,Sunday,0,Clear,0.88,0.803,0.39,0.2239,121,256,377,183,377,377
13016,2012-07-01,Fall,2012,Jul,12,0,Sunday,0,Clear,0.9,0.8182,0.37,0.2239,114,319,433,183,433,433
13017,2012-07-01,Fall,2012,Jul,13,0,Sunday,0,Clear,0.92,0.8333,0.33,0.2537,111,309,420,183,420,420
13018,2012-07-01,Fall,2012,Jul,14,0,Sunday,0,Clear,0.92,0.8333,0.33,0.2537,98,346,444,183,444,444
13019,2012-07-01,Fall,2012,Jul,15,0,Sunday,0,Clear,0.9,0.8182,0.37,0.2836,101,244,345,183,345,345
13020,2012-07-01,Fall,2012,Jul,16,0,Sunday,0,Clear,0.92,0.8333,0.33,0.2985,85,228,313,183,313,313
13021,2012-07-01,Fall,2012,Jul,17,0,Sunday,0,Clear,0.92,0.803,0.26,0.2985,90,323,413,183,413,413
13022,2012-07-01,Fall,2012,Jul,18,0,Sunday,0,Clear,0.88,0.7727,0.32,0.3582,95,275,370,183,370,370
13023,2012-07-01,Fall,2012,Jul,19,0,Sunday,0,Clear,0.84,0.7424,0.39,0.1343,103,279,382,183,382,382
13024,2012-07-01,Fall,2012,Jul,20,0,Sunday,0,Clear,0.84,0.7424,0.39,0.1343,88,244,332,183,332,332
13025,2012-07-01,Fall,2012,Jul,21,0,Sunday,0,Clear,0.84,0.7424,0.39,0.1343,77,181,258,183,258,258
13026,2012-07-01,Fall,2012,Jul,22,0,Sunday,0,Clear,0.82,0.7424,0.43,0.1343,41,110,151,183,151,151
13027,2012-07-01,Fall,2012,Jul,23,0,Sunday,0,Light_rainsnow,0.78,0.7121,0.52,0.1642,22,88,110,183,110,110
13028,2012-07-02,Fall,2012,Jul,0,0,Monday,1,Misty,0.76,0.7121,0.58,0.2239,12,31,43,182,43,43
13029,2012-07-02,Fall,2012,Jul,1,0,Monday,1,Misty,0.76,0.7121,0.58,0.194,3,14,17,182,17,17
13030,2012-07-02,Fall,2012,Jul,2,0,Monday,1,Misty,0.74,0.6667,0.51,0.2537,1,14,15,182,15,15
13031,2012-07-02,Fall,2012,Jul,3,0,Monday,1,Misty,0.72,0.6667,0.54,0.4179,0,5,5,182,5,5
13032,2012-07-02,Fall,2012,Jul,4,0,Monday,1,Misty,0.72,0.6667,0.54,0.2985,2,10,12,182,12,12
13033,2012-07-02,Fall,2012,Jul,5,0,Monday,1,Misty,0.72,0.6667,0.51,0.0,3,37,40,182,40,40
13034,2012-07-02,Fall,2012,Jul,6,0,Monday,1,Clear,0.7,0.6515,0.58,0.1045,4,132,136,182,136,136
13035,2012-07-02,Fall,2012,Jul,7,0,Monday,1,Clear,0.74,0.6667,0.51,0.1045,8,390,398,182,398,398
13036,2012-07-02,Fall,2012,Jul,8,0,Monday,1,Clear,0.76,0.697,0.52,0.194,20,548,568,182,568,568
13037,2012-07-02,Fall,2012,Jul,9,0,Monday,1,Clear,0.78,0.697,0.46,0.2537,56,239,295,182,295,295
13038,2012-07-02,Fall,2012,Jul,10,0,Monday,1,Clear,0.8,0.7273,0.43,0.2537,70,104,174,182,174,174
13039,2012-07-02,Fall,2012,Jul,11,0,Monday,1,Clear,0.84,0.7273,0.28,0.2985,67,134,201,182,201,201
13040,2012-07-02,Fall,2012,Jul,12,0,Monday,1,Clear,0.84,0.7273,0.32,0.194,74,183,257,182,257,257
13041,2012-07-02,Fall,2012,Jul,13,0,Monday,1,Clear,0.86,0.7576,0.34,0.2239,74,162,236,182,236,236
13042,2012-07-02,Fall,2012,Jul,14,0,Monday,1,Clear,0.86,0.7576,0.34,0.2239,79,151,230,182,230,230
13043,2012-07-02,Fall,2012,Jul,15,0,Monday,1,Clear,0.84,0.7424,0.36,0.194,59,175,234,182,234,234
13044,2012-07-02,Fall,2012,Jul,16,0,Monday,1,Clear,0.84,0.7424,0.36,0.2836,61,304,365,182,365,365
13045,2012-07-02,Fall,2012,Jul,17,0,Monday,1,Clear,0.84,0.7273,0.32,0.1343,82,665,747,182,747,747
13046,2012-07-02,Fall,2012,Jul,18,0,Monday,1,Clear,0.84,0.7273,0.32,0.1642,72,658,730,182,730,730
13047,2012-07-02,Fall,2012,Jul,19,0,Monday,1,Clear,0.78,0.697,0.43,0.1343,71,510,581,182,581,581
13048,2012-07-02,Fall,2012,Jul,20,0,Monday,1,Clear,0.78,0.697,0.43,0.1343,38,357,395,182,395,395
13049,2012-07-02,Fall,2012,Jul,21,0,Monday,1,Clear,0.76,0.6818,0.45,0.1343,17,241,258,182,258,258
13050,2012-07-02,Fall,2012,Jul,22,0,Monday,1,Clear,0.74,0.6667,0.51,0.1642,19,169,188,182,188,188
13051,2012-07-02,Fall,2012,Jul,23,0,Monday,1,Clear,0.74,0.6667,0.51,0.1045,12,90,102,182,102,102
13052,2012-07-03,Fall,2012,Jul,0,0,Tuesday,1,Clear,0.72,0.6667,0.54,0.0,9,44,53,181,53,53
13053,2012-07-03,Fall,2012,Jul,1,0,Tuesday,1,Clear,0.72,0.6667,0.58,0.0,5,9,14,181,14,14
13054,2012-07-03,Fall,2012,Jul,2,0,Tuesday,1,Clear,0.72,0.6667,0.58,0.0,2,8,10,181,10,10
13055,2012-07-03,Fall,2012,Jul,3,0,Tuesday,1,Clear,0.7,0.6515,0.65,0.1343,0,2,2,181,2,2
13056,2012-07-03,Fall,2012,Jul,4,0,Tuesday,1,Clear,0.68,0.6364,0.65,0.1045,0,6,6,181,6,6
13057,2012-07-03,Fall,2012,Jul,5,0,Tuesday,1,Clear,0.7,0.6515,0.61,0.0,2,33,35,181,35,35
13058,2012-07-03,Fall,2012,Jul,6,0,Tuesday,1,Clear,0.7,0.6515,0.65,0.1343,5,149,154,181,154,154
13059,2012-07-03,Fall,2012,Jul,7,0,Tuesday,1,Clear,0.74,0.6818,0.58,0.0,21,462,483,181,483,483
13060,2012-07-03,Fall,2012,Jul,8,0,Tuesday,1,Clear,0.74,0.6818,0.62,0.0896,42,604,646,181,646,646
13061,2012-07-03,Fall,2012,Jul,9,0,Tuesday,1,Clear,0.8,0.7424,0.49,0.1642,46,226,272,181,272,272
13062,2012-07-03,Fall,2012,Jul,10,0,Tuesday,1,Clear,0.82,0.7424,0.43,0.2239,56,153,209,181,209,209
13063,2012-07-03,Fall,2012,Jul,11,0,Tuesday,1,Clear,0.86,0.7576,0.34,0.194,66,151,217,181,217,217
13064,2012-07-03,Fall,2012,Jul,12,0,Tuesday,1,Clear,0.88,0.7576,0.28,0.194,74,198,272,181,272,272
13065,2012-07-03,Fall,2012,Jul,13,0,Tuesday,1,Clear,0.9,0.7727,0.25,0.1343,80,203,283,181,283,283
13066,2012-07-03,Fall,2012,Jul,14,0,Tuesday,1,Clear,0.9,0.7727,0.25,0.194,69,241,310,181,310,310
13067,2012-07-03,Fall,2012,Jul,15,0,Tuesday,1,Misty,0.9,0.7727,0.24,0.0,71,330,401,181,401,401
13068,2012-07-03,Fall,2012,Jul,16,0,Tuesday,1,Misty,0.9,0.7727,0.24,0.194,90,437,527,181,527,527
13069,2012-07-03,Fall,2012,Jul,17,0,Tuesday,1,Misty,0.86,0.7424,0.3,0.1642,102,620,722,181,722,722
13070,2012-07-03,Fall,2012,Jul,18,0,Tuesday,1,Misty,0.86,0.7424,0.3,0.0,85,542,627,181,627,627
13071,2012-07-03,Fall,2012,Jul,19,0,Tuesday,1,Misty,0.84,0.7424,0.36,0.1343,66,431,497,181,497,497
13072,2012-07-03,Fall,2012,Jul,20,0,Tuesday,1,Light_rainsnow,0.76,0.697,0.55,0.4925,80,296,376,181,376,376
13073,2012-07-03,Fall,2012,Jul,21,0,Tuesday,1,Misty,0.7,0.6515,0.7,0.2836,36,160,196,181,196,196
13074,2012-07-03,Fall,2012,Jul,22,0,Tuesday,1,Clear,0.68,0.6364,0.79,0.194,26,151,177,181,177,177
13075,2012-07-03,Fall,2012,Jul,23,0,Tuesday,1,Clear,0.66,0.6061,0.83,0.0,19,152,171,181,171,171
13076,2012-07-04,Fall,2012,Jul,0,1,Wednesday,0,Clear,0.68,0.6364,0.79,0.0896,19,140,159,180,159,159
13077,2012-07-04,Fall,2012,Jul,1,1,Wednesday,0,Clear,0.68,0.6364,0.74,0.0,27,96,123,180,123,123
13078,2012-07-04,Fall,2012,Jul,2,1,Wednesday,0,Clear,0.66,0.6061,0.83,0.1343,27,66,93,180,93,93
13079,2012-07-04,Fall,2012,Jul,3,1,Wednesday,0,Clear,0.68,0.6364,0.74,0.194,9,23,32,180,32,32
13080,2012-07-04,Fall,2012,Jul,4,1,Wednesday,0,Clear,0.68,0.6364,0.69,0.2537,5,11,16,180,16,16
13081,2012-07-04,Fall,2012,Jul,5,1,Wednesday,0,Clear,0.66,0.6212,0.69,0.0,5,14,19,180,19,19
13082,2012-07-04,Fall,2012,Jul,6,1,Wednesday,0,Clear,0.66,0.6212,0.69,0.0,9,23,32,180,32,32
13083,2012-07-04,Fall,2012,Jul,7,1,Wednesday,0,Clear,0.68,0.6364,0.65,0.0,10,62,72,180,72,72
13084,2012-07-04,Fall,2012,Jul,8,1,Wednesday,0,Clear,0.7,0.6515,0.61,0.1045,43,110,153,180,153,153
13085,2012-07-04,Fall,2012,Jul,9,1,Wednesday,0,Clear,0.76,0.697,0.52,0.0,90,203,293,180,293,293
13086,2012-07-04,Fall,2012,Jul,10,1,Wednesday,0,Clear,0.8,0.7273,0.46,0.0,143,304,447,180,447,447
13087,2012-07-04,Fall,2012,Jul,11,1,Wednesday,0,Clear,0.82,0.7576,0.46,0.1343,164,321,485,180,485,485
13088,2012-07-04,Fall,2012,Jul,12,1,Wednesday,0,Clear,0.86,0.7879,0.41,0.2239,164,330,494,180,494,494
13089,2012-07-04,Fall,2012,Jul,13,1,Wednesday,0,Clear,0.9,0.8182,0.35,0.0,177,322,499,180,499,499
13090,2012-07-04,Fall,2012,Jul,14,1,Wednesday,0,Clear,0.9,0.8182,0.37,0.1642,190,357,547,180,547,547
13091,2012-07-04,Fall,2012,Jul,15,1,Wednesday,0,Clear,0.92,0.8485,0.35,0.2985,155,299,454,180,454,454
13092,2012-07-04,Fall,2012,Jul,16,1,Wednesday,0,Clear,0.92,0.8485,0.35,0.2537,163,226,389,180,389,389
13093,2012-07-04,Fall,2012,Jul,17,1,Wednesday,0,Clear,0.92,0.8485,0.35,0.2985,161,253,414,180,414,414
13094,2012-07-04,Fall,2012,Jul,18,1,Wednesday,0,Clear,0.9,0.8485,0.42,0.194,159,271,430,180,430,430
13095,2012-07-04,Fall,2012,Jul,19,1,Wednesday,0,Clear,0.86,0.803,0.47,0.2239,177,255,432,180,432,432
13096,2012-07-04,Fall,2012,Jul,20,1,Wednesday,0,Clear,0.86,0.803,0.47,0.2239,237,314,551,180,551,551
13097,2012-07-04,Fall,2012,Jul,21,1,Wednesday,0,Clear,0.84,0.803,0.53,0.1343,222,362,584,180,584,584
13098,2012-07-04,Fall,2012,Jul,22,1,Wednesday,0,Clear,0.82,0.7879,0.56,0.2239,175,327,502,180,502,502
13099,2012-07-04,Fall,2012,Jul,23,1,Wednesday,0,Misty,0.78,0.697,0.43,0.0896,31,152,183,180,183,183
13100,2012-07-05,Fall,2012,Jul,0,0,Thursday,1,Clear,0.74,0.6667,0.51,0.1045,17,71,88,179,88,88
13101,2012-07-05,Fall,2012,Jul,1,0,Thursday,1,Clear,0.74,0.6667,0.51,0.2836,6,24,30,179,30,30
13102,2012-07-05,Fall,2012,Jul,2,0,Thursday,1,Clear,0.74,0.6667,0.51,0.0,4,14,18,179,18,18
13103,2012-07-05,Fall,2012,Jul,3,0,Thursday,1,Clear,0.72,0.6667,0.54,0.194,2,5,7,179,7,7
13104,2012-07-05,Fall,2012,Jul,4,0,Thursday,1,Clear,0.72,0.6667,0.58,0.0,0,7,7,179,7,7
13105,2012-07-05,Fall,2012,Jul,5,0,Thursday,1,Clear,0.72,0.6818,0.62,0.0,1,28,29,179,29,29
13106,2012-07-05,Fall,2012,Jul,6,0,Thursday,1,Clear,0.72,0.6667,0.58,0.0,3,130,133,179,133,133
13107,2012-07-05,Fall,2012,Jul,7,0,Thursday,1,Clear,0.76,0.697,0.55,0.0,27,316,343,179,343,343
13108,2012-07-05,Fall,2012,Jul,8,0,Thursday,1,Clear,0.8,0.7424,0.49,0.1343,36,514,550,179,550,550
13109,2012-07-05,Fall,2012,Jul,9,0,Thursday,1,Clear,0.84,0.7879,0.49,0.2985,47,246,293,179,293,293
13110,2012-07-05,Fall,2012,Jul,10,0,Thursday,1,Clear,0.86,0.7879,0.44,0.3582,69,117,186,179,186,186
13111,2012-07-05,Fall,2012,Jul,11,0,Thursday,1,Clear,0.9,0.8182,0.35,0.2985,107,137,244,179,244,244
13112,2012-07-05,Fall,2012,Jul,12,0,Thursday,1,Clear,0.9,0.8182,0.35,0.3582,88,188,276,179,276,276
13113,2012-07-05,Fall,2012,Jul,13,0,Thursday,1,Clear,0.92,0.8333,0.33,0.2239,129,181,310,179,310,310
13114,2012-07-05,Fall,2012,Jul,14,0,Thursday,1,Clear,0.92,0.8333,0.33,0.3284,87,154,241,179,241,241
13115,2012-07-05,Fall,2012,Jul,15,0,Thursday,1,Clear,0.92,0.8333,0.33,0.3582,71,183,254,179,254,254
13116,2012-07-05,Fall,2012,Jul,16,0,Thursday,1,Clear,0.92,0.8333,0.33,0.2537,109,324,433,179,433,433
13117,2012-07-05,Fall,2012,Jul,17,0,Thursday,1,Clear,0.92,0.8485,0.35,0.1642,114,575,689,179,689,689
13118,2012-07-05,Fall,2012,Jul,18,0,Thursday,1,Misty,0.9,0.8333,0.39,0.3284,96,511,607,179,607,607
13119,2012-07-05,Fall,2012,Jul,19,0,Thursday,1,Misty,0.88,0.803,0.39,0.2537,128,375,503,179,503,503
13120,2012-07-05,Fall,2012,Jul,20,0,Thursday,1,Misty,0.86,0.7879,0.41,0.2239,78,243,321,179,321,321
13121,2012-07-05,Fall,2012,Jul,21,0,Thursday,1,Clear,0.84,0.7727,0.47,0.194,91,232,323,179,323,323
13122,2012-07-05,Fall,2012,Jul,22,0,Thursday,1,Clear,0.82,0.803,0.59,0.1343,63,162,225,179,225,225
13123,2012-07-05,Fall,2012,Jul,23,0,Thursday,1,Clear,0.8,0.7576,0.55,0.1642,32,99,131,179,131,131
13124,2012-07-06,Fall,2012,Jul,0,0,Friday,1,Clear,0.78,0.7424,0.62,0.1343,39,63,102,178,102,102
13125,2012-07-06,Fall,2012,Jul,1,0,Friday,1,Clear,0.78,0.7273,0.55,0.2239,7,22,29,178,29,29
13126,2012-07-06,Fall,2012,Jul,2,0,Friday,1,Clear,0.76,0.7121,0.62,0.1343,4,13,17,178,17,17
13127,2012-07-06,Fall,2012,Jul,3,0,Friday,1,Misty,0.74,0.697,0.7,0.194,1,6,7,178,7,7
13128,2012-07-06,Fall,2012,Jul,4,0,Friday,1,Clear,0.74,0.697,0.66,0.2239,2,4,6,178,6,6
13129,2012-07-06,Fall,2012,Jul,5,0,Friday,1,Clear,0.74,0.697,0.66,0.194,4,31,35,178,35,35
13130,2012-07-06,Fall,2012,Jul,6,0,Friday,1,Clear,0.74,0.697,0.66,0.194,4,127,131,178,131,131
13131,2012-07-06,Fall,2012,Jul,7,0,Friday,1,Clear,0.78,0.697,0.46,0.1343,20,333,353,178,353,353
13132,2012-07-06,Fall,2012,Jul,8,0,Friday,1,Clear,0.8,0.7121,0.41,0.1642,28,557,585,178,585,585
13133,2012-07-06,Fall,2012,Jul,9,0,Friday,1,Clear,0.82,0.7273,0.36,0.1343,55,249,304,178,304,304
13134,2012-07-06,Fall,2012,Jul,10,0,Friday,1,Clear,0.86,0.7424,0.3,0.0,80,130,210,178,210,210
13135,2012-07-06,Fall,2012,Jul,11,0,Friday,1,Clear,0.84,0.7273,0.32,0.0896,92,141,233,178,233,233
13136,2012-07-06,Fall,2012,Jul,12,0,Friday,1,Clear,0.88,0.7576,0.28,0.1045,111,220,331,178,331,331
13137,2012-07-06,Fall,2012,Jul,13,0,Friday,1,Clear,0.9,0.7879,0.27,0.1045,99,194,293,178,293,293
13138,2012-07-06,Fall,2012,Jul,14,0,Friday,1,Clear,0.9,0.803,0.31,0.1642,91,184,275,178,275,275
13139,2012-07-06,Fall,2012,Jul,15,0,Friday,1,Clear,0.92,0.8182,0.29,0.194,79,206,285,178,285,285
13140,2012-07-06,Fall,2012,Jul,16,0,Friday,1,Clear,0.92,0.8182,0.29,0.1045,69,300,369,178,369,369
13141,2012-07-06,Fall,2012,Jul,17,0,Friday,1,Clear,0.92,0.8182,0.29,0.0,90,486,576,178,576,576
13142,2012-07-06,Fall,2012,Jul,18,0,Friday,1,Clear,0.9,0.803,0.33,0.2537,106,454,560,178,560,560
13143,2012-07-06,Fall,2012,Jul,19,0,Friday,1,Clear,0.88,0.7879,0.35,0.2239,112,306,418,178,418,418
13144,2012-07-06,Fall,2012,Jul,20,0,Friday,1,Clear,0.86,0.7727,0.39,0.1045,91,245,336,178,336,336
13145,2012-07-06,Fall,2012,Jul,21,0,Friday,1,Clear,0.82,0.7727,0.52,0.1343,77,223,300,178,300,300
13146,2012-07-06,Fall,2012,Jul,22,0,Friday,1,Clear,0.8,0.7576,0.55,0.194,78,210,288,178,288,288
13147,2012-07-06,Fall,2012,Jul,23,0,Friday,1,Clear,0.8,0.7879,0.63,0.1045,27,137,164,178,164,164
13148,2012-07-07,Fall,2012,Jul,0,0,Saturday,0,Clear,0.78,0.7576,0.66,0.1343,35,115,150,177,150,150
13149,2012-07-07,Fall,2012,Jul,1,0,Saturday,0,Clear,0.76,0.7273,0.7,0.1642,16,55,71,177,71,71
13150,2012-07-07,Fall,2012,Jul,2,0,Saturday,0,Clear,0.76,0.7424,0.72,0.1642,11,47,58,177,58,58
13151,2012-07-07,Fall,2012,Jul,3,0,Saturday,0,Clear,0.74,0.7121,0.74,0.1343,12,19,31,177,31,31
13152,2012-07-07,Fall,2012,Jul,4,0,Saturday,0,Clear,0.74,0.7121,0.74,0.1642,3,13,16,177,16,16
13153,2012-07-07,Fall,2012,Jul,5,0,Saturday,0,Clear,0.74,0.7121,0.74,0.194,2,12,14,177,14,14
13154,2012-07-07,Fall,2012,Jul,6,0,Saturday,0,Clear,0.74,0.7121,0.74,0.1045,4,27,31,177,31,31
13155,2012-07-07,Fall,2012,Jul,7,0,Saturday,0,Clear,0.78,0.7576,0.66,0.1045,8,63,71,177,71,71
13156,2012-07-07,Fall,2012,Jul,8,0,Saturday,0,Clear,0.82,0.8333,0.63,0.194,32,120,152,177,152,152
13157,2012-07-07,Fall,2012,Jul,9,0,Saturday,0,Clear,0.84,0.8333,0.59,0.1642,69,187,256,177,256,256
13158,2012-07-07,Fall,2012,Jul,10,0,Saturday,0,Clear,0.92,0.8636,0.37,0.2239,100,225,325,177,325,325
13159,2012-07-07,Fall,2012,Jul,11,0,Saturday,0,Clear,0.94,0.8788,0.38,0.194,122,245,367,177,367,367
13160,2012-07-07,Fall,2012,Jul,12,0,Saturday,0,Clear,0.96,0.8636,0.31,0.3582,124,218,342,177,342,342
13161,2012-07-07,Fall,2012,Jul,13,0,Saturday,0,Misty,0.96,0.8636,0.31,0.2537,116,244,360,177,360,360
13162,2012-07-07,Fall,2012,Jul,14,0,Saturday,0,Misty,0.96,0.8636,0.3,0.1343,105,203,308,177,308,308
13163,2012-07-07,Fall,2012,Jul,15,0,Saturday,0,Clear,0.96,0.8485,0.26,0.0,113,193,306,177,306,306
13164,2012-07-07,Fall,2012,Jul,16,0,Saturday,0,Clear,1.0,0.8636,0.19,0.1642,102,192,294,177,294,294
13165,2012-07-07,Fall,2012,Jul,17,0,Saturday,0,Clear,0.96,0.8485,0.26,0.1343,103,176,279,177,279,279
13166,2012-07-07,Fall,2012,Jul,18,0,Saturday,0,Clear,0.94,0.8333,0.29,0.0896,83,194,277,177,277,277
13167,2012-07-07,Fall,2012,Jul,19,0,Saturday,0,Clear,0.92,0.8333,0.33,0.1343,68,219,287,177,287,287
13168,2012-07-07,Fall,2012,Jul,20,0,Saturday,0,Clear,0.9,0.8182,0.37,0.1642,79,197,276,177,276,276
13169,2012-07-07,Fall,2012,Jul,21,0,Saturday,0,Clear,0.88,0.7879,0.37,0.194,51,150,201,177,201,201
13170,2012-07-07,Fall,2012,Jul,22,0,Saturday,0,Clear,0.84,0.8333,0.59,0.194,56,164,220,177,220,220
13171,2012-07-07,Fall,2012,Jul,23,0,Saturday,0,Clear,0.84,0.8182,0.56,0.1642,34,114,148,177,148,148
13172,2012-07-08,Fall,2012,Jul,0,0,Sunday,0,Clear,0.82,0.7879,0.56,0.1343,22,125,147,176,147,147
13173,2012-07-08,Fall,2012,Jul,1,0,Sunday,0,Clear,0.82,0.7879,0.56,0.1045,25,99,124,176,124,124
13174,2012-07-08,Fall,2012,Jul,2,0,Sunday,0,Clear,0.82,0.7727,0.52,0.1045,11,59,70,176,70,70
13175,2012-07-08,Fall,2012,Jul,3,0,Sunday,0,Clear,0.8,0.7727,0.59,0.1045,1,34,35,176,35,35
13176,2012-07-08,Fall,2012,Jul,4,0,Sunday,0,Clear,0.78,0.7576,0.66,0.1045,2,11,13,176,13,13
13177,2012-07-08,Fall,2012,Jul,5,0,Sunday,0,Clear,0.78,0.7424,0.62,0.0,1,5,6,176,6,6
13178,2012-07-08,Fall,2012,Jul,6,0,Sunday,0,Clear,0.78,0.7727,0.7,0.1343,5,16,21,176,21,21
13179,2012-07-08,Fall,2012,Jul,7,0,Sunday,0,Clear,0.8,0.803,0.66,0.0,19,33,52,176,52,52
13180,2012-07-08,Fall,2012,Jul,8,0,Sunday,0,Clear,0.84,0.803,0.53,0.1343,35,95,130,176,130,130
13181,2012-07-08,Fall,2012,Jul,9,0,Sunday,0,Clear,0.86,0.8182,0.5,0.1045,70,172,242,176,242,242
13182,2012-07-08,Fall,2012,Jul,10,0,Sunday,0,Clear,0.9,0.8636,0.45,0.0,85,234,319,176,319,319
13183,2012-07-08,Fall,2012,Jul,11,0,Sunday,0,Clear,0.92,0.8939,0.42,0.2985,120,269,389,176,389,389
13184,2012-07-08,Fall,2012,Jul,12,0,Sunday,0,Clear,0.92,0.8939,0.42,0.194,105,271,376,176,376,376
13185,2012-07-08,Fall,2012,Jul,13,0,Sunday,0,Clear,0.94,0.8788,0.38,0.2537,118,219,337,176,337,337
13186,2012-07-08,Fall,2012,Jul,14,0,Sunday,0,Clear,0.96,0.9091,0.36,0.1642,77,235,312,176,312,312
13187,2012-07-08,Fall,2012,Jul,15,0,Sunday,0,Light_rainsnow,0.92,0.8939,0.42,0.2836,80,218,298,176,298,298
13188,2012-07-08,Fall,2012,Jul,16,0,Sunday,0,Misty,0.8,0.803,0.66,0.2239,65,226,291,176,291,291
13189,2012-07-08,Fall,2012,Jul,17,0,Sunday,0,Clear,0.78,0.7424,0.59,0.0,68,202,270,176,270,270
13190,2012-07-08,Fall,2012,Jul,18,0,Sunday,0,Clear,0.78,0.7424,0.62,0.1045,54,199,253,176,253,253
13191,2012-07-08,Fall,2012,Jul,19,0,Sunday,0,Clear,0.78,0.7424,0.62,0.1642,66,184,250,176,250,250
13192,2012-07-08,Fall,2012,Jul,20,0,Sunday,0,Clear,0.76,0.7273,0.7,0.0896,79,206,285,176,285,285
13193,2012-07-08,Fall,2012,Jul,21,0,Sunday,0,Clear,0.76,0.7273,0.7,0.1343,58,149,207,176,207,207
13194,2012-07-08,Fall,2012,Jul,22,0,Sunday,0,Light_rainsnow,0.74,0.697,0.7,0.0896,12,110,122,176,122,122
13195,2012-07-08,Fall,2012,Jul,23,0,Sunday,0,Light_rainsnow,0.68,0.6364,0.83,0.0896,25,98,123,176,123,123
13196,2012-07-09,Fall,2012,Jul,0,0,Monday,1,Misty,0.68,0.6364,0.89,0.0896,6,33,39,175,39,39
13197,2012-07-09,Fall,2012,Jul,1,0,Monday,1,Light_rainsnow,0.7,0.6667,0.89,0.1045,5,13,18,175,18,18
13198,2012-07-09,Fall,2012,Jul,2,0,Monday,1,Light_rainsnow,0.7,0.6667,0.89,0.194,1,4,5,175,5,5
13199,2012-07-09,Fall,2012,Jul,3,0,Monday,1,Light_rainsnow,0.7,0.6667,0.89,0.194,0,5,5,175,5,5
13200,2012-07-09,Fall,2012,Jul,4,0,Monday,1,Light_rainsnow,0.66,0.5909,0.89,0.3881,1,1,2,175,2,2
13201,2012-07-09,Fall,2012,Jul,5,0,Monday,1,Misty,0.66,0.6061,0.83,0.2239,1,27,28,175,28,28
13202,2012-07-09,Fall,2012,Jul,6,0,Monday,1,Light_rainsnow,0.64,0.5758,0.89,0.2537,6,86,92,175,92,92
13203,2012-07-09,Fall,2012,Jul,7,0,Monday,1,Light_rainsnow,0.66,0.6061,0.83,0.2239,7,223,230,175,230,230
13204,2012-07-09,Fall,2012,Jul,8,0,Monday,1,Misty,0.66,0.6061,0.83,0.1642,26,429,455,175,455,455
13205,2012-07-09,Fall,2012,Jul,9,0,Monday,1,Misty,0.66,0.6061,0.83,0.1642,38,325,363,175,363,363
13206,2012-07-09,Fall,2012,Jul,10,0,Monday,1,Misty,0.66,0.6061,0.83,0.194,58,117,175,175,175,175
13207,2012-07-09,Fall,2012,Jul,11,0,Monday,1,Misty,0.72,0.6818,0.62,0.1343,72,144,216,175,216,216
13208,2012-07-09,Fall,2012,Jul,12,0,Monday,1,Misty,0.74,0.6818,0.58,0.1343,61,205,266,175,266,266
13209,2012-07-09,Fall,2012,Jul,13,0,Monday,1,Misty,0.76,0.697,0.55,0.2537,67,188,255,175,255,255
13210,2012-07-09,Fall,2012,Jul,14,0,Monday,1,Misty,0.74,0.6818,0.55,0.2537,58,184,242,175,242,242
13211,2012-07-09,Fall,2012,Jul,15,0,Monday,1,Misty,0.76,0.6818,0.45,0.2239,66,214,280,175,280,280
13212,2012-07-09,Fall,2012,Jul,16,0,Monday,1,Clear,0.78,0.697,0.4,0.2836,88,325,413,175,413,413
13213,2012-07-09,Fall,2012,Jul,17,0,Monday,1,Clear,0.78,0.697,0.4,0.1642,108,741,849,175,849,849
13214,2012-07-09,Fall,2012,Jul,18,0,Monday,1,Clear,0.76,0.6818,0.48,0.1343,82,790,872,175,872,872
13215,2012-07-09,Fall,2012,Jul,19,0,Monday,1,Clear,0.74,0.6818,0.55,0.1642,88,543,631,175,631,631
13216,2012-07-09,Fall,2012,Jul,20,0,Monday,1,Misty,0.74,0.6818,0.55,0.1045,69,378,447,175,447,447
13217,2012-07-09,Fall,2012,Jul,21,0,Monday,1,Misty,0.74,0.6818,0.55,0.0896,33,298,331,175,331,331
13218,2012-07-09,Fall,2012,Jul,22,0,Monday,1,Misty,0.72,0.6667,0.58,0.1045,35,189,224,175,224,224
13219,2012-07-09,Fall,2012,Jul,23,0,Monday,1,Misty,0.7,0.6515,0.65,0.1045,22,109,131,175,131,131
13220,2012-07-10,Fall,2012,Jul,0,0,Tuesday,1,Clear,0.7,0.6515,0.7,0.0896,16,53,69,174,69,69
13221,2012-07-10,Fall,2012,Jul,1,0,Tuesday,1,Clear,0.7,0.6667,0.74,0.1343,0,15,15,174,15,15
13222,2012-07-10,Fall,2012,Jul,2,0,Tuesday,1,Clear,0.7,0.6667,0.74,0.1343,1,15,16,174,16,16
13223,2012-07-10,Fall,2012,Jul,3,0,Tuesday,1,Clear,0.68,0.6364,0.79,0.0,0,3,3,174,3,3
13224,2012-07-10,Fall,2012,Jul,4,0,Tuesday,1,Clear,0.68,0.6364,0.79,0.1343,0,4,4,174,4,4
13225,2012-07-10,Fall,2012,Jul,5,0,Tuesday,1,Clear,0.66,0.6061,0.83,0.1343,3,39,42,174,42,42
13226,2012-07-10,Fall,2012,Jul,6,0,Tuesday,1,Misty,0.68,0.6364,0.79,0.1045,4,183,187,174,187,187
13227,2012-07-10,Fall,2012,Jul,7,0,Tuesday,1,Misty,0.7,0.6667,0.74,0.1045,31,489,520,174,520,520
13228,2012-07-10,Fall,2012,Jul,8,0,Tuesday,1,Clear,0.72,0.697,0.74,0.1343,34,615,649,174,649,649
13229,2012-07-10,Fall,2012,Jul,9,0,Tuesday,1,Clear,0.74,0.697,0.66,0.1343,47,284,331,174,331,331
13230,2012-07-10,Fall,2012,Jul,10,0,Tuesday,1,Clear,0.76,0.7121,0.62,0.194,56,134,190,174,190,190
13231,2012-07-10,Fall,2012,Jul,11,0,Tuesday,1,Clear,0.8,0.7273,0.46,0.194,92,157,249,174,249,249
13232,2012-07-10,Fall,2012,Jul,12,0,Tuesday,1,Clear,0.8,0.7121,0.41,0.1343,69,203,272,174,272,272
13233,2012-07-10,Fall,2012,Jul,13,0,Tuesday,1,Clear,0.82,0.7273,0.38,0.194,77,203,280,174,280,280
13234,2012-07-10,Fall,2012,Jul,14,0,Tuesday,1,Clear,0.82,0.7273,0.38,0.1642,71,171,242,174,242,242
13235,2012-07-10,Fall,2012,Jul,15,0,Tuesday,1,Clear,0.8,0.7121,0.41,0.2239,77,188,265,174,265,265
13236,2012-07-10,Fall,2012,Jul,16,0,Tuesday,1,Clear,0.8,0.7273,0.43,0.2239,89,346,435,174,435,435
13237,2012-07-10,Fall,2012,Jul,17,0,Tuesday,1,Clear,0.78,0.7121,0.49,0.194,103,769,872,174,872,872
13238,2012-07-10,Fall,2012,Jul,18,0,Tuesday,1,Light_rainsnow,0.7,0.6667,0.74,0.2239,70,749,819,174,819,819
13239,2012-07-10,Fall,2012,Jul,19,0,Tuesday,1,Light_rainsnow,0.7,0.6667,0.74,0.2239,55,359,414,174,414,414
13240,2012-07-10,Fall,2012,Jul,20,0,Tuesday,1,Light_rainsnow,0.64,0.5758,0.83,0.2239,9,75,84,174,84,84
13241,2012-07-10,Fall,2012,Jul,21,0,Tuesday,1,Light_rainsnow,0.64,0.5758,0.89,0.1045,7,83,90,174,90,90
13242,2012-07-10,Fall,2012,Jul,22,0,Tuesday,1,Misty,0.64,0.5758,0.83,0.1343,14,125,139,174,139,139
13243,2012-07-10,Fall,2012,Jul,23,0,Tuesday,1,Misty,0.64,0.5758,0.89,0.1045,29,74,103,174,103,103
13244,2012-07-11,Fall,2012,Jul,0,0,Wednesday,1,Misty,0.66,0.6061,0.83,0.1343,6,38,44,173,44,44
13245,2012-07-11,Fall,2012,Jul,1,0,Wednesday,1,Clear,0.64,0.5758,0.89,0.0,3,11,14,173,14,14
13246,2012-07-11,Fall,2012,Jul,2,0,Wednesday,1,Clear,0.64,0.5758,0.89,0.0,0,5,5,173,5,5
13247,2012-07-11,Fall,2012,Jul,3,0,Wednesday,1,Clear,0.64,0.5758,0.89,0.1343,0,5,5,173,5,5
13248,2012-07-11,Fall,2012,Jul,4,0,Wednesday,1,Clear,0.64,0.5758,0.89,0.1343,1,6,7,173,7,7
13249,2012-07-11,Fall,2012,Jul,5,0,Wednesday,1,Clear,0.64,0.5758,0.89,0.0,5,36,41,173,41,41
13250,2012-07-11,Fall,2012,Jul,6,0,Wednesday,1,Clear,0.64,0.5758,0.89,0.1343,17,168,185,173,185,185
13251,2012-07-11,Fall,2012,Jul,7,0,Wednesday,1,Misty,0.66,0.6061,0.83,0.1045,26,471,497,173,497,497
13252,2012-07-11,Fall,2012,Jul,8,0,Wednesday,1,Misty,0.68,0.6364,0.79,0.1642,30,644,674,173,674,674
13253,2012-07-11,Fall,2012,Jul,9,0,Wednesday,1,Misty,0.7,0.6667,0.74,0.1343,30,298,328,173,328,328
13254,2012-07-11,Fall,2012,Jul,10,0,Wednesday,1,Misty,0.72,0.6818,0.62,0.1343,47,148,195,173,195,195
13255,2012-07-11,Fall,2012,Jul,11,0,Wednesday,1,Misty,0.76,0.7121,0.58,0.1343,56,173,229,173,229,229
13256,2012-07-11,Fall,2012,Jul,12,0,Wednesday,1,Misty,0.78,0.697,0.43,0.0,69,223,292,173,292,292
13257,2012-07-11,Fall,2012,Jul,13,0,Wednesday,1,Misty,0.8,0.7121,0.42,0.1642,65,208,273,173,273,273
13258,2012-07-11,Fall,2012,Jul,14,0,Wednesday,1,Clear,0.8,0.7121,0.41,0.2239,66,175,241,173,241,241
13259,2012-07-11,Fall,2012,Jul,15,0,Wednesday,1,Clear,0.8,0.7121,0.41,0.2537,56,220,276,173,276,276
13260,2012-07-11,Fall,2012,Jul,16,0,Wednesday,1,Clear,0.8,0.7121,0.38,0.194,53,358,411,173,411,411
13261,2012-07-11,Fall,2012,Jul,17,0,Wednesday,1,Clear,0.8,0.697,0.31,0.2239,90,740,830,173,830,830
13262,2012-07-11,Fall,2012,Jul,18,0,Wednesday,1,Clear,0.78,0.6818,0.38,0.2537,79,735,814,173,814,814
13263,2012-07-11,Fall,2012,Jul,19,0,Wednesday,1,Clear,0.74,0.6667,0.48,0.2239,73,560,633,173,633,633
13264,2012-07-11,Fall,2012,Jul,20,0,Wednesday,1,Clear,0.74,0.6667,0.51,0.1642,73,410,483,173,483,483
13265,2012-07-11,Fall,2012,Jul,21,0,Wednesday,1,Clear,0.72,0.6667,0.58,0.2239,69,322,391,173,391,391
13266,2012-07-11,Fall,2012,Jul,22,0,Wednesday,1,Clear,0.72,0.6667,0.58,0.2537,41,203,244,173,244,244
13267,2012-07-11,Fall,2012,Jul,23,0,Wednesday,1,Misty,0.7,0.6515,0.58,0.2537,20,132,152,173,152,152
13268,2012-07-12,Fall,2012,Jul,0,0,Thursday,1,Misty,0.68,0.6364,0.61,0.0,1,55,56,172,56,56
13269,2012-07-12,Fall,2012,Jul,1,0,Thursday,1,Misty,0.66,0.6212,0.61,0.0,0,21,21,172,21,21
13270,2012-07-12,Fall,2012,Jul,2,0,Thursday,1,Misty,0.66,0.6212,0.65,0.0896,0,9,9,172,9,9
13271,2012-07-12,Fall,2012,Jul,3,0,Thursday,1,Clear,0.64,0.6061,0.69,0.1045,0,10,10,172,10,10
13272,2012-07-12,Fall,2012,Jul,4,0,Thursday,1,Clear,0.64,0.6061,0.73,0.1045,0,5,5,172,5,5
13273,2012-07-12,Fall,2012,Jul,5,0,Thursday,1,Clear,0.62,0.5909,0.73,0.1045,4,40,44,172,44,44
13274,2012-07-12,Fall,2012,Jul,6,0,Thursday,1,Clear,0.64,0.6061,0.73,0.0896,7,171,178,172,178,178
13275,2012-07-12,Fall,2012,Jul,7,0,Thursday,1,Clear,0.64,0.6061,0.73,0.1343,32,480,512,172,512,512
13276,2012-07-12,Fall,2012,Jul,8,0,Thursday,1,Clear,0.68,0.6364,0.65,0.1343,49,653,702,172,702,702
13277,2012-07-12,Fall,2012,Jul,9,0,Thursday,1,Clear,0.72,0.6667,0.58,0.1045,42,285,327,172,327,327
13278,2012-07-12,Fall,2012,Jul,10,0,Thursday,1,Clear,0.74,0.6667,0.48,0.1642,69,145,214,172,214,214
13279,2012-07-12,Fall,2012,Jul,11,0,Thursday,1,Clear,0.76,0.6818,0.45,0.1045,49,166,215,172,215,215
13280,2012-07-12,Fall,2012,Jul,12,0,Thursday,1,Clear,0.78,0.6818,0.35,0.1343,71,221,292,172,292,292
13281,2012-07-12,Fall,2012,Jul,13,0,Thursday,1,Clear,0.8,0.697,0.33,0.2239,52,225,277,172,277,277
13282,2012-07-12,Fall,2012,Jul,14,0,Thursday,1,Clear,0.78,0.6818,0.33,0.2239,42,167,209,172,209,209
13283,2012-07-12,Fall,2012,Jul,15,0,Thursday,1,Clear,0.8,0.7121,0.36,0.194,63,208,271,172,271,271
13284,2012-07-12,Fall,2012,Jul,16,0,Thursday,1,Clear,0.8,0.7121,0.36,0.194,69,370,439,172,439,439
13285,2012-07-12,Fall,2012,Jul,17,0,Thursday,1,Clear,0.76,0.6818,0.43,0.2239,91,704,795,172,795,795
13286,2012-07-12,Fall,2012,Jul,18,0,Thursday,1,Clear,0.76,0.6818,0.45,0.1343,86,739,825,172,825,825
13287,2012-07-12,Fall,2012,Jul,19,0,Thursday,1,Clear,0.74,0.6667,0.48,0.2239,97,532,629,172,629,629
13288,2012-07-12,Fall,2012,Jul,20,0,Thursday,1,Clear,0.74,0.6667,0.48,0.2239,75,439,514,172,514,514
13289,2012-07-12,Fall,2012,Jul,21,0,Thursday,1,Clear,0.72,0.6667,0.48,0.2239,44,329,373,172,373,373
13290,2012-07-12,Fall,2012,Jul,22,0,Thursday,1,Clear,0.72,0.6667,0.51,0.1642,56,262,318,172,318,318
13291,2012-07-12,Fall,2012,Jul,23,0,Thursday,1,Misty,0.7,0.6515,0.51,0.2239,33,178,211,172,211,211
13292,2012-07-13,Fall,2012,Jul,0,0,Friday,1,Misty,0.7,0.6515,0.54,0.1642,19,76,95,171,95,95
13293,2012-07-13,Fall,2012,Jul,1,0,Friday,1,Misty,0.68,0.6364,0.54,0.1045,17,42,59,171,59,59
13294,2012-07-13,Fall,2012,Jul,2,0,Friday,1,Misty,0.66,0.6212,0.61,0.0896,2,15,17,171,17,17
13295,2012-07-13,Fall,2012,Jul,3,0,Friday,1,Misty,0.68,0.6364,0.61,0.0,2,7,9,171,9,9
13296,2012-07-13,Fall,2012,Jul,4,0,Friday,1,Misty,0.66,0.6212,0.61,0.0,0,11,11,171,11,11
13297,2012-07-13,Fall,2012,Jul,5,0,Friday,1,Misty,0.66,0.6364,0.56,0.0896,4,30,34,171,34,34
13298,2012-07-13,Fall,2012,Jul,6,0,Friday,1,Misty,0.7,0.6515,0.54,0.0,7,120,127,171,127,127
13299,2012-07-13,Fall,2012,Jul,7,0,Friday,1,Misty,0.7,0.6515,0.54,0.0,27,353,380,171,380,380
13300,2012-07-13,Fall,2012,Jul,8,0,Friday,1,Misty,0.7,0.6515,0.54,0.0,53,660,713,171,713,713
13301,2012-07-13,Fall,2012,Jul,9,0,Friday,1,Misty,0.72,0.6667,0.51,0.0,70,344,414,171,414,414
13302,2012-07-13,Fall,2012,Jul,10,0,Friday,1,Misty,0.74,0.6667,0.48,0.0,78,190,268,171,268,268
13303,2012-07-13,Fall,2012,Jul,11,0,Friday,1,Misty,0.76,0.6818,0.45,0.1343,68,220,288,171,288,288
13304,2012-07-13,Fall,2012,Jul,12,0,Friday,1,Misty,0.76,0.6818,0.4,0.1045,125,254,379,171,379,379
13305,2012-07-13,Fall,2012,Jul,13,0,Friday,1,Misty,0.8,0.7121,0.38,0.1343,100,274,374,171,374,374
13306,2012-07-13,Fall,2012,Jul,14,0,Friday,1,Misty,0.8,0.7121,0.38,0.0,120,249,369,171,369,369
13307,2012-07-13,Fall,2012,Jul,15,0,Friday,1,Misty,0.8,0.7121,0.36,0.1045,92,261,353,171,353,353
13308,2012-07-13,Fall,2012,Jul,16,0,Friday,1,Misty,0.8,0.7121,0.36,0.2239,111,381,492,171,492,492
13309,2012-07-13,Fall,2012,Jul,17,0,Friday,1,Misty,0.8,0.7121,0.36,0.1642,138,697,835,171,835,835
13310,2012-07-13,Fall,2012,Jul,18,0,Friday,1,Clear,0.78,0.697,0.46,0.194,108,523,631,171,631,631
13311,2012-07-13,Fall,2012,Jul,19,0,Friday,1,Clear,0.74,0.6667,0.51,0.1642,103,385,488,171,488,488
13312,2012-07-13,Fall,2012,Jul,20,0,Friday,1,Clear,0.74,0.6667,0.48,0.1343,95,294,389,171,389,389
13313,2012-07-13,Fall,2012,Jul,21,0,Friday,1,Clear,0.72,0.6667,0.54,0.0,76,223,299,171,299,299
13314,2012-07-13,Fall,2012,Jul,22,0,Friday,1,Clear,0.74,0.6667,0.45,0.0,59,204,263,171,263,263
13315,2012-07-13,Fall,2012,Jul,23,0,Friday,1,Misty,0.72,0.6515,0.45,0.1343,37,175,212,171,212,212
13316,2012-07-14,Fall,2012,Jul,0,0,Saturday,0,Misty,0.72,0.6667,0.48,0.0896,35,156,191,170,191,191
13317,2012-07-14,Fall,2012,Jul,1,0,Saturday,0,Misty,0.7,0.6515,0.51,0.1045,13,105,118,170,118,118
13318,2012-07-14,Fall,2012,Jul,2,0,Saturday,0,Misty,0.7,0.6515,0.54,0.1045,10,91,101,170,101,101
13319,2012-07-14,Fall,2012,Jul,3,0,Saturday,0,Misty,0.7,0.6515,0.54,0.1045,9,31,40,170,40,40
13320,2012-07-14,Fall,2012,Jul,4,0,Saturday,0,Light_rainsnow,0.66,0.6212,0.61,0.1045,3,6,9,170,9,9
13321,2012-07-14,Fall,2012,Jul,5,0,Saturday,0,Misty,0.64,0.6061,0.73,0.1045,0,5,5,170,5,5
13322,2012-07-14,Fall,2012,Jul,6,0,Saturday,0,Misty,0.64,0.5909,0.78,0.0896,6,29,35,170,35,35
13323,2012-07-14,Fall,2012,Jul,7,0,Saturday,0,Clear,0.64,0.5909,0.78,0.2836,7,41,48,170,48,48
13324,2012-07-14,Fall,2012,Jul,8,0,Saturday,0,Clear,0.62,0.5909,0.78,0.2836,33,118,151,170,151,151
13325,2012-07-14,Fall,2012,Jul,9,0,Saturday,0,Clear,0.66,0.6212,0.74,0.194,82,200,282,170,282,282
13326,2012-07-14,Fall,2012,Jul,10,0,Saturday,0,Misty,0.72,0.6818,0.7,0.0896,123,278,401,170,401,401
13327,2012-07-14,Fall,2012,Jul,11,0,Saturday,0,Misty,0.72,0.6818,0.7,0.1045,143,296,439,170,439,439
13328,2012-07-14,Fall,2012,Jul,12,0,Saturday,0,Misty,0.74,0.697,0.66,0.0896,181,318,499,170,499,499
13329,2012-07-14,Fall,2012,Jul,13,0,Saturday,0,Misty,0.76,0.7121,0.62,0.0896,219,372,591,170,591,591
13330,2012-07-14,Fall,2012,Jul,14,0,Saturday,0,Clear,0.8,0.7576,0.55,0.1045,269,363,632,170,632,632
13331,2012-07-14,Fall,2012,Jul,15,0,Saturday,0,Clear,0.8,0.7576,0.55,0.1642,243,317,560,170,560,560
13332,2012-07-14,Fall,2012,Jul,16,0,Saturday,0,Misty,0.72,0.697,0.79,0.3582,226,340,566,170,566,566
13333,2012-07-14,Fall,2012,Jul,17,0,Saturday,0,Light_rainsnow,0.7,0.6667,0.79,0.1642,199,259,458,170,458,458
13334,2012-07-14,Fall,2012,Jul,18,0,Saturday,0,Clear,0.72,0.697,0.79,0.1343,108,243,351,170,351,351
13335,2012-07-14,Fall,2012,Jul,19,0,Saturday,0,Clear,0.72,0.7121,0.84,0.0896,156,275,431,170,431,431
13336,2012-07-14,Fall,2012,Jul,20,0,Saturday,0,Clear,0.72,0.7121,0.84,0.0896,101,255,356,170,356,356
13337,2012-07-14,Fall,2012,Jul,21,0,Saturday,0,Clear,0.7,0.6667,0.84,0.2239,69,200,269,170,269,269
13338,2012-07-14,Fall,2012,Jul,22,0,Saturday,0,Clear,0.7,0.6667,0.79,0.194,65,160,225,170,225,225
13339,2012-07-14,Fall,2012,Jul,23,0,Saturday,0,Misty,0.68,0.6364,0.83,0.0896,55,156,211,170,211,211
13340,2012-07-15,Fall,2012,Jul,0,0,Sunday,0,Clear,0.68,0.6364,0.89,0.1642,40,147,187,169,187,187
13341,2012-07-15,Fall,2012,Jul,1,0,Sunday,0,Misty,0.68,0.6364,0.89,0.1343,49,119,168,169,168,168
13342,2012-07-15,Fall,2012,Jul,2,0,Sunday,0,Misty,0.68,0.6364,0.89,0.1642,29,86,115,169,115,115
13343,2012-07-15,Fall,2012,Jul,3,0,Sunday,0,Misty,0.68,0.6364,0.89,0.1642,15,42,57,169,57,57
13344,2012-07-15,Fall,2012,Jul,4,0,Sunday,0,Misty,0.68,0.6364,0.89,0.1045,8,11,19,169,19,19
13345,2012-07-15,Fall,2012,Jul,5,0,Sunday,0,Clear,0.68,0.6364,0.89,0.1343,2,7,9,169,9,9
13346,2012-07-15,Fall,2012,Jul,6,0,Sunday,0,Clear,0.68,0.6364,0.83,0.1343,6,9,15,169,15,15
13347,2012-07-15,Fall,2012,Jul,7,0,Sunday,0,Clear,0.7,0.6667,0.79,0.0896,17,30,47,169,47,47
13348,2012-07-15,Fall,2012,Jul,8,0,Sunday,0,Misty,0.7,0.6667,0.84,0.1343,37,96,133,169,133,133
13349,2012-07-15,Fall,2012,Jul,9,0,Sunday,0,Misty,0.72,0.697,0.79,0.0,58,163,221,169,221,221
13350,2012-07-15,Fall,2012,Jul,10,0,Sunday,0,Clear,0.76,0.7273,0.66,0.1343,141,241,382,169,382,382
13351,2012-07-15,Fall,2012,Jul,11,0,Sunday,0,Clear,0.82,0.7727,0.52,0.1642,170,281,451,169,451,451
13352,2012-07-15,Fall,2012,Jul,12,0,Sunday,0,Clear,0.84,0.7727,0.47,0.1045,153,336,489,169,489,489
13353,2012-07-15,Fall,2012,Jul,13,0,Sunday,0,Clear,0.86,0.7879,0.41,0.1045,171,309,480,169,480,480
13354,2012-07-15,Fall,2012,Jul,14,0,Sunday,0,Clear,0.9,0.8182,0.37,0.2537,162,314,476,169,476,476
13355,2012-07-15,Fall,2012,Jul,15,0,Sunday,0,Clear,0.86,0.803,0.47,0.1343,182,307,489,169,489,489
13356,2012-07-15,Fall,2012,Jul,16,0,Sunday,0,Clear,0.86,0.7879,0.41,0.2239,152,343,495,169,495,495
13357,2012-07-15,Fall,2012,Jul,17,0,Sunday,0,Clear,0.8,0.7727,0.59,0.4925,122,314,436,169,436,436
13358,2012-07-15,Fall,2012,Jul,18,0,Sunday,0,Light_rainsnow,0.72,0.697,0.79,0.3582,84,228,312,169,312,312
13359,2012-07-15,Fall,2012,Jul,19,0,Sunday,0,Clear,0.72,0.7121,0.84,0.2239,109,203,312,169,312,312
13360,2012-07-15,Fall,2012,Jul,20,0,Sunday,0,Clear,0.72,0.697,0.79,0.2537,95,199,294,169,294,294
13361,2012-07-15,Fall,2012,Jul,21,0,Sunday,0,Clear,0.72,0.697,0.79,0.0896,59,164,223,169,223,223
13362,2012-07-15,Fall,2012,Jul,22,0,Sunday,0,Clear,0.72,0.697,0.74,0.1045,34,96,130,169,130,130
13363,2012-07-15,Fall,2012,Jul,23,0,Sunday,0,Clear,0.72,0.697,0.79,0.1343,25,66,91,169,91,91
13364,2012-07-16,Fall,2012,Jul,0,0,Monday,1,Light_rainsnow,0.72,0.697,0.79,0.1045,11,32,43,168,43,43
13365,2012-07-16,Fall,2012,Jul,1,0,Monday,1,Misty,0.7,0.6667,0.74,0.194,1,10,11,168,11,11
13366,2012-07-16,Fall,2012,Jul,2,0,Monday,1,Clear,0.7,0.6667,0.74,0.1045,4,11,15,168,15,15
13367,2012-07-16,Fall,2012,Jul,3,0,Monday,1,Clear,0.68,0.6364,0.79,0.0896,2,4,6,168,6,6
13368,2012-07-16,Fall,2012,Jul,4,0,Monday,1,Clear,0.68,0.6364,0.79,0.1045,1,11,12,168,12,12
13369,2012-07-16,Fall,2012,Jul,5,0,Monday,1,Clear,0.66,0.6061,0.78,0.1045,10,40,50,168,50,50
13370,2012-07-16,Fall,2012,Jul,6,0,Monday,1,Clear,0.68,0.6364,0.79,0.1343,8,132,140,168,140,140
13371,2012-07-16,Fall,2012,Jul,7,0,Monday,1,Clear,0.72,0.6818,0.7,0.0896,24,459,483,168,483,483
13372,2012-07-16,Fall,2012,Jul,8,0,Monday,1,Clear,0.74,0.697,0.66,0.1045,48,619,667,168,667,667
13373,2012-07-16,Fall,2012,Jul,9,0,Monday,1,Clear,0.76,0.7121,0.62,0.1642,51,297,348,168,348,348
13374,2012-07-16,Fall,2012,Jul,10,0,Monday,1,Clear,0.8,0.7727,0.59,0.0,69,117,186,168,186,186
13375,2012-07-16,Fall,2012,Jul,11,0,Monday,1,Clear,0.84,0.803,0.53,0.2239,57,125,182,168,182,182
13376,2012-07-16,Fall,2012,Jul,12,0,Monday,1,Clear,0.84,0.7879,0.49,0.1343,79,158,237,168,237,237
13377,2012-07-16,Fall,2012,Jul,13,0,Monday,1,Clear,0.84,0.7879,0.49,0.2836,63,176,239,168,239,239
13378,2012-07-16,Fall,2012,Jul,14,0,Monday,1,Clear,0.88,0.8182,0.42,0.1045,53,159,212,168,212,212
13379,2012-07-16,Fall,2012,Jul,15,0,Monday,1,Clear,0.86,0.803,0.47,0.2537,61,176,237,168,237,237
13380,2012-07-16,Fall,2012,Jul,16,0,Monday,1,Light_rainsnow,0.76,0.7273,0.66,0.5821,77,309,386,168,386,386
13381,2012-07-16,Fall,2012,Jul,17,0,Monday,1,Light_rainsnow,0.76,0.7273,0.66,0.5821,86,669,755,168,755,755
13382,2012-07-16,Fall,2012,Jul,18,0,Monday,1,Clear,0.84,0.803,0.53,0.0,97,697,794,168,794,794
13383,2012-07-16,Fall,2012,Jul,19,0,Monday,1,Clear,0.8,0.7879,0.63,0.1343,92,503,595,168,595,595
13384,2012-07-16,Fall,2012,Jul,20,0,Monday,1,Clear,0.8,0.7727,0.59,0.1343,66,388,454,168,454,454
13385,2012-07-16,Fall,2012,Jul,21,0,Monday,1,Clear,0.76,0.7273,0.66,0.1343,45,283,328,168,328,328
13386,2012-07-16,Fall,2012,Jul,22,0,Monday,1,Clear,0.76,0.7121,0.62,0.0896,56,228,284,168,284,284
13387,2012-07-16,Fall,2012,Jul,23,0,Monday,1,Clear,0.74,0.7121,0.74,0.0896,27,139,166,168,166,166
13388,2012-07-17,Fall,2012,Jul,0,0,Tuesday,1,Clear,0.72,0.7121,0.84,0.1045,10,43,53,167,53,53
13389,2012-07-17,Fall,2012,Jul,1,0,Tuesday,1,Clear,0.74,0.697,0.7,0.0,4,21,25,167,25,25
13390,2012-07-17,Fall,2012,Jul,2,0,Tuesday,1,Clear,0.72,0.6818,0.7,0.0896,1,6,7,167,7,7
13391,2012-07-17,Fall,2012,Jul,3,0,Tuesday,1,Clear,0.72,0.6818,0.66,0.0,0,3,3,167,3,3
13392,2012-07-17,Fall,2012,Jul,4,0,Tuesday,1,Clear,0.72,0.6818,0.62,0.0,0,7,7,167,7,7
13393,2012-07-17,Fall,2012,Jul,5,0,Tuesday,1,Clear,0.68,0.6364,0.74,0.0896,7,31,38,167,38,38
13394,2012-07-17,Fall,2012,Jul,6,0,Tuesday,1,Clear,0.72,0.6818,0.66,0.1045,16,197,213,167,213,213
13395,2012-07-17,Fall,2012,Jul,7,0,Tuesday,1,Misty,0.74,0.697,0.7,0.0,26,500,526,167,526,526
13396,2012-07-17,Fall,2012,Jul,8,0,Tuesday,1,Misty,0.8,0.7576,0.55,0.0,43,618,661,167,661,661
13397,2012-07-17,Fall,2012,Jul,9,0,Tuesday,1,Misty,0.82,0.7727,0.49,0.2239,32,288,320,167,320,320
13398,2012-07-17,Fall,2012,Jul,10,0,Tuesday,1,Misty,0.84,0.7879,0.49,0.194,37,122,159,167,159,159
13399,2012-07-17,Fall,2012,Jul,11,0,Tuesday,1,Misty,0.86,0.803,0.47,0.0,60,146,206,167,206,206
13400,2012-07-17,Fall,2012,Jul,12,0,Tuesday,1,Misty,0.9,0.8182,0.35,0.0,80,174,254,167,254,254
13401,2012-07-17,Fall,2012,Jul,13,0,Tuesday,1,Clear,0.92,0.8182,0.31,0.194,53,168,221,167,221,221
13402,2012-07-17,Fall,2012,Jul,14,0,Tuesday,1,Clear,0.94,0.8333,0.29,0.2537,54,160,214,167,214,214
13403,2012-07-17,Fall,2012,Jul,15,0,Tuesday,1,Clear,0.92,0.8182,0.31,0.1642,57,187,244,167,244,244
13404,2012-07-17,Fall,2012,Jul,16,0,Tuesday,1,Clear,0.92,0.8182,0.29,0.1642,64,317,381,167,381,381
13405,2012-07-17,Fall,2012,Jul,17,0,Tuesday,1,Clear,0.92,0.8182,0.29,0.0,95,675,770,167,770,770
13406,2012-07-17,Fall,2012,Jul,18,0,Tuesday,1,Clear,0.9,0.803,0.33,0.194,60,712,772,167,772,772
13407,2012-07-17,Fall,2012,Jul,19,0,Tuesday,1,Clear,0.88,0.7879,0.35,0.2537,69,478,547,167,547,547
13408,2012-07-17,Fall,2012,Jul,20,0,Tuesday,1,Clear,0.86,0.7576,0.34,0.1642,52,375,427,167,427,427
13409,2012-07-17,Fall,2012,Jul,21,0,Tuesday,1,Clear,0.82,0.7727,0.52,0.1343,50,283,333,167,333,333
13410,2012-07-17,Fall,2012,Jul,22,0,Tuesday,1,Clear,0.8,0.7576,0.55,0.2239,29,215,244,167,244,244
13411,2012-07-17,Fall,2012,Jul,23,0,Tuesday,1,Clear,0.78,0.7424,0.59,0.194,22,139,161,167,161,161
13412,2012-07-18,Fall,2012,Jul,0,0,Wednesday,1,Clear,0.76,0.7273,0.66,0.1642,8,45,53,166,53,53
13413,2012-07-18,Fall,2012,Jul,1,0,Wednesday,1,Clear,0.76,0.7273,0.66,0.1045,2,14,16,166,16,16
13414,2012-07-18,Fall,2012,Jul,2,0,Wednesday,1,Clear,0.74,0.697,0.66,0.1343,3,5,8,166,8,8
13415,2012-07-18,Fall,2012,Jul,3,0,Wednesday,1,Clear,0.74,0.697,0.66,0.1343,2,2,4,166,4,4
13416,2012-07-18,Fall,2012,Jul,4,0,Wednesday,1,Clear,0.72,0.6818,0.7,0.1343,0,6,6,166,6,6
13417,2012-07-18,Fall,2012,Jul,5,0,Wednesday,1,Clear,0.72,0.6818,0.7,0.1642,5,41,46,166,46,46
13418,2012-07-18,Fall,2012,Jul,6,0,Wednesday,1,Clear,0.72,0.6818,0.7,0.1642,10,152,162,166,162,162
13419,2012-07-18,Fall,2012,Jul,7,0,Wednesday,1,Clear,0.74,0.697,0.66,0.1642,23,472,495,166,495,495
13420,2012-07-18,Fall,2012,Jul,8,0,Wednesday,1,Clear,0.78,0.7424,0.62,0.1045,55,624,679,166,679,679
13421,2012-07-18,Fall,2012,Jul,9,0,Wednesday,1,Clear,0.82,0.7879,0.56,0.0,44,253,297,166,297,297
13422,2012-07-18,Fall,2012,Jul,10,0,Wednesday,1,Clear,0.9,0.8485,0.42,0.194,39,99,138,166,138,138
13423,2012-07-18,Fall,2012,Jul,11,0,Wednesday,1,Clear,0.9,0.8485,0.42,0.0,47,136,183,166,183,183
13424,2012-07-18,Fall,2012,Jul,12,0,Wednesday,1,Clear,0.92,0.8636,0.37,0.1343,36,166,202,166,202,202
13425,2012-07-18,Fall,2012,Jul,13,0,Wednesday,1,Clear,0.94,0.8485,0.33,0.0,49,154,203,166,203,203
13426,2012-07-18,Fall,2012,Jul,14,0,Wednesday,1,Clear,0.94,0.8788,0.38,0.3284,54,116,170,166,170,170
13427,2012-07-18,Fall,2012,Jul,15,0,Wednesday,1,Light_rainsnow,0.92,0.8485,0.35,0.3582,42,152,194,166,194,194
13428,2012-07-18,Fall,2012,Jul,16,0,Wednesday,1,Clear,0.74,0.697,0.66,0.2537,34,190,224,166,224,224
13429,2012-07-18,Fall,2012,Jul,17,0,Wednesday,1,Clear,0.74,0.697,0.7,0.2537,35,335,370,166,370,370
13430,2012-07-18,Fall,2012,Jul,18,0,Wednesday,1,Misty,0.76,0.7121,0.62,0.1343,63,580,643,166,643,643
13431,2012-07-18,Fall,2012,Jul,19,0,Wednesday,1,Misty,0.76,0.7121,0.62,0.1045,78,438,516,166,516,516
13432,2012-07-18,Fall,2012,Jul,20,0,Wednesday,1,Clear,0.74,0.6818,0.62,0.0896,56,310,366,166,366,366
13433,2012-07-18,Fall,2012,Jul,21,0,Wednesday,1,Clear,0.76,0.7121,0.62,0.0,53,266,319,166,319,319
13434,2012-07-18,Fall,2012,Jul,22,0,Wednesday,1,Clear,0.76,0.7121,0.58,0.0896,42,246,288,166,288,288
13435,2012-07-18,Fall,2012,Jul,23,0,Wednesday,1,Clear,0.76,0.7121,0.58,0.0896,19,112,131,166,131,131
13436,2012-07-19,Fall,2012,Jul,0,0,Thursday,1,Clear,0.74,0.697,0.66,0.0896,16,50,66,165,66,66
13437,2012-07-19,Fall,2012,Jul,1,0,Thursday,1,Clear,0.74,0.697,0.66,0.0896,6,19,25,165,25,25
13438,2012-07-19,Fall,2012,Jul,2,0,Thursday,1,Clear,0.72,0.6818,0.7,0.194,0,7,7,165,7,7
13439,2012-07-19,Fall,2012,Jul,3,0,Thursday,1,Clear,0.72,0.6818,0.7,0.1045,1,4,5,165,5,5
13440,2012-07-19,Fall,2012,Jul,4,0,Thursday,1,Clear,0.72,0.6818,0.7,0.1045,0,8,8,165,8,8
13441,2012-07-19,Fall,2012,Jul,5,0,Thursday,1,Misty,0.72,0.6818,0.7,0.1045,5,35,40,165,40,40
13442,2012-07-19,Fall,2012,Jul,6,0,Thursday,1,Clear,0.72,0.6818,0.66,0.1343,8,144,152,165,152,152
13443,2012-07-19,Fall,2012,Jul,7,0,Thursday,1,Clear,0.74,0.6818,0.58,0.2836,23,450,473,165,473,473
13444,2012-07-19,Fall,2012,Jul,8,0,Thursday,1,Clear,0.76,0.7121,0.58,0.2537,32,625,657,165,657,657
13445,2012-07-19,Fall,2012,Jul,9,0,Thursday,1,Misty,0.76,0.7121,0.58,0.2836,36,282,318,165,318,318
13446,2012-07-19,Fall,2012,Jul,10,0,Thursday,1,Clear,0.76,0.7121,0.58,0.194,41,157,198,165,198,198
13447,2012-07-19,Fall,2012,Jul,11,0,Thursday,1,Clear,0.8,0.7576,0.55,0.1045,54,162,216,165,216,216
13448,2012-07-19,Fall,2012,Jul,12,0,Thursday,1,Clear,0.84,0.7879,0.49,0.2836,59,215,274,165,274,274
13449,2012-07-19,Fall,2012,Jul,13,0,Thursday,1,Clear,0.84,0.7727,0.47,0.1343,74,180,254,165,254,254
13450,2012-07-19,Fall,2012,Jul,14,0,Thursday,1,Clear,0.86,0.7879,0.44,0.0896,46,151,197,165,197,197
13451,2012-07-19,Fall,2012,Jul,15,0,Thursday,1,Clear,0.84,0.7727,0.47,0.0896,66,226,292,165,292,292
13452,2012-07-19,Fall,2012,Jul,16,0,Thursday,1,Clear,0.84,0.7727,0.47,0.0896,70,288,358,165,358,358
13453,2012-07-19,Fall,2012,Jul,17,0,Thursday,1,Clear,0.86,0.7879,0.41,0.0,93,678,771,165,771,771
13454,2012-07-19,Fall,2012,Jul,18,0,Thursday,1,Clear,0.86,0.7879,0.41,0.194,93,684,777,165,777,777
13455,2012-07-19,Fall,2012,Jul,19,0,Thursday,1,Clear,0.84,0.7576,0.44,0.2537,53,480,533,165,533,533
13456,2012-07-19,Fall,2012,Jul,20,0,Thursday,1,Clear,0.82,0.7727,0.49,0.1642,65,440,505,165,505,505
13457,2012-07-19,Fall,2012,Jul,21,0,Thursday,1,Light_rainsnow,0.66,0.5909,0.89,0.2537,38,294,332,165,332,332
13458,2012-07-19,Fall,2012,Jul,22,0,Thursday,1,Light_rainsnow,0.66,0.5909,0.89,0.2537,6,62,68,165,68,68
13459,2012-07-19,Fall,2012,Jul,23,0,Thursday,1,Light_rainsnow,0.66,0.5909,0.89,0.2239,3,62,65,165,65,65
13460,2012-07-20,Fall,2012,Jul,0,0,Friday,1,Light_rainsnow,0.66,0.5909,0.89,0.0896,2,32,34,164,34,34
13461,2012-07-20,Fall,2012,Jul,1,0,Friday,1,Clear,0.66,0.5909,0.89,0.1343,2,9,11,164,11,11
13462,2012-07-20,Fall,2012,Jul,2,0,Friday,1,Misty,0.66,0.5909,0.89,0.0896,5,14,19,164,19,19
13463,2012-07-20,Fall,2012,Jul,3,0,Friday,1,Misty,0.66,0.5909,0.89,0.1045,7,29,36,164,36,36
13464,2012-07-20,Fall,2012,Jul,4,0,Friday,1,Misty,0.66,0.5909,0.89,0.1642,3,6,9,164,9,9
13465,2012-07-20,Fall,2012,Jul,5,0,Friday,1,Misty,0.66,0.5909,0.89,0.1343,2,40,42,164,42,42
13466,2012-07-20,Fall,2012,Jul,6,0,Friday,1,Misty,0.66,0.5909,0.89,0.1642,3,123,126,164,126,126
13467,2012-07-20,Fall,2012,Jul,7,0,Friday,1,Misty,0.66,0.5909,0.89,0.194,14,346,360,164,360,360
13468,2012-07-20,Fall,2012,Jul,8,0,Friday,1,Misty,0.68,0.6364,0.83,0.1642,39,652,691,164,691,691
13469,2012-07-20,Fall,2012,Jul,9,0,Friday,1,Misty,0.7,0.6667,0.79,0.1343,45,328,373,164,373,373
13470,2012-07-20,Fall,2012,Jul,10,0,Friday,1,Misty,0.7,0.6667,0.79,0.1642,51,182,233,164,233,233
13471,2012-07-20,Fall,2012,Jul,11,0,Friday,1,Light_rainsnow,0.72,0.697,0.74,0.194,51,161,212,164,212,212
13472,2012-07-20,Fall,2012,Jul,12,0,Friday,1,Light_rainsnow,0.68,0.6364,0.83,0.1642,41,233,274,164,274,274
13473,2012-07-20,Fall,2012,Jul,13,0,Friday,1,Light_rainsnow,0.68,0.6364,0.83,0.1045,20,136,156,164,156,156
13474,2012-07-20,Fall,2012,Jul,14,0,Friday,1,Light_rainsnow,0.7,0.6667,0.84,0.1642,53,176,229,164,229,229
13475,2012-07-20,Fall,2012,Jul,15,0,Friday,1,Misty,0.7,0.6667,0.84,0.2985,47,169,216,164,216,216
13476,2012-07-20,Fall,2012,Jul,16,0,Friday,1,Misty,0.68,0.6364,0.83,0.3284,70,366,436,164,436,436
13477,2012-07-20,Fall,2012,Jul,17,0,Friday,1,Misty,0.66,0.5909,0.89,0.4179,95,620,715,164,715,715
13478,2012-07-20,Fall,2012,Jul,18,0,Friday,1,Misty,0.66,0.6061,0.78,0.3284,73,549,622,164,622,622
13479,2012-07-20,Fall,2012,Jul,19,0,Friday,1,Misty,0.64,0.5758,0.83,0.2836,44,358,402,164,402,402
13480,2012-07-20,Fall,2012,Jul,20,0,Friday,1,Light_rainsnow,0.64,0.5758,0.83,0.3881,35,216,251,164,251,251
13481,2012-07-20,Fall,2012,Jul,21,0,Friday,1,Light_rainsnow,0.62,0.5758,0.83,0.3284,14,108,122,164,122,122
13482,2012-07-20,Fall,2012,Jul,22,0,Friday,1,Misty,0.62,0.5758,0.83,0.194,13,122,135,164,135,135
13483,2012-07-20,Fall,2012,Jul,23,0,Friday,1,Misty,0.62,0.5758,0.83,0.2836,18,148,166,164,166,166
13484,2012-07-21,Fall,2012,Jul,0,0,Saturday,0,Light_rainsnow,0.62,0.5758,0.83,0.2836,11,92,103,163,103,103
13485,2012-07-21,Fall,2012,Jul,1,0,Saturday,0,Misty,0.62,0.5758,0.83,0.2537,10,62,72,163,72,72
13486,2012-07-21,Fall,2012,Jul,2,0,Saturday,0,Light_rainsnow,0.6,0.5455,0.88,0.2836,5,55,60,163,60,60
13487,2012-07-21,Fall,2012,Jul,3,0,Saturday,0,Light_rainsnow,0.6,0.5455,0.88,0.2537,7,18,25,163,25,25
13488,2012-07-21,Fall,2012,Jul,4,0,Saturday,0,Light_rainsnow,0.58,0.5455,0.88,0.2836,11,5,16,163,16,16
13489,2012-07-21,Fall,2012,Jul,5,0,Saturday,0,Light_rainsnow,0.58,0.5455,0.88,0.2537,7,10,17,163,17,17
13490,2012-07-21,Fall,2012,Jul,6,0,Saturday,0,Light_rainsnow,0.58,0.5455,0.88,0.2537,3,12,15,163,15,15
13491,2012-07-21,Fall,2012,Jul,7,0,Saturday,0,Misty,0.58,0.5455,0.88,0.2537,8,29,37,163,37,37
13492,2012-07-21,Fall,2012,Jul,8,0,Saturday,0,Misty,0.58,0.5455,0.83,0.2537,18,94,112,163,112,112
13493,2012-07-21,Fall,2012,Jul,9,0,Saturday,0,Misty,0.58,0.5455,0.83,0.194,32,175,207,163,207,207
13494,2012-07-21,Fall,2012,Jul,10,0,Saturday,0,Light_rainsnow,0.58,0.5455,0.88,0.2537,49,219,268,163,268,268
13495,2012-07-21,Fall,2012,Jul,11,0,Saturday,0,Misty,0.6,0.5606,0.83,0.2537,80,225,305,163,305,305
13496,2012-07-21,Fall,2012,Jul,12,0,Saturday,0,Light_rainsnow,0.6,0.5606,0.83,0.2239,156,301,457,163,457,457
13497,2012-07-21,Fall,2012,Jul,13,0,Saturday,0,Light_rainsnow,0.6,0.5606,0.83,0.1642,106,248,354,163,354,354
13498,2012-07-21,Fall,2012,Jul,14,0,Saturday,0,Misty,0.6,0.5455,0.88,0.2537,121,222,343,163,343,343
13499,2012-07-21,Fall,2012,Jul,15,0,Saturday,0,Light_rainsnow,0.6,0.5455,0.88,0.2537,148,232,380,163,380,380
13500,2012-07-21,Fall,2012,Jul,16,0,Saturday,0,Light_rainsnow,0.6,0.5455,0.88,0.194,130,196,326,163,326,326
13501,2012-07-21,Fall,2012,Jul,17,0,Saturday,0,Light_rainsnow,0.6,0.5455,0.88,0.1642,92,149,241,163,241,241
13502,2012-07-21,Fall,2012,Jul,18,0,Saturday,0,Misty,0.6,0.5455,0.88,0.194,51,126,177,163,177,177
13503,2012-07-21,Fall,2012,Jul,19,0,Saturday,0,Misty,0.6,0.5455,0.88,0.1642,67,171,238,163,238,238
13504,2012-07-21,Fall,2012,Jul,20,0,Saturday,0,Light_rainsnow,0.6,0.5455,0.88,0.1642,51,163,214,163,214,214
13505,2012-07-21,Fall,2012,Jul,21,0,Saturday,0,Misty,0.6,0.5455,0.88,0.1642,29,134,163,163,163,163
13506,2012-07-21,Fall,2012,Jul,22,0,Saturday,0,Misty,0.6,0.5455,0.88,0.1045,40,140,180,163,180,180
13507,2012-07-21,Fall,2012,Jul,23,0,Saturday,0,Misty,0.6,0.5455,0.88,0.0,32,117,149,163,149,149
13508,2012-07-22,Fall,2012,Jul,0,0,Sunday,0,Misty,0.6,0.5455,0.88,0.1045,17,96,113,162,113,113
13509,2012-07-22,Fall,2012,Jul,1,0,Sunday,0,Misty,0.6,0.5455,0.88,0.1642,31,99,130,162,130,130
13510,2012-07-22,Fall,2012,Jul,2,0,Sunday,0,Misty,0.6,0.5455,0.88,0.1045,32,90,122,162,122,122
13511,2012-07-22,Fall,2012,Jul,3,0,Sunday,0,Misty,0.6,0.5455,0.88,0.1045,13,30,43,162,43,43
13512,2012-07-22,Fall,2012,Jul,4,0,Sunday,0,Clear,0.6,0.5455,0.88,0.0,6,10,16,162,16,16
13513,2012-07-22,Fall,2012,Jul,5,0,Sunday,0,Clear,0.6,0.5455,0.88,0.0,0,6,6,162,6,6
13514,2012-07-22,Fall,2012,Jul,6,0,Sunday,0,Misty,0.62,0.5758,0.83,0.0896,5,14,19,162,19,19
13515,2012-07-22,Fall,2012,Jul,7,0,Sunday,0,Misty,0.62,0.5758,0.83,0.0,13,25,38,162,38,38
13516,2012-07-22,Fall,2012,Jul,8,0,Sunday,0,Misty,0.64,0.5909,0.78,0.0,31,122,153,162,153,153
13517,2012-07-22,Fall,2012,Jul,9,0,Sunday,0,Misty,0.66,0.6212,0.69,0.0,79,179,258,162,258,258
13518,2012-07-22,Fall,2012,Jul,10,0,Sunday,0,Misty,0.66,0.6212,0.74,0.0,114,265,379,162,379,379
13519,2012-07-22,Fall,2012,Jul,11,0,Sunday,0,Misty,0.66,0.6212,0.74,0.0,191,314,505,162,505,505
13520,2012-07-22,Fall,2012,Jul,12,0,Sunday,0,Misty,0.7,0.6515,0.7,0.1045,178,326,504,162,504,504
13521,2012-07-22,Fall,2012,Jul,13,0,Sunday,0,Misty,0.7,0.6515,0.65,0.0896,238,388,626,162,626,626
13522,2012-07-22,Fall,2012,Jul,14,0,Sunday,0,Clear,0.72,0.6818,0.66,0.1045,256,360,616,162,616,616
13523,2012-07-22,Fall,2012,Jul,15,0,Sunday,0,Clear,0.72,0.6818,0.66,0.1045,254,370,624,162,624,624
13524,2012-07-22,Fall,2012,Jul,16,0,Sunday,0,Clear,0.74,0.697,0.66,0.1045,245,383,628,162,628,628
13525,2012-07-22,Fall,2012,Jul,17,0,Sunday,0,Clear,0.74,0.697,0.66,0.2239,188,368,556,162,556,556
13526,2012-07-22,Fall,2012,Jul,18,0,Sunday,0,Clear,0.74,0.697,0.66,0.1642,173,342,515,162,515,515
13527,2012-07-22,Fall,2012,Jul,19,0,Sunday,0,Clear,0.72,0.6818,0.7,0.1642,180,342,522,162,522,522
13528,2012-07-22,Fall,2012,Jul,20,0,Sunday,0,Clear,0.7,0.6667,0.74,0.1642,124,254,378,162,378,378
13529,2012-07-22,Fall,2012,Jul,21,0,Sunday,0,Clear,0.7,0.6667,0.79,0.1045,88,257,345,162,345,345
13530,2012-07-22,Fall,2012,Jul,22,0,Sunday,0,Clear,0.7,0.6667,0.74,0.194,55,136,191,162,191,191
13531,2012-07-22,Fall,2012,Jul,23,0,Sunday,0,Clear,0.68,0.6364,0.79,0.1642,33,90,123,162,123,123
13532,2012-07-23,Fall,2012,Jul,0,0,Monday,1,Clear,0.66,0.5909,0.89,0.0896,11,36,47,161,47,47
13533,2012-07-23,Fall,2012,Jul,1,0,Monday,1,Clear,0.66,0.5909,0.89,0.194,7,20,27,161,27,27
13534,2012-07-23,Fall,2012,Jul,2,0,Monday,1,Misty,0.66,0.5909,0.94,0.0896,3,14,17,161,17,17
13535,2012-07-23,Fall,2012,Jul,3,0,Monday,1,Misty,0.66,0.5909,0.94,0.0896,0,2,2,161,2,2
13536,2012-07-23,Fall,2012,Jul,4,0,Monday,1,Misty,0.66,0.5909,0.94,0.1343,0,8,8,161,8,8
13537,2012-07-23,Fall,2012,Jul,5,0,Monday,1,Misty,0.66,0.5909,0.94,0.1343,3,48,51,161,51,51
13538,2012-07-23,Fall,2012,Jul,6,0,Monday,1,Misty,0.68,0.6364,0.89,0.0896,9,148,157,161,157,157
13539,2012-07-23,Fall,2012,Jul,7,0,Monday,1,Clear,0.7,0.6667,0.84,0.1343,17,404,421,161,421,421
13540,2012-07-23,Fall,2012,Jul,8,0,Monday,1,Clear,0.72,0.697,0.79,0.1045,47,691,738,161,738,738
13541,2012-07-23,Fall,2012,Jul,9,0,Monday,1,Misty,0.74,0.7121,0.74,0.1343,57,288,345,161,345,345
13542,2012-07-23,Fall,2012,Jul,10,0,Monday,1,Misty,0.78,0.7424,0.62,0.0,63,137,200,161,200,200
13543,2012-07-23,Fall,2012,Jul,11,0,Monday,1,Misty,0.8,0.7424,0.52,0.1642,69,129,198,161,198,198
13544,2012-07-23,Fall,2012,Jul,12,0,Monday,1,Misty,0.8,0.7424,0.52,0.1642,109,205,314,161,314,314
13545,2012-07-23,Fall,2012,Jul,13,0,Monday,1,Misty,0.8,0.7424,0.52,0.1045,64,176,240,161,240,240
13546,2012-07-23,Fall,2012,Jul,14,0,Monday,1,Misty,0.78,0.7424,0.59,0.1642,82,189,271,161,271,271
13547,2012-07-23,Fall,2012,Jul,15,0,Monday,1,Clear,0.8,0.7576,0.55,0.194,76,205,281,161,281,281
13548,2012-07-23,Fall,2012,Jul,16,0,Monday,1,Clear,0.82,0.7727,0.52,0.1343,111,346,457,161,457,457
13549,2012-07-23,Fall,2012,Jul,17,0,Monday,1,Clear,0.82,0.7727,0.52,0.1343,87,760,847,161,847,847
13550,2012-07-23,Fall,2012,Jul,18,0,Monday,1,Clear,0.82,0.7576,0.46,0.1045,69,672,741,161,741,741
13551,2012-07-23,Fall,2012,Jul,19,0,Monday,1,Clear,0.8,0.7424,0.52,0.2537,94,488,582,161,582,582
13552,2012-07-23,Fall,2012,Jul,20,0,Monday,1,Clear,0.76,0.7121,0.62,0.1642,56,347,403,161,403,403
13553,2012-07-23,Fall,2012,Jul,21,0,Monday,1,Clear,0.76,0.7121,0.62,0.194,45,251,296,161,296,296
13554,2012-07-23,Fall,2012,Jul,22,0,Monday,1,Clear,0.74,0.6818,0.62,0.194,40,169,209,161,209,209
13555,2012-07-23,Fall,2012,Jul,23,0,Monday,1,Clear,0.72,0.6818,0.66,0.1642,16,98,114,161,114,114
13556,2012-07-24,Fall,2012,Jul,0,0,Tuesday,1,Clear,0.7,0.6667,0.74,0.1343,12,52,64,160,64,64
13557,2012-07-24,Fall,2012,Jul,1,0,Tuesday,1,Clear,0.68,0.6364,0.79,0.1642,7,10,17,160,17,17
13558,2012-07-24,Fall,2012,Jul,2,0,Tuesday,1,Clear,0.66,0.6061,0.83,0.1642,6,10,16,160,16,16
13559,2012-07-24,Fall,2012,Jul,3,0,Tuesday,1,Clear,0.66,0.6061,0.83,0.1642,1,5,6,160,6,6
13560,2012-07-24,Fall,2012,Jul,4,0,Tuesday,1,Clear,0.66,0.6061,0.83,0.0896,0,6,6,160,6,6
13561,2012-07-24,Fall,2012,Jul,5,0,Tuesday,1,Clear,0.66,0.6061,0.83,0.1045,5,45,50,160,50,50
13562,2012-07-24,Fall,2012,Jul,6,0,Tuesday,1,Clear,0.66,0.6061,0.83,0.1343,17,173,190,160,190,190
13563,2012-07-24,Fall,2012,Jul,7,0,Tuesday,1,Clear,0.7,0.6667,0.74,0.1642,24,492,516,160,516,516
13564,2012-07-24,Fall,2012,Jul,8,0,Tuesday,1,Clear,0.74,0.697,0.7,0.194,49,694,743,160,743,743
13565,2012-07-24,Fall,2012,Jul,9,0,Tuesday,1,Clear,0.84,0.803,0.53,0.0,40,299,339,160,339,339
13566,2012-07-24,Fall,2012,Jul,10,0,Tuesday,1,Clear,0.82,0.7879,0.56,0.2985,62,156,218,160,218,218
13567,2012-07-24,Fall,2012,Jul,11,0,Tuesday,1,Misty,0.84,0.803,0.53,0.3284,45,156,201,160,201,201
13568,2012-07-24,Fall,2012,Jul,12,0,Tuesday,1,Misty,0.82,0.7879,0.56,0.2239,60,169,229,160,229,229
13569,2012-07-24,Fall,2012,Jul,13,0,Tuesday,1,Misty,0.84,0.803,0.53,0.2985,73,200,273,160,273,273
13570,2012-07-24,Fall,2012,Jul,14,0,Tuesday,1,Misty,0.84,0.803,0.53,0.2239,48,196,244,160,244,244
13571,2012-07-24,Fall,2012,Jul,15,0,Tuesday,1,Clear,0.82,0.7727,0.49,0.2985,73,212,285,160,285,285
13572,2012-07-24,Fall,2012,Jul,16,0,Tuesday,1,Clear,0.8,0.7576,0.55,0.2985,86,369,455,160,455,455
13573,2012-07-24,Fall,2012,Jul,17,0,Tuesday,1,Clear,0.8,0.7424,0.52,0.3284,94,775,869,160,869,869
13574,2012-07-24,Fall,2012,Jul,18,0,Tuesday,1,Clear,0.76,0.7121,0.62,0.3284,110,767,877,160,877,877
13575,2012-07-24,Fall,2012,Jul,19,0,Tuesday,1,Clear,0.76,0.7121,0.62,0.1642,109,523,632,160,632,632
13576,2012-07-24,Fall,2012,Jul,20,0,Tuesday,1,Clear,0.74,0.697,0.66,0.1642,85,438,523,160,523,523
13577,2012-07-24,Fall,2012,Jul,21,0,Tuesday,1,Clear,0.74,0.697,0.66,0.2239,53,325,378,160,378,378
13578,2012-07-24,Fall,2012,Jul,22,0,Tuesday,1,Clear,0.74,0.697,0.66,0.2537,43,226,269,160,269,269
13579,2012-07-24,Fall,2012,Jul,23,0,Tuesday,1,Clear,0.74,0.6818,0.58,0.3284,38,154,192,160,192,192
13580,2012-07-25,Fall,2012,Jul,0,0,Wednesday,1,Clear,0.72,0.6667,0.58,0.2985,9,57,66,159,66,66
13581,2012-07-25,Fall,2012,Jul,1,0,Wednesday,1,Clear,0.7,0.6515,0.58,0.194,2,26,28,159,28,28
13582,2012-07-25,Fall,2012,Jul,2,0,Wednesday,1,Clear,0.68,0.6364,0.61,0.2239,1,11,12,159,12,12
13583,2012-07-25,Fall,2012,Jul,3,0,Wednesday,1,Clear,0.66,0.6212,0.65,0.2239,1,11,12,159,12,12
13584,2012-07-25,Fall,2012,Jul,4,0,Wednesday,1,Clear,0.64,0.6061,0.65,0.2239,0,4,4,159,4,4
13585,2012-07-25,Fall,2012,Jul,5,0,Wednesday,1,Clear,0.64,0.6061,0.65,0.1642,5,54,59,159,59,59
13586,2012-07-25,Fall,2012,Jul,6,0,Wednesday,1,Clear,0.64,0.6061,0.65,0.194,11,179,190,159,190,190
13587,2012-07-25,Fall,2012,Jul,7,0,Wednesday,1,Clear,0.66,0.6212,0.5,0.3284,34,473,507,159,507,507
13588,2012-07-25,Fall,2012,Jul,8,0,Wednesday,1,Clear,0.7,0.6364,0.42,0.2537,43,745,788,159,788,788
13589,2012-07-25,Fall,2012,Jul,9,0,Wednesday,1,Clear,0.72,0.6515,0.37,0.2985,65,277,342,159,342,342
13590,2012-07-25,Fall,2012,Jul,10,0,Wednesday,1,Clear,0.74,0.6515,0.37,0.0,68,163,231,159,231,231
13591,2012-07-25,Fall,2012,Jul,11,0,Wednesday,1,Clear,0.76,0.6667,0.33,0.0,79,202,281,159,281,281
13592,2012-07-25,Fall,2012,Jul,12,0,Wednesday,1,Clear,0.76,0.6667,0.33,0.0,77,233,310,159,310,310
13593,2012-07-25,Fall,2012,Jul,13,0,Wednesday,1,Clear,0.78,0.6818,0.31,0.1642,81,231,312,159,312,312
13594,2012-07-25,Fall,2012,Jul,14,0,Wednesday,1,Clear,0.8,0.697,0.29,0.1343,88,159,247,159,247,247
13595,2012-07-25,Fall,2012,Jul,15,0,Wednesday,1,Clear,0.78,0.6818,0.31,0.0896,94,223,317,159,317,317
13596,2012-07-25,Fall,2012,Jul,16,0,Wednesday,1,Clear,0.8,0.697,0.29,0.1642,91,393,484,159,484,484
13597,2012-07-25,Fall,2012,Jul,17,0,Wednesday,1,Clear,0.8,0.697,0.31,0.0,130,783,913,159,913,913
13598,2012-07-25,Fall,2012,Jul,18,0,Wednesday,1,Clear,0.8,0.697,0.27,0.1343,104,787,891,159,891,891
13599,2012-07-25,Fall,2012,Jul,19,0,Wednesday,1,Clear,0.76,0.6667,0.33,0.1343,116,582,698,159,698,698
13600,2012-07-25,Fall,2012,Jul,20,0,Wednesday,1,Clear,0.74,0.6515,0.4,0.1642,106,461,567,159,567,567
13601,2012-07-25,Fall,2012,Jul,21,0,Wednesday,1,Clear,0.72,0.6515,0.45,0.1343,71,326,397,159,397,397
13602,2012-07-25,Fall,2012,Jul,22,0,Wednesday,1,Clear,0.7,0.6515,0.58,0.1343,55,223,278,159,278,278
13603,2012-07-25,Fall,2012,Jul,23,0,Wednesday,1,Clear,0.68,0.6364,0.57,0.2985,52,187,239,159,239,239
13604,2012-07-26,Fall,2012,Jul,0,0,Thursday,1,Clear,0.66,0.6212,0.65,0.194,27,65,92,158,92,92
13605,2012-07-26,Fall,2012,Jul,1,0,Thursday,1,Clear,0.66,0.6212,0.65,0.2239,6,23,29,158,29,29
13606,2012-07-26,Fall,2012,Jul,2,0,Thursday,1,Clear,0.66,0.6212,0.69,0.2537,5,16,21,158,21,21
13607,2012-07-26,Fall,2012,Jul,3,0,Thursday,1,Clear,0.66,0.6212,0.69,0.2239,0,8,8,158,8,8
13608,2012-07-26,Fall,2012,Jul,4,0,Thursday,1,Clear,0.66,0.6212,0.74,0.194,0,4,4,158,4,4
13609,2012-07-26,Fall,2012,Jul,5,0,Thursday,1,Clear,0.66,0.6212,0.74,0.194,2,40,42,158,42,42
13610,2012-07-26,Fall,2012,Jul,6,0,Thursday,1,Clear,0.66,0.6061,0.78,0.2537,16,165,181,158,181,181
13611,2012-07-26,Fall,2012,Jul,7,0,Thursday,1,Clear,0.7,0.6667,0.74,0.2537,17,478,495,158,495,495
13612,2012-07-26,Fall,2012,Jul,8,0,Thursday,1,Misty,0.7,0.6667,0.74,0.2537,49,680,729,158,729,729
13613,2012-07-26,Fall,2012,Jul,9,0,Thursday,1,Misty,0.72,0.6818,0.7,0.1343,55,289,344,158,344,344
13614,2012-07-26,Fall,2012,Jul,10,0,Thursday,1,Clear,0.74,0.697,0.7,0.2239,79,143,222,158,222,222
13615,2012-07-26,Fall,2012,Jul,11,0,Thursday,1,Clear,0.8,0.803,0.66,0.2239,69,143,212,158,212,212
13616,2012-07-26,Fall,2012,Jul,12,0,Thursday,1,Clear,0.84,0.8182,0.56,0.2537,73,206,279,158,279,279
13617,2012-07-26,Fall,2012,Jul,13,0,Thursday,1,Clear,0.86,0.8333,0.53,0.2985,53,189,242,158,242,242
13618,2012-07-26,Fall,2012,Jul,14,0,Thursday,1,Clear,0.9,0.8788,0.47,0.2537,62,151,213,158,213,213
13619,2012-07-26,Fall,2012,Jul,15,0,Thursday,1,Clear,0.92,0.8939,0.42,0.2985,65,173,238,158,238,238
13620,2012-07-26,Fall,2012,Jul,16,0,Thursday,1,Clear,0.94,0.8788,0.38,0.3881,62,312,374,158,374,374
13621,2012-07-26,Fall,2012,Jul,17,0,Thursday,1,Clear,0.9,0.8636,0.45,0.4179,110,628,738,158,738,738
13622,2012-07-26,Fall,2012,Jul,18,0,Thursday,1,Clear,0.92,0.8788,0.4,0.3582,73,615,688,158,688,688
13623,2012-07-26,Fall,2012,Jul,19,0,Thursday,1,Clear,0.9,0.8636,0.45,0.3284,80,534,614,158,614,614
13624,2012-07-26,Fall,2012,Jul,20,0,Thursday,1,Clear,0.86,0.8182,0.5,0.2537,47,399,446,158,446,446
13625,2012-07-26,Fall,2012,Jul,21,0,Thursday,1,Clear,0.8,0.7424,0.49,0.6119,35,236,271,158,271,271
13626,2012-07-26,Fall,2012,Jul,22,0,Thursday,1,Clear,0.8,0.7424,0.49,0.6119,33,201,234,158,234,234
13627,2012-07-26,Fall,2012,Jul,23,0,Thursday,1,Clear,0.72,0.6818,0.7,0.1343,18,127,145,158,145,145
13628,2012-07-27,Fall,2012,Jul,0,0,Friday,1,Clear,0.72,0.6818,0.7,0.0,14,83,97,157,97,97
13629,2012-07-27,Fall,2012,Jul,1,0,Friday,1,Clear,0.72,0.6818,0.7,0.1045,12,42,54,157,54,54
13630,2012-07-27,Fall,2012,Jul,2,0,Friday,1,Clear,0.7,0.6667,0.79,0.1343,8,18,26,157,26,26
13631,2012-07-27,Fall,2012,Jul,3,0,Friday,1,Clear,0.7,0.6667,0.74,0.1642,3,9,12,157,12,12
13632,2012-07-27,Fall,2012,Jul,4,0,Friday,1,Clear,0.7,0.6667,0.79,0.0,3,5,8,157,8,8
13633,2012-07-27,Fall,2012,Jul,5,0,Friday,1,Clear,0.7,0.6667,0.84,0.0,3,34,37,157,37,37
13634,2012-07-27,Fall,2012,Jul,6,0,Friday,1,Clear,0.7,0.6667,0.79,0.0,10,129,139,157,139,139
13635,2012-07-27,Fall,2012,Jul,7,0,Friday,1,Clear,0.72,0.6818,0.7,0.194,13,397,410,157,410,410
13636,2012-07-27,Fall,2012,Jul,8,0,Friday,1,Clear,0.76,0.7273,0.66,0.0896,34,642,676,157,676,676
13637,2012-07-27,Fall,2012,Jul,9,0,Friday,1,Clear,0.82,0.7727,0.49,0.2836,34,329,363,157,363,363
13638,2012-07-27,Fall,2012,Jul,10,0,Friday,1,Clear,0.84,0.7727,0.47,0.0,85,146,231,157,231,231
13639,2012-07-27,Fall,2012,Jul,11,0,Friday,1,Clear,0.84,0.7727,0.47,0.3284,67,184,251,157,251,251
13640,2012-07-27,Fall,2012,Jul,12,0,Friday,1,Clear,0.84,0.7879,0.49,0.3582,92,207,299,157,299,299
13641,2012-07-27,Fall,2012,Jul,13,0,Friday,1,Clear,0.84,0.7727,0.47,0.2836,83,231,314,157,314,314
13642,2012-07-27,Fall,2012,Jul,14,0,Friday,1,Clear,0.86,0.803,0.47,0.2985,105,221,326,157,326,326
13643,2012-07-27,Fall,2012,Jul,15,0,Friday,1,Clear,0.86,0.7879,0.41,0.2239,81,242,323,157,323,323
13644,2012-07-27,Fall,2012,Jul,16,0,Friday,1,Clear,0.84,0.7727,0.47,0.2239,80,419,499,157,499,499
13645,2012-07-27,Fall,2012,Jul,17,0,Friday,1,Clear,0.86,0.7879,0.41,0.2836,101,598,699,157,699,699
13646,2012-07-27,Fall,2012,Jul,18,0,Friday,1,Clear,0.82,0.7576,0.46,0.1642,100,522,622,157,622,622
13647,2012-07-27,Fall,2012,Jul,19,0,Friday,1,Clear,0.82,0.7727,0.52,0.194,93,423,516,157,516,516
13648,2012-07-27,Fall,2012,Jul,20,0,Friday,1,Clear,0.78,0.7424,0.59,0.1045,85,269,354,157,354,354
13649,2012-07-27,Fall,2012,Jul,21,0,Friday,1,Clear,0.78,0.7424,0.59,0.1045,71,189,260,157,260,260
13650,2012-07-27,Fall,2012,Jul,22,0,Friday,1,Clear,0.78,0.7424,0.59,0.1343,48,151,199,157,199,199
13651,2012-07-27,Fall,2012,Jul,23,0,Friday,1,Clear,0.76,0.7273,0.66,0.0,34,155,189,157,189,189
13652,2012-07-28,Fall,2012,Jul,0,0,Saturday,0,Clear,0.74,0.6818,0.62,0.1343,21,170,191,156,191,191
13653,2012-07-28,Fall,2012,Jul,1,0,Saturday,0,Clear,0.72,0.6818,0.7,0.0896,11,69,80,156,80,80
13654,2012-07-28,Fall,2012,Jul,2,0,Saturday,0,Clear,0.72,0.6818,0.7,0.0,14,76,90,156,90,90
13655,2012-07-28,Fall,2012,Jul,3,0,Saturday,0,Clear,0.72,0.6818,0.7,0.0,10,33,43,156,43,43
13656,2012-07-28,Fall,2012,Jul,4,0,Saturday,0,Clear,0.7,0.6667,0.79,0.194,1,10,11,156,11,11
13657,2012-07-28,Fall,2012,Jul,5,0,Saturday,0,Clear,0.68,0.6364,0.79,0.1642,4,10,14,156,14,14
13658,2012-07-28,Fall,2012,Jul,6,0,Saturday,0,Clear,0.7,0.6515,0.7,0.1045,10,40,50,156,50,50
13659,2012-07-28,Fall,2012,Jul,7,0,Saturday,0,Clear,0.72,0.6818,0.7,0.1343,18,58,76,156,76,76
13660,2012-07-28,Fall,2012,Jul,8,0,Saturday,0,Clear,0.74,0.697,0.66,0.1642,36,127,163,156,163,163
13661,2012-07-28,Fall,2012,Jul,9,0,Saturday,0,Clear,0.78,0.7424,0.59,0.1045,110,227,337,156,337,337
13662,2012-07-28,Fall,2012,Jul,10,0,Saturday,0,Clear,0.82,0.7727,0.52,0.2239,129,266,395,156,395,395
13663,2012-07-28,Fall,2012,Jul,11,0,Saturday,0,Clear,0.84,0.7424,0.39,0.2239,162,295,457,156,457,457
13664,2012-07-28,Fall,2012,Jul,12,0,Saturday,0,Clear,0.84,0.7576,0.41,0.2239,157,330,487,156,487,487
13665,2012-07-28,Fall,2012,Jul,13,0,Saturday,0,Clear,0.86,0.7879,0.41,0.2836,173,325,498,156,498,498
13666,2012-07-28,Fall,2012,Jul,14,0,Saturday,0,Clear,0.86,0.7727,0.39,0.2537,186,308,494,156,494,494
13667,2012-07-28,Fall,2012,Jul,15,0,Saturday,0,Clear,0.88,0.7727,0.32,0.2836,206,291,497,156,497,497
13668,2012-07-28,Fall,2012,Jul,16,0,Saturday,0,Clear,0.86,0.7727,0.39,0.2239,208,279,487,156,487,487
13669,2012-07-28,Fall,2012,Jul,17,0,Saturday,0,Clear,0.82,0.7576,0.46,0.194,199,280,479,156,479,479
13670,2012-07-28,Fall,2012,Jul,18,0,Saturday,0,Clear,0.82,0.7424,0.43,0.2836,151,330,481,156,481,481
13671,2012-07-28,Fall,2012,Jul,19,0,Saturday,0,Clear,0.68,0.6364,0.83,0.0,115,223,338,156,338,338
13672,2012-07-28,Fall,2012,Jul,20,0,Saturday,0,Clear,0.66,0.6061,0.83,0.2239,79,154,233,156,233,233
13673,2012-07-28,Fall,2012,Jul,21,0,Saturday,0,Clear,0.66,0.6061,0.78,0.0896,94,206,300,156,300,300
13674,2012-07-28,Fall,2012,Jul,22,0,Saturday,0,Clear,0.66,0.6061,0.78,0.0896,88,188,276,156,276,276
13675,2012-07-28,Fall,2012,Jul,23,0,Saturday,0,Clear,0.66,0.6061,0.83,0.0896,52,156,208,156,208,208
13676,2012-07-29,Fall,2012,Jul,0,0,Sunday,0,Clear,0.66,0.5909,0.89,0.1343,59,129,188,155,188,188
13677,2012-07-29,Fall,2012,Jul,1,0,Sunday,0,Clear,0.66,0.6061,0.83,0.1045,49,109,158,155,158,158
13678,2012-07-29,Fall,2012,Jul,2,0,Sunday,0,Clear,0.66,0.6212,0.74,0.1343,33,79,112,155,112,112
13679,2012-07-29,Fall,2012,Jul,3,0,Sunday,0,Clear,0.66,0.6212,0.69,0.2239,18,37,55,155,55,55
13680,2012-07-29,Fall,2012,Jul,4,0,Sunday,0,Clear,0.64,0.6061,0.69,0.194,2,11,13,155,13,13
13681,2012-07-29,Fall,2012,Jul,5,0,Sunday,0,Clear,0.62,0.5909,0.78,0.194,3,14,17,155,17,17
13682,2012-07-29,Fall,2012,Jul,6,0,Sunday,0,Clear,0.64,0.6061,0.73,0.1642,6,12,18,155,18,18
13683,2012-07-29,Fall,2012,Jul,7,0,Sunday,0,Clear,0.66,0.6212,0.69,0.2537,4,36,40,155,40,40
13684,2012-07-29,Fall,2012,Jul,8,0,Sunday,0,Clear,0.7,0.6515,0.65,0.2239,37,90,127,155,127,127
13685,2012-07-29,Fall,2012,Jul,9,0,Sunday,0,Clear,0.72,0.6818,0.62,0.2537,64,162,226,155,226,226
13686,2012-07-29,Fall,2012,Jul,10,0,Sunday,0,Clear,0.74,0.6818,0.62,0.0,123,258,381,155,381,381
13687,2012-07-29,Fall,2012,Jul,11,0,Sunday,0,Clear,0.76,0.697,0.55,0.2239,183,326,509,155,509,509
13688,2012-07-29,Fall,2012,Jul,12,0,Sunday,0,Clear,0.76,0.697,0.55,0.3284,154,357,511,155,511,511
13689,2012-07-29,Fall,2012,Jul,13,0,Sunday,0,Clear,0.8,0.7424,0.49,0.2239,181,302,483,155,483,483
13690,2012-07-29,Fall,2012,Jul,14,0,Sunday,0,Clear,0.8,0.7273,0.46,0.194,231,291,522,155,522,522
13691,2012-07-29,Fall,2012,Jul,15,0,Sunday,0,Clear,0.8,0.7273,0.43,0.1343,195,306,501,155,501,501
13692,2012-07-29,Fall,2012,Jul,16,0,Sunday,0,Clear,0.8,0.7273,0.43,0.1343,191,330,521,155,521,521
13693,2012-07-29,Fall,2012,Jul,17,0,Sunday,0,Clear,0.82,0.7424,0.41,0.1642,164,367,531,155,531,531
13694,2012-07-29,Fall,2012,Jul,18,0,Sunday,0,Clear,0.8,0.7121,0.41,0.2985,117,302,419,155,419,419
13695,2012-07-29,Fall,2012,Jul,19,0,Sunday,0,Clear,0.76,0.697,0.55,0.1642,143,300,443,155,443,443
13696,2012-07-29,Fall,2012,Jul,20,0,Sunday,0,Clear,0.74,0.697,0.66,0.1045,75,228,303,155,303,303
13697,2012-07-29,Fall,2012,Jul,21,0,Sunday,0,Clear,0.72,0.6818,0.7,0.1343,72,199,271,155,271,271
13698,2012-07-29,Fall,2012,Jul,22,0,Sunday,0,Clear,0.7,0.6515,0.7,0.1045,31,117,148,155,148,148
13699,2012-07-29,Fall,2012,Jul,23,0,Sunday,0,Clear,0.7,0.6515,0.7,0.0,18,82,100,155,100,100
13700,2012-07-30,Fall,2012,Jul,0,0,Monday,1,Clear,0.7,0.6667,0.74,0.0896,12,46,58,154,58,58
13701,2012-07-30,Fall,2012,Jul,1,0,Monday,1,Clear,0.7,0.6667,0.74,0.0,4,15,19,154,19,19
13702,2012-07-30,Fall,2012,Jul,2,0,Monday,1,Clear,0.68,0.6364,0.74,0.0,2,6,8,154,8,8
13703,2012-07-30,Fall,2012,Jul,3,0,Monday,1,Clear,0.66,0.6061,0.83,0.0,0,3,3,154,3,3
13704,2012-07-30,Fall,2012,Jul,4,0,Monday,1,Clear,0.66,0.6061,0.83,0.0,0,5,5,154,5,5
13705,2012-07-30,Fall,2012,Jul,5,0,Monday,1,Clear,0.66,0.6061,0.83,0.1045,4,43,47,154,47,47
13706,2012-07-30,Fall,2012,Jul,6,0,Monday,1,Clear,0.66,0.6061,0.83,0.1642,6,155,161,154,161,161
13707,2012-07-30,Fall,2012,Jul,7,0,Monday,1,Clear,0.7,0.6667,0.79,0.0896,14,455,469,154,469,469
13708,2012-07-30,Fall,2012,Jul,8,0,Monday,1,Misty,0.72,0.697,0.74,0.1045,31,720,751,154,751,751
13709,2012-07-30,Fall,2012,Jul,9,0,Monday,1,Misty,0.74,0.697,0.7,0.0,34,259,293,154,293,293
13710,2012-07-30,Fall,2012,Jul,10,0,Monday,1,Misty,0.74,0.697,0.66,0.2239,54,135,189,154,189,189
13711,2012-07-30,Fall,2012,Jul,11,0,Monday,1,Misty,0.78,0.7273,0.55,0.1343,69,146,215,154,215,215
13712,2012-07-30,Fall,2012,Jul,12,0,Monday,1,Misty,0.76,0.7121,0.58,0.1045,77,201,278,154,278,278
13713,2012-07-30,Fall,2012,Jul,13,0,Monday,1,Clear,0.8,0.7424,0.49,0.1642,57,169,226,154,226,226
13714,2012-07-30,Fall,2012,Jul,14,0,Monday,1,Clear,0.8,0.7424,0.49,0.2239,87,167,254,154,254,254
13715,2012-07-30,Fall,2012,Jul,15,0,Monday,1,Clear,0.8,0.7424,0.49,0.2537,51,185,236,154,236,236
13716,2012-07-30,Fall,2012,Jul,16,0,Monday,1,Clear,0.8,0.7424,0.49,0.2836,88,337,425,154,425,425
13717,2012-07-30,Fall,2012,Jul,17,0,Monday,1,Clear,0.76,0.697,0.55,0.3284,62,765,827,154,827,827
13718,2012-07-30,Fall,2012,Jul,18,0,Monday,1,Clear,0.76,0.7121,0.58,0.4179,77,735,812,154,812,812
13719,2012-07-30,Fall,2012,Jul,19,0,Monday,1,Clear,0.82,0.7727,0.52,0.1642,81,584,665,154,665,665
13720,2012-07-30,Fall,2012,Jul,20,0,Monday,1,Clear,0.72,0.6818,0.7,0.2239,78,384,462,154,462,462
13721,2012-07-30,Fall,2012,Jul,21,0,Monday,1,Clear,0.72,0.6818,0.7,0.194,71,251,322,154,322,322
13722,2012-07-30,Fall,2012,Jul,22,0,Monday,1,Misty,0.7,0.6667,0.74,0.2239,47,183,230,154,230,230
13723,2012-07-30,Fall,2012,Jul,23,0,Monday,1,Clear,0.7,0.6667,0.74,0.194,34,116,150,154,150,150
13724,2012-07-31,Fall,2012,Jul,0,0,Tuesday,1,Clear,0.68,0.6364,0.79,0.1343,11,27,38,153,38,38
13725,2012-07-31,Fall,2012,Jul,1,0,Tuesday,1,Clear,0.66,0.6061,0.83,0.1343,3,18,21,153,21,21
13726,2012-07-31,Fall,2012,Jul,2,0,Tuesday,1,Clear,0.66,0.6061,0.83,0.1343,0,8,8,153,8,8
13727,2012-07-31,Fall,2012,Jul,3,0,Tuesday,1,Clear,0.66,0.6061,0.83,0.0896,1,5,6,153,6,6
13728,2012-07-31,Fall,2012,Jul,4,0,Tuesday,1,Clear,0.66,0.6061,0.83,0.0896,0,6,6,153,6,6
13729,2012-07-31,Fall,2012,Jul,5,0,Tuesday,1,Clear,0.66,0.6061,0.83,0.1642,5,40,45,153,45,45
13730,2012-07-31,Fall,2012,Jul,6,0,Tuesday,1,Clear,0.64,0.5758,0.89,0.1642,2,192,194,153,194,194
13731,2012-07-31,Fall,2012,Jul,7,0,Tuesday,1,Clear,0.68,0.6364,0.83,0.2239,21,492,513,153,513,513
13732,2012-07-31,Fall,2012,Jul,8,0,Tuesday,1,Clear,0.7,0.6667,0.79,0.1343,30,730,760,153,760,760
13733,2012-07-31,Fall,2012,Jul,9,0,Tuesday,1,Clear,0.72,0.6818,0.7,0.1045,31,302,333,153,333,333
13734,2012-07-31,Fall,2012,Jul,10,0,Tuesday,1,Clear,0.72,0.6818,0.66,0.0,73,154,227,153,227,227
13735,2012-07-31,Fall,2012,Jul,11,0,Tuesday,1,Clear,0.76,0.7121,0.58,0.0,54,170,224,153,224,224
13736,2012-07-31,Fall,2012,Jul,12,0,Tuesday,1,Clear,0.8,0.7273,0.46,0.0,50,198,248,153,248,248
13737,2012-07-31,Fall,2012,Jul,13,0,Tuesday,1,Clear,0.8,0.7576,0.55,0.2836,69,219,288,153,288,288
13738,2012-07-31,Fall,2012,Jul,14,0,Tuesday,1,Clear,0.8,0.7576,0.55,0.2836,72,188,260,153,260,260
13739,2012-07-31,Fall,2012,Jul,15,0,Tuesday,1,Clear,0.76,0.7121,0.62,0.1343,29,115,144,153,144,144
13740,2012-07-31,Fall,2012,Jul,16,0,Tuesday,1,Clear,0.76,0.7121,0.58,0.2239,66,336,402,153,402,402
13741,2012-07-31,Fall,2012,Jul,17,0,Tuesday,1,Clear,0.78,0.7121,0.52,0.2239,94,726,820,153,820,820
13742,2012-07-31,Fall,2012,Jul,18,0,Tuesday,1,Clear,0.76,0.697,0.55,0.2836,99,758,857,153,857,857
13743,2012-07-31,Fall,2012,Jul,19,0,Tuesday,1,Light_rainsnow,0.74,0.6818,0.62,0.3582,90,524,614,153,614,614
13744,2012-07-31,Fall,2012,Jul,20,0,Tuesday,1,Light_rainsnow,0.7,0.6515,0.7,0.194,55,397,452,153,452,452
13745,2012-07-31,Fall,2012,Jul,21,0,Tuesday,1,Clear,0.68,0.6364,0.79,0.194,60,292,352,153,352,352
13746,2012-07-31,Fall,2012,Jul,22,0,Tuesday,1,Clear,0.68,0.6364,0.74,0.2537,33,224,257,153,257,257
13747,2012-07-31,Fall,2012,Jul,23,0,Tuesday,1,Misty,0.66,0.6061,0.83,0.1642,20,127,147,153,147,147
13748,2012-08-01,Fall,2012,Aug,0,0,Wednesday,1,Clear,0.68,0.6364,0.79,0.1642,3,44,47,152,47,47
13749,2012-08-01,Fall,2012,Aug,1,0,Wednesday,1,Clear,0.66,0.6061,0.83,0.0896,5,28,33,152,33,33
13750,2012-08-01,Fall,2012,Aug,2,0,Wednesday,1,Clear,0.64,0.5758,0.83,0.1045,0,13,13,152,13,13
13751,2012-08-01,Fall,2012,Aug,3,0,Wednesday,1,Clear,0.64,0.5758,0.83,0.1045,0,7,7,152,7,7
13752,2012-08-01,Fall,2012,Aug,4,0,Wednesday,1,Misty,0.64,0.5909,0.78,0.1343,1,3,4,152,4,4
13753,2012-08-01,Fall,2012,Aug,5,0,Wednesday,1,Misty,0.64,0.5909,0.78,0.1343,3,46,49,152,49,49
13754,2012-08-01,Fall,2012,Aug,6,0,Wednesday,1,Clear,0.64,0.5909,0.78,0.1343,6,179,185,152,185,185
13755,2012-08-01,Fall,2012,Aug,7,0,Wednesday,1,Misty,0.64,0.5758,0.83,0.1343,19,468,487,152,487,487
13756,2012-08-01,Fall,2012,Aug,8,0,Wednesday,1,Misty,0.66,0.6061,0.78,0.194,32,649,681,152,681,681
13757,2012-08-01,Fall,2012,Aug,9,0,Wednesday,1,Misty,0.68,0.6364,0.74,0.0896,34,316,350,152,350,350
13758,2012-08-01,Fall,2012,Aug,10,0,Wednesday,1,Clear,0.72,0.6818,0.66,0.0896,61,175,236,152,236,236
13759,2012-08-01,Fall,2012,Aug,11,0,Wednesday,1,Clear,0.76,0.7121,0.58,0.0896,54,180,234,152,234,234
13760,2012-08-01,Fall,2012,Aug,12,0,Wednesday,1,Clear,0.8,0.7424,0.49,0.1045,75,209,284,152,284,284
13761,2012-08-01,Fall,2012,Aug,13,0,Wednesday,1,Clear,0.8,0.7424,0.52,0.1642,59,221,280,152,280,280
13762,2012-08-01,Fall,2012,Aug,14,0,Wednesday,1,Clear,0.82,0.7576,0.46,0.1642,88,175,263,152,263,263
13763,2012-08-01,Fall,2012,Aug,15,0,Wednesday,1,Clear,0.82,0.7576,0.46,0.1642,89,206,295,152,295,295
13764,2012-08-01,Fall,2012,Aug,16,0,Wednesday,1,Clear,0.8,0.7576,0.55,0.2836,93,386,479,152,479,479
13765,2012-08-01,Fall,2012,Aug,17,0,Wednesday,1,Clear,0.8,0.7424,0.49,0.1642,103,734,837,152,837,837
13766,2012-08-01,Fall,2012,Aug,18,0,Wednesday,1,Light_rainsnow,0.76,0.7121,0.62,0.2239,105,786,891,152,891,891
13767,2012-08-01,Fall,2012,Aug,19,0,Wednesday,1,Clear,0.74,0.697,0.66,0.2537,88,564,652,152,652,652
13768,2012-08-01,Fall,2012,Aug,20,0,Wednesday,1,Clear,0.74,0.697,0.66,0.1642,65,448,513,152,513,513
13769,2012-08-01,Fall,2012,Aug,21,0,Wednesday,1,Clear,0.72,0.6818,0.7,0.1343,36,284,320,152,320,320
13770,2012-08-01,Fall,2012,Aug,22,0,Wednesday,1,Clear,0.72,0.6818,0.7,0.1045,37,251,288,152,288,288
13771,2012-08-01,Fall,2012,Aug,23,0,Wednesday,1,Clear,0.7,0.6667,0.74,0.0,18,134,152,152,152,152
13772,2012-08-02,Fall,2012,Aug,0,0,Thursday,1,Clear,0.7,0.6667,0.74,0.0,8,55,63,151,63,63
13773,2012-08-02,Fall,2012,Aug,1,0,Thursday,1,Clear,0.68,0.6364,0.79,0.1045,6,36,42,151,42,42
13774,2012-08-02,Fall,2012,Aug,2,0,Thursday,1,Clear,0.66,0.6061,0.83,0.0896,3,8,11,151,11,11
13775,2012-08-02,Fall,2012,Aug,3,0,Thursday,1,Clear,0.66,0.6061,0.83,0.0,0,6,6,151,6,6
13776,2012-08-02,Fall,2012,Aug,4,0,Thursday,1,Clear,0.66,0.6061,0.83,0.0,0,9,9,151,9,9
13777,2012-08-02,Fall,2012,Aug,5,0,Thursday,1,Clear,0.66,0.5909,0.89,0.1343,4,37,41,151,41,41
13778,2012-08-02,Fall,2012,Aug,6,0,Thursday,1,Clear,0.66,0.6061,0.83,0.0,6,177,183,151,183,183
13779,2012-08-02,Fall,2012,Aug,7,0,Thursday,1,Clear,0.7,0.6667,0.79,0.0,21,452,473,151,473,473
13780,2012-08-02,Fall,2012,Aug,8,0,Thursday,1,Clear,0.72,0.697,0.74,0.1045,21,718,739,151,739,739
13781,2012-08-02,Fall,2012,Aug,9,0,Thursday,1,Clear,0.76,0.7273,0.66,0.1045,31,312,343,151,343,343
13782,2012-08-02,Fall,2012,Aug,10,0,Thursday,1,Clear,0.8,0.7576,0.55,0.0,51,130,181,151,181,181
13783,2012-08-02,Fall,2012,Aug,11,0,Thursday,1,Clear,0.82,0.7727,0.52,0.1045,59,167,226,151,226,226
13784,2012-08-02,Fall,2012,Aug,12,0,Thursday,1,Clear,0.84,0.7576,0.44,0.1343,56,230,286,151,286,286
13785,2012-08-02,Fall,2012,Aug,13,0,Thursday,1,Clear,0.86,0.7879,0.44,0.2239,98,212,310,151,310,310
13786,2012-08-02,Fall,2012,Aug,14,0,Thursday,1,Clear,0.86,0.7879,0.41,0.1343,54,171,225,151,225,225
13787,2012-08-02,Fall,2012,Aug,15,0,Thursday,1,Clear,0.78,0.7424,0.62,0.4627,68,202,270,151,270,270
13788,2012-08-02,Fall,2012,Aug,16,0,Thursday,1,Clear,0.82,0.7576,0.46,0.194,71,335,406,151,406,406
13789,2012-08-02,Fall,2012,Aug,17,0,Thursday,1,Clear,0.82,0.7727,0.52,0.2537,90,775,865,151,865,865
13790,2012-08-02,Fall,2012,Aug,18,0,Thursday,1,Clear,0.8,0.7727,0.59,0.2239,86,681,767,151,767,767
13791,2012-08-02,Fall,2012,Aug,19,0,Thursday,1,Clear,0.8,0.7879,0.63,0.1642,98,509,607,151,607,607
13792,2012-08-02,Fall,2012,Aug,20,0,Thursday,1,Clear,0.78,0.7576,0.66,0.0,51,376,427,151,427,427
13793,2012-08-02,Fall,2012,Aug,21,0,Thursday,1,Clear,0.76,0.7273,0.66,0.2239,41,301,342,151,342,342
13794,2012-08-02,Fall,2012,Aug,22,0,Thursday,1,Clear,0.74,0.697,0.7,0.194,35,227,262,151,262,262
13795,2012-08-02,Fall,2012,Aug,23,0,Thursday,1,Clear,0.72,0.6818,0.7,0.2537,25,152,177,151,177,177
13796,2012-08-03,Fall,2012,Aug,0,0,Friday,1,Clear,0.72,0.6818,0.7,0.194,15,56,71,150,71,71
13797,2012-08-03,Fall,2012,Aug,1,0,Friday,1,Clear,0.7,0.6667,0.74,0.194,11,32,43,150,43,43
13798,2012-08-03,Fall,2012,Aug,2,0,Friday,1,Clear,0.68,0.6364,0.79,0.2239,0,14,14,150,14,14
13799,2012-08-03,Fall,2012,Aug,3,0,Friday,1,Clear,0.68,0.6364,0.79,0.2239,1,5,6,150,6,6
13800,2012-08-03,Fall,2012,Aug,4,0,Friday,1,Clear,0.66,0.6061,0.83,0.2537,1,11,12,150,12,12
13801,2012-08-03,Fall,2012,Aug,5,0,Friday,1,Clear,0.66,0.6061,0.83,0.1642,2,35,37,150,37,37
13802,2012-08-03,Fall,2012,Aug,6,0,Friday,1,Clear,0.66,0.6061,0.83,0.2239,5,158,163,150,163,163
13803,2012-08-03,Fall,2012,Aug,7,0,Friday,1,Clear,0.7,0.6667,0.74,0.1045,25,396,421,150,421,421
13804,2012-08-03,Fall,2012,Aug,8,0,Friday,1,Clear,0.72,0.6818,0.7,0.1343,32,636,668,150,668,668
13805,2012-08-03,Fall,2012,Aug,9,0,Friday,1,Misty,0.74,0.697,0.66,0.1045,69,327,396,150,396,396
13806,2012-08-03,Fall,2012,Aug,10,0,Friday,1,Misty,0.8,0.7424,0.52,0.194,82,167,249,150,249,249
13807,2012-08-03,Fall,2012,Aug,11,0,Friday,1,Misty,0.84,0.7879,0.49,0.2836,77,186,263,150,263,263
13808,2012-08-03,Fall,2012,Aug,12,0,Friday,1,Misty,0.86,0.8182,0.5,0.2985,95,243,338,150,338,338
13809,2012-08-03,Fall,2012,Aug,13,0,Friday,1,Misty,0.86,0.803,0.47,0.2836,98,247,345,150,345,345
13810,2012-08-03,Fall,2012,Aug,14,0,Friday,1,Misty,0.86,0.7879,0.44,0.2537,102,229,331,150,331,331
13811,2012-08-03,Fall,2012,Aug,15,0,Friday,1,Clear,0.88,0.8182,0.42,0.2537,112,268,380,150,380,380
13812,2012-08-03,Fall,2012,Aug,16,0,Friday,1,Misty,0.86,0.7879,0.41,0.2239,112,380,492,150,492,492
13813,2012-08-03,Fall,2012,Aug,17,0,Friday,1,Misty,0.84,0.803,0.53,0.2836,95,646,741,150,741,741
13814,2012-08-03,Fall,2012,Aug,18,0,Friday,1,Misty,0.82,0.803,0.59,0.2537,98,573,671,150,671,671
13815,2012-08-03,Fall,2012,Aug,19,0,Friday,1,Misty,0.8,0.7879,0.63,0.2239,81,388,469,150,469,469
13816,2012-08-03,Fall,2012,Aug,20,0,Friday,1,Misty,0.78,0.7576,0.66,0.2239,89,300,389,150,389,389
13817,2012-08-03,Fall,2012,Aug,21,0,Friday,1,Misty,0.76,0.7273,0.66,0.194,54,224,278,150,278,278
13818,2012-08-03,Fall,2012,Aug,22,0,Friday,1,Clear,0.76,0.7273,0.7,0.2537,46,156,202,150,202,202
13819,2012-08-03,Fall,2012,Aug,23,0,Friday,1,Clear,0.74,0.7121,0.79,0.1343,26,170,196,150,196,196
13820,2012-08-04,Fall,2012,Aug,0,0,Saturday,0,Clear,0.74,0.7121,0.79,0.1642,24,137,161,149,161,161
13821,2012-08-04,Fall,2012,Aug,1,0,Saturday,0,Clear,0.72,0.7121,0.84,0.194,23,99,122,149,122,122
13822,2012-08-04,Fall,2012,Aug,2,0,Saturday,0,Clear,0.72,0.7121,0.84,0.1343,20,64,84,149,84,84
13823,2012-08-04,Fall,2012,Aug,3,0,Saturday,0,Clear,0.72,0.7121,0.84,0.1343,11,19,30,149,30,30
13824,2012-08-04,Fall,2012,Aug,4,0,Saturday,0,Clear,0.72,0.697,0.79,0.194,2,11,13,149,13,13
13825,2012-08-04,Fall,2012,Aug,5,0,Saturday,0,Clear,0.7,0.6667,0.84,0.2239,1,16,17,149,17,17
13826,2012-08-04,Fall,2012,Aug,6,0,Saturday,0,Clear,0.7,0.6667,0.84,0.2239,12,37,49,149,49,49
13827,2012-08-04,Fall,2012,Aug,7,0,Saturday,0,Clear,0.72,0.697,0.77,0.1642,18,49,67,149,67,67
13828,2012-08-04,Fall,2012,Aug,8,0,Saturday,0,Clear,0.74,0.7273,0.72,0.194,49,132,181,149,181,181
13829,2012-08-04,Fall,2012,Aug,9,0,Saturday,0,Clear,0.78,0.7576,0.65,0.2239,61,217,278,149,278,278
13830,2012-08-04,Fall,2012,Aug,10,0,Saturday,0,Clear,0.82,0.7727,0.57,0.194,108,288,396,149,396,396
13831,2012-08-04,Fall,2012,Aug,11,0,Saturday,0,Clear,0.86,0.803,0.47,0.2537,155,315,470,149,470,470
13832,2012-08-04,Fall,2012,Aug,12,0,Saturday,0,Clear,0.86,0.7879,0.4,0.3582,222,325,547,149,547,547
13833,2012-08-04,Fall,2012,Aug,13,0,Saturday,0,Clear,0.88,0.8182,0.42,0.2985,195,332,527,149,527,527
13834,2012-08-04,Fall,2012,Aug,14,0,Saturday,0,Clear,0.88,0.803,0.4,0.3881,183,289,472,149,472,472
13835,2012-08-04,Fall,2012,Aug,15,0,Saturday,0,Clear,0.88,0.8182,0.42,0.4179,205,284,489,149,489,489
13836,2012-08-04,Fall,2012,Aug,16,0,Saturday,0,Clear,0.9,0.8182,0.39,0.2985,197,253,450,149,450,450
13837,2012-08-04,Fall,2012,Aug,17,0,Saturday,0,Clear,0.88,0.7879,0.37,0.2985,179,313,492,149,492,492
13838,2012-08-04,Fall,2012,Aug,18,0,Saturday,0,Clear,0.86,0.7879,0.41,0.3284,169,321,490,149,490,490
13839,2012-08-04,Fall,2012,Aug,19,0,Saturday,0,Clear,0.82,0.7727,0.52,0.3582,133,264,397,149,397,397
13840,2012-08-04,Fall,2012,Aug,20,0,Saturday,0,Clear,0.82,0.7727,0.52,0.2985,117,195,312,149,312,312
13841,2012-08-04,Fall,2012,Aug,21,0,Saturday,0,Clear,0.8,0.7727,0.59,0.2537,96,193,289,149,289,289
13842,2012-08-04,Fall,2012,Aug,22,0,Saturday,0,Clear,0.76,0.7273,0.66,0.2836,104,165,269,149,269,269
13843,2012-08-04,Fall,2012,Aug,23,0,Saturday,0,Clear,0.76,0.7273,0.66,0.2985,61,161,222,149,222,222
13844,2012-08-05,Fall,2012,Aug,0,0,Sunday,0,Clear,0.74,0.697,0.7,0.2836,32,121,153,148,153,153
13845,2012-08-05,Fall,2012,Aug,1,0,Sunday,0,Clear,0.74,0.697,0.7,0.2537,8,79,87,148,87,87
13846,2012-08-05,Fall,2012,Aug,2,0,Sunday,0,Clear,0.74,0.697,0.7,0.2985,5,68,73,148,73,73
13847,2012-08-05,Fall,2012,Aug,3,0,Sunday,0,Clear,0.72,0.697,0.74,0.2537,9,32,41,148,41,41
13848,2012-08-05,Fall,2012,Aug,4,0,Sunday,0,Clear,0.72,0.697,0.74,0.2537,3,11,14,148,14,14
13849,2012-08-05,Fall,2012,Aug,5,0,Sunday,0,Clear,0.72,0.697,0.74,0.2537,1,18,19,148,19,19
13850,2012-08-05,Fall,2012,Aug,6,0,Sunday,0,Clear,0.72,0.697,0.79,0.2537,7,12,19,148,19,19
13851,2012-08-05,Fall,2012,Aug,7,0,Sunday,0,Clear,0.74,0.7121,0.74,0.2985,18,50,68,148,68,68
13852,2012-08-05,Fall,2012,Aug,8,0,Sunday,0,Clear,0.76,0.7273,0.66,0.3284,27,81,108,148,108,108
13853,2012-08-05,Fall,2012,Aug,9,0,Sunday,0,Clear,0.8,0.7727,0.59,0.3582,61,168,229,148,229,229
13854,2012-08-05,Fall,2012,Aug,10,0,Sunday,0,Clear,0.8,0.7727,0.59,0.4179,111,253,364,148,364,364
13855,2012-08-05,Fall,2012,Aug,11,0,Sunday,0,Clear,0.82,0.7879,0.56,0.4179,155,282,437,148,437,437
13856,2012-08-05,Fall,2012,Aug,12,0,Sunday,0,Clear,0.86,0.803,0.47,0.5224,161,330,491,148,491,491
13857,2012-08-05,Fall,2012,Aug,13,0,Sunday,0,Clear,0.88,0.8182,0.44,0.4627,208,315,523,148,523,523
13858,2012-08-05,Fall,2012,Aug,14,0,Sunday,0,Clear,0.9,0.8485,0.42,0.4627,161,365,526,148,526,526
13859,2012-08-05,Fall,2012,Aug,15,0,Sunday,0,Clear,0.9,0.8182,0.37,0.5224,164,286,450,148,450,450
13860,2012-08-05,Fall,2012,Aug,16,0,Sunday,0,Clear,0.82,0.7576,0.46,0.2537,143,278,421,148,421,421
13861,2012-08-05,Fall,2012,Aug,17,0,Sunday,0,Clear,0.82,0.7576,0.46,0.2537,122,260,382,148,382,382
13862,2012-08-05,Fall,2012,Aug,18,0,Sunday,0,Light_rainsnow,0.7,0.6667,0.74,0.1343,75,154,229,148,229,229
13863,2012-08-05,Fall,2012,Aug,19,0,Sunday,0,Clear,0.7,0.6667,0.84,0.2239,46,139,185,148,185,185
13864,2012-08-05,Fall,2012,Aug,20,0,Sunday,0,Clear,0.7,0.6667,0.84,0.1045,53,140,193,148,193,193
13865,2012-08-05,Fall,2012,Aug,21,0,Sunday,0,Clear,0.72,0.697,0.79,0.1045,51,157,208,148,208,208
13866,2012-08-05,Fall,2012,Aug,22,0,Sunday,0,Clear,0.72,0.697,0.79,0.0896,57,100,157,148,157,157
13867,2012-08-05,Fall,2012,Aug,23,0,Sunday,0,Misty,0.72,0.697,0.79,0.1642,29,58,87,148,87,87
13868,2012-08-06,Fall,2012,Aug,0,0,Monday,1,Misty,0.72,0.697,0.79,0.0,9,24,33,147,33,33
13869,2012-08-06,Fall,2012,Aug,1,0,Monday,1,Clear,0.72,0.697,0.79,0.0896,1,10,11,147,11,11
13870,2012-08-06,Fall,2012,Aug,2,0,Monday,1,Misty,0.72,0.697,0.79,0.1343,0,5,5,147,5,5
13871,2012-08-06,Fall,2012,Aug,3,0,Monday,1,Light_rainsnow,0.72,0.697,0.79,0.0896,0,5,5,147,5,5
13872,2012-08-06,Fall,2012,Aug,4,0,Monday,1,Misty,0.72,0.697,0.74,0.1343,3,8,11,147,11,11
13873,2012-08-06,Fall,2012,Aug,5,0,Monday,1,Clear,0.7,0.6667,0.79,0.194,2,23,25,147,25,25
13874,2012-08-06,Fall,2012,Aug,6,0,Monday,1,Misty,0.7,0.6667,0.79,0.2239,4,137,141,147,141,141
13875,2012-08-06,Fall,2012,Aug,7,0,Monday,1,Light_rainsnow,0.72,0.6818,0.7,0.194,14,393,407,147,407,407
13876,2012-08-06,Fall,2012,Aug,8,0,Monday,1,Misty,0.7,0.6667,0.79,0.0,27,578,605,147,605,605
13877,2012-08-06,Fall,2012,Aug,9,0,Monday,1,Light_rainsnow,0.7,0.6667,0.79,0.1642,28,248,276,147,276,276
13878,2012-08-06,Fall,2012,Aug,10,0,Monday,1,Clear,0.74,0.697,0.7,0.2239,54,159,213,147,213,213
13879,2012-08-06,Fall,2012,Aug,11,0,Monday,1,Clear,0.76,0.7273,0.66,0.1343,108,152,260,147,260,260
13880,2012-08-06,Fall,2012,Aug,12,0,Monday,1,Misty,0.78,0.7273,0.55,0.0896,72,213,285,147,285,285
13881,2012-08-06,Fall,2012,Aug,13,0,Monday,1,Clear,0.8,0.7424,0.49,0.2239,85,204,289,147,289,289
13882,2012-08-06,Fall,2012,Aug,14,0,Monday,1,Clear,0.82,0.7576,0.46,0.0,99,188,287,147,287,287
13883,2012-08-06,Fall,2012,Aug,15,0,Monday,1,Clear,0.82,0.7576,0.46,0.1343,91,183,274,147,274,274
13884,2012-08-06,Fall,2012,Aug,16,0,Monday,1,Clear,0.84,0.7576,0.41,0.1045,88,363,451,147,451,451
13885,2012-08-06,Fall,2012,Aug,17,0,Monday,1,Clear,0.82,0.7424,0.41,0.0,112,746,858,147,858,858
13886,2012-08-06,Fall,2012,Aug,18,0,Monday,1,Clear,0.82,0.7424,0.41,0.1343,100,743,843,147,843,843
13887,2012-08-06,Fall,2012,Aug,19,0,Monday,1,Clear,0.78,0.7424,0.59,0.194,109,531,640,147,640,640
13888,2012-08-06,Fall,2012,Aug,20,0,Monday,1,Clear,0.76,0.7273,0.66,0.1642,89,368,457,147,457,457
13889,2012-08-06,Fall,2012,Aug,21,0,Monday,1,Clear,0.74,0.697,0.7,0.194,72,245,317,147,317,317
13890,2012-08-06,Fall,2012,Aug,22,0,Monday,1,Clear,0.74,0.697,0.7,0.0896,50,157,207,147,207,207
13891,2012-08-06,Fall,2012,Aug,23,0,Monday,1,Clear,0.72,0.697,0.74,0.194,16,97,113,147,113,113
13892,2012-08-07,Fall,2012,Aug,0,0,Tuesday,1,Clear,0.7,0.6667,0.84,0.194,15,32,47,146,47,47
13893,2012-08-07,Fall,2012,Aug,1,0,Tuesday,1,Clear,0.7,0.6667,0.84,0.1343,2,16,18,146,18,18
13894,2012-08-07,Fall,2012,Aug,2,0,Tuesday,1,Clear,0.7,0.6667,0.84,0.1343,6,7,13,146,13,13
13895,2012-08-07,Fall,2012,Aug,3,0,Tuesday,1,Clear,0.7,0.6667,0.84,0.0,0,6,6,146,6,6
13896,2012-08-07,Fall,2012,Aug,4,0,Tuesday,1,Clear,0.68,0.6364,0.83,0.1343,2,7,9,146,9,9
13897,2012-08-07,Fall,2012,Aug,5,0,Tuesday,1,Clear,0.7,0.6667,0.79,0.1045,3,33,36,146,36,36
13898,2012-08-07,Fall,2012,Aug,6,0,Tuesday,1,Misty,0.7,0.6667,0.79,0.194,3,176,179,146,179,179
13899,2012-08-07,Fall,2012,Aug,7,0,Tuesday,1,Misty,0.7,0.6667,0.74,0.1343,21,481,502,146,502,502
13900,2012-08-07,Fall,2012,Aug,8,0,Tuesday,1,Misty,0.7,0.6515,0.7,0.1642,41,664,705,146,705,705
13901,2012-08-07,Fall,2012,Aug,9,0,Tuesday,1,Misty,0.7,0.6667,0.74,0.1343,44,283,327,146,327,327
13902,2012-08-07,Fall,2012,Aug,10,0,Tuesday,1,Misty,0.74,0.697,0.7,0.1343,89,161,250,146,250,250
13903,2012-08-07,Fall,2012,Aug,11,0,Tuesday,1,Misty,0.76,0.7273,0.66,0.0896,84,130,214,146,214,214
13904,2012-08-07,Fall,2012,Aug,12,0,Tuesday,1,Misty,0.8,0.7576,0.55,0.1343,86,197,283,146,283,283
13905,2012-08-07,Fall,2012,Aug,13,0,Tuesday,1,Misty,0.8,0.7424,0.52,0.194,68,185,253,146,253,253
13906,2012-08-07,Fall,2012,Aug,14,0,Tuesday,1,Misty,0.82,0.7576,0.46,0.0,76,185,261,146,261,261
13907,2012-08-07,Fall,2012,Aug,15,0,Tuesday,1,Clear,0.8,0.7424,0.52,0.0,100,206,306,146,306,306
13908,2012-08-07,Fall,2012,Aug,16,0,Tuesday,1,Light_rainsnow,0.76,0.7273,0.66,0.2836,101,344,445,146,445,445
13909,2012-08-07,Fall,2012,Aug,17,0,Tuesday,1,Misty,0.78,0.7424,0.62,0.1343,125,743,868,146,868,868
13910,2012-08-07,Fall,2012,Aug,18,0,Tuesday,1,Misty,0.76,0.7121,0.62,0.1642,103,711,814,146,814,814
13911,2012-08-07,Fall,2012,Aug,19,0,Tuesday,1,Misty,0.76,0.7273,0.66,0.1045,104,506,610,146,610,610
13912,2012-08-07,Fall,2012,Aug,20,0,Tuesday,1,Misty,0.74,0.697,0.7,0.1343,74,374,448,146,448,448
13913,2012-08-07,Fall,2012,Aug,21,0,Tuesday,1,Misty,0.72,0.697,0.74,0.0,70,247,317,146,317,317
13914,2012-08-07,Fall,2012,Aug,22,0,Tuesday,1,Clear,0.72,0.697,0.74,0.1045,43,181,224,146,224,224
13915,2012-08-07,Fall,2012,Aug,23,0,Tuesday,1,Clear,0.72,0.697,0.79,0.0,18,120,138,146,138,138
13916,2012-08-08,Fall,2012,Aug,0,0,Wednesday,1,Clear,0.7,0.6667,0.84,0.0,12,46,58,145,58,58
13917,2012-08-08,Fall,2012,Aug,1,0,Wednesday,1,Clear,0.72,0.697,0.79,0.0,3,20,23,145,23,23
13918,2012-08-08,Fall,2012,Aug,2,0,Wednesday,1,Clear,0.7,0.6667,0.84,0.0,1,5,6,145,6,6
13919,2012-08-08,Fall,2012,Aug,3,0,Wednesday,1,Clear,0.7,0.6667,0.84,0.0,1,6,7,145,7,7
13920,2012-08-08,Fall,2012,Aug,4,0,Wednesday,1,Clear,0.7,0.6667,0.84,0.0,1,6,7,145,7,7
13921,2012-08-08,Fall,2012,Aug,5,0,Wednesday,1,Misty,0.68,0.6364,0.89,0.1642,3,40,43,145,43,43
13922,2012-08-08,Fall,2012,Aug,6,0,Wednesday,1,Misty,0.7,0.6667,0.84,0.1642,4,169,173,145,173,173
13923,2012-08-08,Fall,2012,Aug,7,0,Wednesday,1,Misty,0.7,0.6667,0.84,0.1642,24,458,482,145,482,482
13924,2012-08-08,Fall,2012,Aug,8,0,Wednesday,1,Misty,0.74,0.7273,0.72,0.0896,48,689,737,145,737,737
13925,2012-08-08,Fall,2012,Aug,9,0,Wednesday,1,Misty,0.76,0.7273,0.66,0.0,33,308,341,145,341,341
13926,2012-08-08,Fall,2012,Aug,10,0,Wednesday,1,Misty,0.8,0.7424,0.52,0.1343,63,151,214,145,214,214
13927,2012-08-08,Fall,2012,Aug,11,0,Wednesday,1,Misty,0.8,0.7424,0.52,0.0,80,159,239,145,239,239
13928,2012-08-08,Fall,2012,Aug,12,0,Wednesday,1,Misty,0.8,0.7424,0.52,0.0,63,217,280,145,280,280
13929,2012-08-08,Fall,2012,Aug,13,0,Wednesday,1,Misty,0.8,0.7424,0.52,0.0,101,212,313,145,313,313
13930,2012-08-08,Fall,2012,Aug,14,0,Wednesday,1,Misty,0.8,0.7424,0.52,0.2537,63,173,236,145,236,236
13931,2012-08-08,Fall,2012,Aug,15,0,Wednesday,1,Misty,0.84,0.7576,0.44,0.194,110,168,278,145,278,278
13932,2012-08-08,Fall,2012,Aug,16,0,Wednesday,1,Misty,0.8,0.7424,0.49,0.2836,113,328,441,145,441,441
13933,2012-08-08,Fall,2012,Aug,17,0,Wednesday,1,Misty,0.8,0.7576,0.55,0.2836,107,751,858,145,858,858
13934,2012-08-08,Fall,2012,Aug,18,0,Wednesday,1,Misty,0.78,0.7273,0.55,0.1642,117,745,862,145,862,862
13935,2012-08-08,Fall,2012,Aug,19,0,Wednesday,1,Clear,0.76,0.7273,0.66,0.2239,119,567,686,145,686,686
13936,2012-08-08,Fall,2012,Aug,20,0,Wednesday,1,Clear,0.74,0.697,0.66,0.194,76,424,500,145,500,500
13937,2012-08-08,Fall,2012,Aug,21,0,Wednesday,1,Clear,0.74,0.697,0.66,0.1045,70,311,381,145,381,381
13938,2012-08-08,Fall,2012,Aug,22,0,Wednesday,1,Clear,0.72,0.697,0.74,0.1045,35,198,233,145,233,233
13939,2012-08-08,Fall,2012,Aug,23,0,Wednesday,1,Clear,0.72,0.6818,0.7,0.1343,16,120,136,145,136,136
13940,2012-08-09,Fall,2012,Aug,0,0,Thursday,1,Clear,0.72,0.697,0.74,0.194,16,51,67,144,67,67
13941,2012-08-09,Fall,2012,Aug,1,0,Thursday,1,Clear,0.7,0.6667,0.79,0.1343,5,23,28,144,28,28
13942,2012-08-09,Fall,2012,Aug,2,0,Thursday,1,Clear,0.7,0.6667,0.84,0.0896,2,12,14,144,14,14
13943,2012-08-09,Fall,2012,Aug,3,0,Thursday,1,Clear,0.68,0.6364,0.83,0.0896,1,5,6,144,6,6
13944,2012-08-09,Fall,2012,Aug,4,0,Thursday,1,Misty,0.68,0.6364,0.89,0.1343,0,10,10,144,10,10
13945,2012-08-09,Fall,2012,Aug,5,0,Thursday,1,Misty,0.66,0.5909,0.94,0.0,4,37,41,144,41,41
13946,2012-08-09,Fall,2012,Aug,6,0,Thursday,1,Clear,0.66,0.6061,0.83,0.1642,5,162,167,144,167,167
13947,2012-08-09,Fall,2012,Aug,7,0,Thursday,1,Misty,0.7,0.6667,0.84,0.1642,24,451,475,144,475,475
13948,2012-08-09,Fall,2012,Aug,8,0,Thursday,1,Clear,0.72,0.697,0.74,0.1045,28,670,698,144,698,698
13949,2012-08-09,Fall,2012,Aug,9,0,Thursday,1,Clear,0.76,0.7273,0.66,0.1642,54,299,353,144,353,353
13950,2012-08-09,Fall,2012,Aug,10,0,Thursday,1,Clear,0.8,0.7576,0.55,0.2239,72,133,205,144,205,205
13951,2012-08-09,Fall,2012,Aug,11,0,Thursday,1,Clear,0.84,0.7576,0.44,0.0,94,166,260,144,260,260
13952,2012-08-09,Fall,2012,Aug,12,0,Thursday,1,Clear,0.84,0.7576,0.44,0.1045,85,192,277,144,277,277
13953,2012-08-09,Fall,2012,Aug,13,0,Thursday,1,Clear,0.86,0.7879,0.41,0.1045,80,201,281,144,281,281
13954,2012-08-09,Fall,2012,Aug,14,0,Thursday,1,Clear,0.88,0.7727,0.32,0.2239,86,161,247,144,247,247
13955,2012-08-09,Fall,2012,Aug,15,0,Thursday,1,Clear,0.88,0.7727,0.32,0.2239,63,204,267,144,267,267
13956,2012-08-09,Fall,2012,Aug,16,0,Thursday,1,Clear,0.86,0.7727,0.39,0.2537,97,320,417,144,417,417
13957,2012-08-09,Fall,2012,Aug,17,0,Thursday,1,Clear,0.86,0.7576,0.36,0.2537,111,699,810,144,810,810
13958,2012-08-09,Fall,2012,Aug,18,0,Thursday,1,Misty,0.82,0.7576,0.46,0.2537,78,733,811,144,811,811
13959,2012-08-09,Fall,2012,Aug,19,0,Thursday,1,Clear,0.8,0.7576,0.55,0.194,90,533,623,144,623,623
13960,2012-08-09,Fall,2012,Aug,20,0,Thursday,1,Clear,0.7,0.6515,0.54,0.2836,91,387,478,144,478,478
13961,2012-08-09,Fall,2012,Aug,21,0,Thursday,1,Misty,0.7,0.6515,0.58,0.1642,50,286,336,144,336,336
13962,2012-08-09,Fall,2012,Aug,22,0,Thursday,1,Misty,0.66,0.6212,0.69,0.2239,41,218,259,144,259,259
13963,2012-08-09,Fall,2012,Aug,23,0,Thursday,1,Clear,0.66,0.6212,0.74,0.0,19,137,156,144,156,156
13964,2012-08-10,Fall,2012,Aug,0,0,Friday,1,Clear,0.7,0.6515,0.65,0.0896,17,68,85,143,85,85
13965,2012-08-10,Fall,2012,Aug,1,0,Friday,1,Clear,0.7,0.6515,0.65,0.1045,6,35,41,143,41,41
13966,2012-08-10,Fall,2012,Aug,2,0,Friday,1,Clear,0.7,0.6667,0.74,0.1642,6,14,20,143,20,20
13967,2012-08-10,Fall,2012,Aug,3,0,Friday,1,Misty,0.72,0.697,0.79,0.194,3,6,9,143,9,9
13968,2012-08-10,Fall,2012,Aug,4,0,Friday,1,Light_rainsnow,0.7,0.6667,0.84,0.2836,0,7,7,143,7,7
13969,2012-08-10,Fall,2012,Aug,5,0,Friday,1,Light_rainsnow,0.7,0.6667,0.84,0.2836,4,29,33,143,33,33
13970,2012-08-10,Fall,2012,Aug,6,0,Friday,1,Light_rainsnow,0.64,0.5758,0.89,0.2985,3,41,44,143,44,44
13971,2012-08-10,Fall,2012,Aug,7,0,Friday,1,Light_rainsnow,0.64,0.5758,0.89,0.1045,5,128,133,143,133,133
13972,2012-08-10,Fall,2012,Aug,8,0,Friday,1,Light_rainsnow,0.62,0.5455,0.91,0.1642,7,112,119,143,119,119
13973,2012-08-10,Fall,2012,Aug,9,0,Friday,1,Misty,0.64,0.5758,0.89,0.0,21,199,220,143,220,220
13974,2012-08-10,Fall,2012,Aug,10,0,Friday,1,Clear,0.66,0.5909,0.89,0.1045,27,166,193,143,193,193
13975,2012-08-10,Fall,2012,Aug,11,0,Friday,1,Light_rainsnow,0.68,0.6364,0.79,0.1343,73,178,251,143,251,251
13976,2012-08-10,Fall,2012,Aug,12,0,Friday,1,Misty,0.74,0.697,0.66,0.3582,75,240,315,143,315,315
13977,2012-08-10,Fall,2012,Aug,13,0,Friday,1,Misty,0.76,0.7121,0.58,0.3582,66,224,290,143,290,290
13978,2012-08-10,Fall,2012,Aug,14,0,Friday,1,Clear,0.76,0.7121,0.58,0.3582,71,236,307,143,307,307
13979,2012-08-10,Fall,2012,Aug,15,0,Friday,1,Clear,0.8,0.7424,0.52,0.4478,100,224,324,143,324,324
13980,2012-08-10,Fall,2012,Aug,16,0,Friday,1,Clear,0.78,0.7273,0.55,0.2985,96,371,467,143,467,467
13981,2012-08-10,Fall,2012,Aug,17,0,Friday,1,Clear,0.8,0.7424,0.52,0.2836,111,619,730,143,730,730
13982,2012-08-10,Fall,2012,Aug,18,0,Friday,1,Clear,0.76,0.7121,0.62,0.2985,88,552,640,143,640,640
13983,2012-08-10,Fall,2012,Aug,19,0,Friday,1,Clear,0.76,0.7121,0.62,0.2836,98,394,492,143,492,492
13984,2012-08-10,Fall,2012,Aug,20,0,Friday,1,Clear,0.74,0.697,0.66,0.2985,55,315,370,143,370,370
13985,2012-08-10,Fall,2012,Aug,21,0,Friday,1,Clear,0.74,0.697,0.66,0.2537,50,236,286,143,286,286
13986,2012-08-10,Fall,2012,Aug,22,0,Friday,1,Clear,0.72,0.697,0.74,0.2836,50,168,218,143,218,218
13987,2012-08-10,Fall,2012,Aug,23,0,Friday,1,Clear,0.72,0.6818,0.7,0.2836,33,159,192,143,192,192
13988,2012-08-11,Fall,2012,Aug,0,0,Saturday,0,Clear,0.7,0.6515,0.7,0.2836,38,142,180,142,180,180
13989,2012-08-11,Fall,2012,Aug,1,0,Saturday,0,Clear,0.66,0.6212,0.74,0.2239,32,84,116,142,116,116
13990,2012-08-11,Fall,2012,Aug,2,0,Saturday,0,Light_rainsnow,0.64,0.5909,0.78,0.194,19,66,85,142,85,85
13991,2012-08-11,Fall,2012,Aug,3,0,Saturday,0,Light_rainsnow,0.62,0.5758,0.83,0.1642,2,19,21,142,21,21
13992,2012-08-11,Fall,2012,Aug,4,0,Saturday,0,Clear,0.62,0.5758,0.83,0.1045,3,7,10,142,10,10
13993,2012-08-11,Fall,2012,Aug,5,0,Saturday,0,Clear,0.62,0.5606,0.88,0.1045,2,9,11,142,11,11
13994,2012-08-11,Fall,2012,Aug,6,0,Saturday,0,Misty,0.62,0.5606,0.88,0.1045,5,18,23,142,23,23
13995,2012-08-11,Fall,2012,Aug,7,0,Saturday,0,Clear,0.64,0.5758,0.83,0.0896,8,54,62,142,62,62
13996,2012-08-11,Fall,2012,Aug,8,0,Saturday,0,Clear,0.66,0.6061,0.83,0.1045,30,132,162,142,162,162
13997,2012-08-11,Fall,2012,Aug,9,0,Saturday,0,Clear,0.68,0.6364,0.79,0.194,54,217,271,142,271,271
13998,2012-08-11,Fall,2012,Aug,10,0,Saturday,0,Clear,0.72,0.6818,0.62,0.0896,125,282,407,142,407,407
13999,2012-08-11,Fall,2012,Aug,11,0,Saturday,0,Clear,0.74,0.697,0.66,0.1642,203,296,499,142,499,499
14000,2012-08-11,Fall,2012,Aug,12,0,Saturday,0,Clear,0.76,0.7121,0.58,0.2239,214,332,546,142,546,546
14001,2012-08-11,Fall,2012,Aug,13,0,Saturday,0,Clear,0.8,0.7424,0.49,0.3582,228,341,569,142,569,569
14002,2012-08-11,Fall,2012,Aug,14,0,Saturday,0,Clear,0.8,0.7424,0.49,0.2985,248,290,538,142,538,538
14003,2012-08-11,Fall,2012,Aug,15,0,Saturday,0,Clear,0.8,0.7273,0.46,0.2836,246,316,562,142,562,562
14004,2012-08-11,Fall,2012,Aug,16,0,Saturday,0,Clear,0.8,0.7273,0.46,0.2985,227,304,531,142,531,531
14005,2012-08-11,Fall,2012,Aug,17,0,Saturday,0,Light_rainsnow,0.74,0.697,0.66,0.3582,220,292,512,142,512,512
14006,2012-08-11,Fall,2012,Aug,18,0,Saturday,0,Misty,0.7,0.6667,0.74,0.2985,107,193,300,142,300,300
14007,2012-08-11,Fall,2012,Aug,19,0,Saturday,0,Misty,0.66,0.5909,0.89,0.1045,97,178,275,142,275,275
14008,2012-08-11,Fall,2012,Aug,20,0,Saturday,0,Light_rainsnow,0.66,0.5909,0.89,0.4179,31,129,160,142,160,160
14009,2012-08-11,Fall,2012,Aug,21,0,Saturday,0,Misty,0.66,0.5909,0.89,0.1642,26,102,128,142,128,128
14010,2012-08-11,Fall,2012,Aug,22,0,Saturday,0,Misty,0.66,0.5909,0.89,0.1642,40,128,168,142,168,168
14011,2012-08-11,Fall,2012,Aug,23,0,Saturday,0,Light_rainsnow,0.66,0.6061,0.78,0.1642,42,121,163,142,163,163
14012,2012-08-12,Fall,2012,Aug,0,0,Sunday,0,Misty,0.64,0.6061,0.73,0.1343,24,96,120,141,120,120
14013,2012-08-12,Fall,2012,Aug,1,0,Sunday,0,Clear,0.62,0.5909,0.78,0.1343,21,92,113,141,113,113
14014,2012-08-12,Fall,2012,Aug,2,0,Sunday,0,Clear,0.64,0.6061,0.69,0.1343,19,67,86,141,86,86
14015,2012-08-12,Fall,2012,Aug,3,0,Sunday,0,Clear,0.62,0.5909,0.73,0.0896,11,37,48,141,48,48
14016,2012-08-12,Fall,2012,Aug,4,0,Sunday,0,Clear,0.64,0.6061,0.69,0.0896,2,8,10,141,10,10
14017,2012-08-12,Fall,2012,Aug,5,0,Sunday,0,Clear,0.64,0.6212,0.61,0.194,1,9,10,141,10,10
14018,2012-08-12,Fall,2012,Aug,6,0,Sunday,0,Clear,0.64,0.6061,0.65,0.1642,2,14,16,141,16,16
14019,2012-08-12,Fall,2012,Aug,7,0,Sunday,0,Clear,0.64,0.6061,0.65,0.1343,9,30,39,141,39,39
14020,2012-08-12,Fall,2012,Aug,8,0,Sunday,0,Clear,0.66,0.6212,0.54,0.2239,35,84,119,141,119,119
14021,2012-08-12,Fall,2012,Aug,9,0,Sunday,0,Clear,0.7,0.6515,0.48,0.2239,64,153,217,141,217,217
14022,2012-08-12,Fall,2012,Aug,10,0,Sunday,0,Clear,0.7,0.6515,0.51,0.1642,88,240,328,141,328,328
14023,2012-08-12,Fall,2012,Aug,11,0,Sunday,0,Clear,0.74,0.6667,0.42,0.1642,167,282,449,141,449,449
14024,2012-08-12,Fall,2012,Aug,12,0,Sunday,0,Clear,0.74,0.6667,0.42,0.194,163,342,505,141,505,505
14025,2012-08-12,Fall,2012,Aug,13,0,Sunday,0,Clear,0.78,0.697,0.4,0.0,178,365,543,141,543,543
14026,2012-08-12,Fall,2012,Aug,14,0,Sunday,0,Clear,0.76,0.6818,0.4,0.194,213,366,579,141,579,579
14027,2012-08-12,Fall,2012,Aug,15,0,Sunday,0,Clear,0.76,0.6818,0.4,0.1343,235,342,577,141,577,577
14028,2012-08-12,Fall,2012,Aug,16,0,Sunday,0,Clear,0.76,0.6818,0.4,0.1045,213,300,513,141,513,513
14029,2012-08-12,Fall,2012,Aug,17,0,Sunday,0,Clear,0.8,0.697,0.33,0.0,186,319,505,141,505,505
14030,2012-08-12,Fall,2012,Aug,18,0,Sunday,0,Clear,0.78,0.6818,0.35,0.1045,164,327,491,141,491,491
14031,2012-08-12,Fall,2012,Aug,19,0,Sunday,0,Clear,0.74,0.6515,0.4,0.1343,148,317,465,141,465,465
14032,2012-08-12,Fall,2012,Aug,20,0,Sunday,0,Clear,0.72,0.6515,0.45,0.0,96,204,300,141,300,300
14033,2012-08-12,Fall,2012,Aug,21,0,Sunday,0,Clear,0.72,0.6667,0.51,0.0896,78,142,220,141,220,220
14034,2012-08-12,Fall,2012,Aug,22,0,Sunday,0,Clear,0.7,0.6515,0.58,0.1343,40,141,181,141,181,181
14035,2012-08-12,Fall,2012,Aug,23,0,Sunday,0,Clear,0.68,0.6364,0.61,0.0,25,85,110,141,110,110
14036,2012-08-13,Fall,2012,Aug,0,0,Monday,1,Clear,0.66,0.6212,0.65,0.1045,14,33,47,140,47,47
14037,2012-08-13,Fall,2012,Aug,1,0,Monday,1,Clear,0.66,0.6212,0.65,0.0896,3,11,14,140,14,14
14038,2012-08-13,Fall,2012,Aug,2,0,Monday,1,Clear,0.64,0.6061,0.69,0.1045,1,8,9,140,9,9
14039,2012-08-13,Fall,2012,Aug,3,0,Monday,1,Clear,0.64,0.6061,0.69,0.0,1,5,6,140,6,6
14040,2012-08-13,Fall,2012,Aug,4,0,Monday,1,Clear,0.64,0.6061,0.69,0.1045,0,11,11,140,11,11
14041,2012-08-13,Fall,2012,Aug,5,0,Monday,1,Clear,0.64,0.6061,0.69,0.1045,3,33,36,140,36,36
14042,2012-08-13,Fall,2012,Aug,6,0,Monday,1,Clear,0.62,0.5909,0.73,0.0896,4,155,159,140,159,159
14043,2012-08-13,Fall,2012,Aug,7,0,Monday,1,Clear,0.66,0.6212,0.65,0.1343,11,425,436,140,436,436
14044,2012-08-13,Fall,2012,Aug,8,0,Monday,1,Misty,0.72,0.6667,0.51,0.0896,25,648,673,140,673,673
14045,2012-08-13,Fall,2012,Aug,9,0,Monday,1,Misty,0.74,0.6667,0.45,0.0,40,265,305,140,305,305
14046,2012-08-13,Fall,2012,Aug,10,0,Monday,1,Misty,0.76,0.6818,0.4,0.0,88,111,199,140,199,199
14047,2012-08-13,Fall,2012,Aug,11,0,Monday,1,Clear,0.76,0.6818,0.4,0.0896,94,151,245,140,245,245
14048,2012-08-13,Fall,2012,Aug,12,0,Monday,1,Clear,0.78,0.697,0.4,0.194,96,180,276,140,276,276
14049,2012-08-13,Fall,2012,Aug,13,0,Monday,1,Clear,0.78,0.697,0.4,0.1642,79,175,254,140,254,254
14050,2012-08-13,Fall,2012,Aug,14,0,Monday,1,Clear,0.8,0.697,0.33,0.1045,85,163,248,140,248,248
14051,2012-08-13,Fall,2012,Aug,15,0,Monday,1,Clear,0.82,0.7273,0.34,0.2239,80,194,274,140,274,274
14052,2012-08-13,Fall,2012,Aug,16,0,Monday,1,Clear,0.8,0.7121,0.36,0.0896,116,348,464,140,464,464
14053,2012-08-13,Fall,2012,Aug,17,0,Monday,1,Clear,0.8,0.7121,0.36,0.1642,102,716,818,140,818,818
14054,2012-08-13,Fall,2012,Aug,18,0,Monday,1,Clear,0.76,0.697,0.52,0.2836,103,709,812,140,812,812
14055,2012-08-13,Fall,2012,Aug,19,0,Monday,1,Clear,0.74,0.6818,0.58,0.1642,88,467,555,140,555,555
14056,2012-08-13,Fall,2012,Aug,20,0,Monday,1,Clear,0.74,0.6818,0.62,0.2239,58,374,432,140,432,432
14057,2012-08-13,Fall,2012,Aug,21,0,Monday,1,Clear,0.72,0.6818,0.66,0.194,44,246,290,140,290,290
14058,2012-08-13,Fall,2012,Aug,22,0,Monday,1,Clear,0.72,0.6818,0.62,0.3284,44,148,192,140,192,192
14059,2012-08-13,Fall,2012,Aug,23,0,Monday,1,Clear,0.7,0.6515,0.7,0.2239,28,100,128,140,128,128
14060,2012-08-14,Fall,2012,Aug,0,0,Tuesday,1,Clear,0.7,0.6667,0.74,0.2239,12,48,60,139,60,60
14061,2012-08-14,Fall,2012,Aug,1,0,Tuesday,1,Clear,0.68,0.6364,0.79,0.2537,8,19,27,139,27,27
14062,2012-08-14,Fall,2012,Aug,2,0,Tuesday,1,Misty,0.68,0.6364,0.83,0.194,2,9,11,139,11,11
14063,2012-08-14,Fall,2012,Aug,3,0,Tuesday,1,Misty,0.68,0.6364,0.83,0.194,0,3,3,139,3,3
14064,2012-08-14,Fall,2012,Aug,4,0,Tuesday,1,Misty,0.68,0.6364,0.83,0.194,0,5,5,139,5,5
14065,2012-08-14,Fall,2012,Aug,5,0,Tuesday,1,Misty,0.68,0.6364,0.89,0.194,1,35,36,139,36,36
14066,2012-08-14,Fall,2012,Aug,6,0,Tuesday,1,Light_rainsnow,0.64,0.5758,0.83,0.194,1,63,64,139,64,64
14067,2012-08-14,Fall,2012,Aug,7,0,Tuesday,1,Misty,0.66,0.6061,0.83,0.0896,1,178,179,139,179,179
14068,2012-08-14,Fall,2012,Aug,8,0,Tuesday,1,Misty,0.66,0.5909,0.89,0.0896,27,591,618,139,618,618
14069,2012-08-14,Fall,2012,Aug,9,0,Tuesday,1,Misty,0.7,0.6667,0.74,0.0,48,354,402,139,402,402
14070,2012-08-14,Fall,2012,Aug,10,0,Tuesday,1,Clear,0.7,0.6667,0.79,0.1045,53,155,208,139,208,208
14071,2012-08-14,Fall,2012,Aug,11,0,Tuesday,1,Clear,0.74,0.6818,0.62,0.0,69,127,196,139,196,196
14072,2012-08-14,Fall,2012,Aug,12,0,Tuesday,1,Clear,0.78,0.7121,0.49,0.1343,93,207,300,139,300,300
14073,2012-08-14,Fall,2012,Aug,13,0,Tuesday,1,Clear,0.8,0.7273,0.46,0.0896,83,203,286,139,286,286
14074,2012-08-14,Fall,2012,Aug,14,0,Tuesday,1,Clear,0.82,0.7424,0.41,0.2239,80,175,255,139,255,255
14075,2012-08-14,Fall,2012,Aug,15,0,Tuesday,1,Clear,0.82,0.7576,0.46,0.2239,84,199,283,139,283,283
14076,2012-08-14,Fall,2012,Aug,16,0,Tuesday,1,Clear,0.82,0.7424,0.43,0.2239,95,363,458,139,458,458
14077,2012-08-14,Fall,2012,Aug,17,0,Tuesday,1,Light_rainsnow,0.76,0.7273,0.66,0.2537,78,734,812,139,812,812
14078,2012-08-14,Fall,2012,Aug,18,0,Tuesday,1,Clear,0.76,0.7121,0.62,0.2836,97,757,854,139,854,854
14079,2012-08-14,Fall,2012,Aug,19,0,Tuesday,1,Clear,0.76,0.7273,0.66,0.194,94,533,627,139,627,627
14080,2012-08-14,Fall,2012,Aug,20,0,Tuesday,1,Clear,0.74,0.7121,0.74,0.2239,65,371,436,139,436,436
14081,2012-08-14,Fall,2012,Aug,21,0,Tuesday,1,Clear,0.74,0.6818,0.62,0.2239,56,252,308,139,308,308
14082,2012-08-14,Fall,2012,Aug,22,0,Tuesday,1,Clear,0.72,0.6818,0.66,0.0896,28,161,189,139,189,189
14083,2012-08-14,Fall,2012,Aug,23,0,Tuesday,1,Clear,0.72,0.6818,0.66,0.1642,53,114,167,139,167,167
14084,2012-08-15,Fall,2012,Aug,0,0,Wednesday,1,Clear,0.7,0.6515,0.61,0.194,8,52,60,138,60,60
14085,2012-08-15,Fall,2012,Aug,1,0,Wednesday,1,Clear,0.7,0.6515,0.61,0.0,6,31,37,138,37,37
14086,2012-08-15,Fall,2012,Aug,2,0,Wednesday,1,Clear,0.68,0.6364,0.65,0.0,1,7,8,138,8,8
14087,2012-08-15,Fall,2012,Aug,3,0,Wednesday,1,Clear,0.66,0.6212,0.74,0.1045,1,10,11,138,11,11
14088,2012-08-15,Fall,2012,Aug,4,0,Wednesday,1,Clear,0.64,0.5758,0.83,0.1045,0,4,4,138,4,4
14089,2012-08-15,Fall,2012,Aug,5,0,Wednesday,1,Clear,0.64,0.5909,0.78,0.1045,4,35,39,138,39,39
14090,2012-08-15,Fall,2012,Aug,6,0,Wednesday,1,Clear,0.64,0.5909,0.78,0.1045,12,160,172,138,172,172
14091,2012-08-15,Fall,2012,Aug,7,0,Wednesday,1,Misty,0.66,0.6212,0.69,0.194,25,467,492,138,492,492
14092,2012-08-15,Fall,2012,Aug,8,0,Wednesday,1,Misty,0.7,0.6515,0.65,0.2836,40,642,682,138,682,682
14093,2012-08-15,Fall,2012,Aug,9,0,Wednesday,1,Misty,0.72,0.6818,0.62,0.194,57,310,367,138,367,367
14094,2012-08-15,Fall,2012,Aug,10,0,Wednesday,1,Misty,0.72,0.6818,0.62,0.194,70,163,233,138,233,233
14095,2012-08-15,Fall,2012,Aug,11,0,Wednesday,1,Misty,0.74,0.6818,0.58,0.194,80,155,235,138,235,235
14096,2012-08-15,Fall,2012,Aug,12,0,Wednesday,1,Clear,0.74,0.6818,0.55,0.2239,77,230,307,138,307,307
14097,2012-08-15,Fall,2012,Aug,13,0,Wednesday,1,Misty,0.78,0.7121,0.49,0.194,88,206,294,138,294,294
14098,2012-08-15,Fall,2012,Aug,14,0,Wednesday,1,Misty,0.76,0.697,0.52,0.2985,94,161,255,138,255,255
14099,2012-08-15,Fall,2012,Aug,15,0,Wednesday,1,Clear,0.76,0.697,0.52,0.2537,70,196,266,138,266,266
14100,2012-08-15,Fall,2012,Aug,16,0,Wednesday,1,Clear,0.76,0.6818,0.48,0.194,91,340,431,138,431,431
14101,2012-08-15,Fall,2012,Aug,17,0,Wednesday,1,Clear,0.74,0.6818,0.55,0.2836,102,749,851,138,851,851
14102,2012-08-15,Fall,2012,Aug,18,0,Wednesday,1,Clear,0.74,0.6667,0.51,0.2239,80,768,848,138,848,848
14103,2012-08-15,Fall,2012,Aug,19,0,Wednesday,1,Clear,0.7,0.6515,0.61,0.1343,124,525,649,138,649,649
14104,2012-08-15,Fall,2012,Aug,20,0,Wednesday,1,Clear,0.7,0.6515,0.61,0.1343,72,355,427,138,427,427
14105,2012-08-15,Fall,2012,Aug,21,0,Wednesday,1,Clear,0.7,0.6515,0.61,0.194,49,266,315,138,315,315
14106,2012-08-15,Fall,2012,Aug,22,0,Wednesday,1,Clear,0.7,0.6515,0.61,0.1642,29,197,226,138,226,226
14107,2012-08-15,Fall,2012,Aug,23,0,Wednesday,1,Clear,0.68,0.6364,0.65,0.1045,18,120,138,138,138,138
14108,2012-08-16,Fall,2012,Aug,0,0,Thursday,1,Clear,0.66,0.6212,0.69,0.0,13,63,76,137,76,76
14109,2012-08-16,Fall,2012,Aug,1,0,Thursday,1,Clear,0.64,0.6061,0.73,0.0,3,18,21,137,21,21
14110,2012-08-16,Fall,2012,Aug,2,0,Thursday,1,Clear,0.64,0.6061,0.69,0.194,0,15,15,137,15,15
14111,2012-08-16,Fall,2012,Aug,3,0,Thursday,1,Clear,0.62,0.5909,0.73,0.2537,0,4,4,137,4,4
14112,2012-08-16,Fall,2012,Aug,4,0,Thursday,1,Clear,0.62,0.5909,0.73,0.2239,2,3,5,137,5,5
14113,2012-08-16,Fall,2012,Aug,5,0,Thursday,1,Clear,0.6,0.5758,0.78,0.1642,7,30,37,137,37,37
14114,2012-08-16,Fall,2012,Aug,6,0,Thursday,1,Clear,0.6,0.5758,0.78,0.1642,3,162,165,137,165,165
14115,2012-08-16,Fall,2012,Aug,7,0,Thursday,1,Clear,0.64,0.6061,0.69,0.2239,16,448,464,137,464,464
14116,2012-08-16,Fall,2012,Aug,8,0,Thursday,1,Clear,0.68,0.6364,0.61,0.194,33,649,682,137,682,682
14117,2012-08-16,Fall,2012,Aug,9,0,Thursday,1,Clear,0.72,0.6667,0.54,0.1045,41,296,337,137,337,337
14118,2012-08-16,Fall,2012,Aug,10,0,Thursday,1,Clear,0.74,0.6667,0.48,0.1343,78,121,199,137,199,199
14119,2012-08-16,Fall,2012,Aug,11,0,Thursday,1,Clear,0.76,0.6667,0.37,0.0896,83,191,274,137,274,274
14120,2012-08-16,Fall,2012,Aug,12,0,Thursday,1,Clear,0.8,0.697,0.33,0.1045,96,247,343,137,343,343
14121,2012-08-16,Fall,2012,Aug,13,0,Thursday,1,Clear,0.8,0.697,0.31,0.2239,81,219,300,137,300,300
14122,2012-08-16,Fall,2012,Aug,14,0,Thursday,1,Clear,0.82,0.7121,0.32,0.0,72,176,248,137,248,248
14123,2012-08-16,Fall,2012,Aug,15,0,Thursday,1,Clear,0.8,0.697,0.33,0.2537,63,197,260,137,260,260
14124,2012-08-16,Fall,2012,Aug,16,0,Thursday,1,Clear,0.82,0.7121,0.32,0.2239,79,340,419,137,419,419
14125,2012-08-16,Fall,2012,Aug,17,0,Thursday,1,Clear,0.82,0.7273,0.34,0.194,130,767,897,137,897,897
14126,2012-08-16,Fall,2012,Aug,18,0,Thursday,1,Clear,0.8,0.7121,0.36,0.0,109,723,832,137,832,832
14127,2012-08-16,Fall,2012,Aug,19,0,Thursday,1,Clear,0.76,0.6818,0.4,0.1045,119,558,677,137,677,677
14128,2012-08-16,Fall,2012,Aug,20,0,Thursday,1,Clear,0.76,0.6818,0.4,0.0896,100,414,514,137,514,514
14129,2012-08-16,Fall,2012,Aug,21,0,Thursday,1,Clear,0.74,0.6667,0.48,0.194,83,273,356,137,356,356
14130,2012-08-16,Fall,2012,Aug,22,0,Thursday,1,Clear,0.72,0.6667,0.51,0.1642,69,185,254,137,254,254
14131,2012-08-16,Fall,2012,Aug,23,0,Thursday,1,Clear,0.7,0.6515,0.54,0.1045,58,168,226,137,226,226
14132,2012-08-17,Fall,2012,Aug,0,0,Friday,1,Clear,0.68,0.2424,0.57,0.1642,21,67,88,136,88,88
14133,2012-08-17,Fall,2012,Aug,1,0,Friday,1,Clear,0.66,0.2424,0.65,0.1045,16,38,54,136,54,54
14134,2012-08-17,Fall,2012,Aug,2,0,Friday,1,Clear,0.66,0.2424,0.61,0.1343,4,15,19,136,19,19
14135,2012-08-17,Fall,2012,Aug,3,0,Friday,1,Clear,0.64,0.2424,0.65,0.1045,0,6,6,136,6,6
14136,2012-08-17,Fall,2012,Aug,4,0,Friday,1,Clear,0.64,0.2424,0.73,0.1642,0,9,9,136,9,9
14137,2012-08-17,Fall,2012,Aug,5,0,Friday,1,Clear,0.64,0.2424,0.73,0.1045,2,34,36,136,36,36
14138,2012-08-17,Fall,2012,Aug,6,0,Friday,1,Clear,0.62,0.2424,0.78,0.1343,6,151,157,136,157,157
14139,2012-08-17,Fall,2012,Aug,7,0,Friday,1,Clear,0.64,0.2424,0.73,0.1045,11,368,379,136,379,379
14140,2012-08-17,Fall,2012,Aug,8,0,Friday,1,Clear,0.68,0.2424,0.65,0.1343,43,625,668,136,668,668
14141,2012-08-17,Fall,2012,Aug,9,0,Friday,1,Clear,0.7,0.2424,0.58,0.1045,58,320,378,136,378,378
14142,2012-08-17,Fall,2012,Aug,10,0,Friday,1,Clear,0.74,0.2424,0.55,0.1642,82,149,231,136,231,231
14143,2012-08-17,Fall,2012,Aug,11,0,Friday,1,Clear,0.76,0.2424,0.52,0.2836,98,205,303,136,303,303
14144,2012-08-17,Fall,2012,Aug,12,0,Friday,1,Clear,0.82,0.2424,0.41,0.2239,110,255,365,136,365,365
14145,2012-08-17,Fall,2012,Aug,13,0,Friday,1,Clear,0.84,0.2424,0.36,0.3881,103,254,357,136,357,357
14146,2012-08-17,Fall,2012,Aug,14,0,Friday,1,Clear,0.86,0.2424,0.34,0.4179,128,200,328,136,328,328
14147,2012-08-17,Fall,2012,Aug,15,0,Friday,1,Clear,0.86,0.2424,0.3,0.4627,127,256,383,136,383,383
14148,2012-08-17,Fall,2012,Aug,16,0,Friday,1,Misty,0.84,0.2424,0.32,0.4478,116,372,488,136,488,488
14149,2012-08-17,Fall,2012,Aug,17,0,Friday,1,Clear,0.82,0.2424,0.36,0.3284,144,647,791,136,791,791
14150,2012-08-17,Fall,2012,Aug,18,0,Friday,1,Misty,0.82,0.2424,0.38,0.2537,108,561,669,136,669,669
14151,2012-08-17,Fall,2012,Aug,19,0,Friday,1,Misty,0.74,0.2424,0.55,0.3881,88,403,491,136,491,491
14152,2012-08-17,Fall,2012,Aug,20,0,Friday,1,Misty,0.72,0.2424,0.58,0.2239,97,262,359,136,359,359
14153,2012-08-17,Fall,2012,Aug,21,0,Friday,1,Misty,0.68,0.2424,0.69,0.2985,57,198,255,136,255,255
14154,2012-08-17,Fall,2012,Aug,22,0,Friday,1,Light_rainsnow,0.66,0.2424,0.83,0.194,43,170,213,136,213,213
14155,2012-08-17,Fall,2012,Aug,23,0,Friday,1,Light_rainsnow,0.64,0.2424,0.83,0.2239,21,100,121,136,121,121
14156,2012-08-18,Fall,2012,Aug,0,0,Saturday,0,Misty,0.64,0.5758,0.83,0.2239,6,99,105,135,105,105
14157,2012-08-18,Fall,2012,Aug,1,0,Saturday,0,Light_rainsnow,0.62,0.5455,0.94,0.1642,14,78,92,135,92,92
14158,2012-08-18,Fall,2012,Aug,2,0,Saturday,0,Light_rainsnow,0.62,0.5606,0.88,0.1642,4,39,43,135,43,43
14159,2012-08-18,Fall,2012,Aug,3,0,Saturday,0,Clear,0.62,0.5606,0.88,0.194,7,23,30,135,30,30
14160,2012-08-18,Fall,2012,Aug,4,0,Saturday,0,Clear,0.62,0.5909,0.73,0.2239,5,8,13,135,13,13
14161,2012-08-18,Fall,2012,Aug,5,0,Saturday,0,Clear,0.6,0.5758,0.78,0.2537,2,7,9,135,9,9
14162,2012-08-18,Fall,2012,Aug,6,0,Saturday,0,Clear,0.6,0.5606,0.83,0.2239,4,23,27,135,27,27
14163,2012-08-18,Fall,2012,Aug,7,0,Saturday,0,Clear,0.6,0.5606,0.83,0.2239,12,52,64,135,64,64
14164,2012-08-18,Fall,2012,Aug,8,0,Saturday,0,Clear,0.64,0.6061,0.69,0.2537,28,161,189,135,189,189
14165,2012-08-18,Fall,2012,Aug,9,0,Saturday,0,Clear,0.66,0.6212,0.65,0.2836,81,211,292,135,292,292
14166,2012-08-18,Fall,2012,Aug,10,0,Saturday,0,Clear,0.7,0.6515,0.54,0.1642,166,314,480,135,480,480
14167,2012-08-18,Fall,2012,Aug,11,0,Saturday,0,Clear,0.72,0.6667,0.51,0.0,180,356,536,135,536,536
14168,2012-08-18,Fall,2012,Aug,12,0,Saturday,0,Clear,0.76,0.6667,0.37,0.194,266,388,654,135,654,654
14169,2012-08-18,Fall,2012,Aug,13,0,Saturday,0,Clear,0.74,0.6515,0.4,0.194,289,355,644,135,644,644
14170,2012-08-18,Fall,2012,Aug,14,0,Saturday,0,Clear,0.76,0.6667,0.37,0.2836,242,356,598,135,598,598
14171,2012-08-18,Fall,2012,Aug,15,0,Saturday,0,Clear,0.76,0.6667,0.37,0.2239,250,346,596,135,596,596
14172,2012-08-18,Fall,2012,Aug,16,0,Saturday,0,Clear,0.76,0.6667,0.37,0.2537,287,354,641,135,641,641
14173,2012-08-18,Fall,2012,Aug,17,0,Saturday,0,Clear,0.76,0.6667,0.37,0.2239,256,379,635,135,635,635
14174,2012-08-18,Fall,2012,Aug,18,0,Saturday,0,Clear,0.74,0.6515,0.37,0.1642,225,329,554,135,554,554
14175,2012-08-18,Fall,2012,Aug,19,0,Saturday,0,Clear,0.7,0.6364,0.45,0.1642,164,324,488,135,488,488
14176,2012-08-18,Fall,2012,Aug,20,0,Saturday,0,Clear,0.7,0.6364,0.45,0.1045,99,242,341,135,341,341
14177,2012-08-18,Fall,2012,Aug,21,0,Saturday,0,Clear,0.66,0.6212,0.61,0.0,90,248,338,135,338,338
14178,2012-08-18,Fall,2012,Aug,22,0,Saturday,0,Clear,0.66,0.6212,0.61,0.0,90,171,261,135,261,261
14179,2012-08-18,Fall,2012,Aug,23,0,Saturday,0,Clear,0.64,0.6061,0.65,0.0896,60,175,235,135,235,235
14180,2012-08-19,Fall,2012,Aug,0,0,Sunday,0,Clear,0.66,0.6212,0.57,0.0896,44,143,187,134,187,187
14181,2012-08-19,Fall,2012,Aug,1,0,Sunday,0,Clear,0.64,0.6061,0.65,0.0,29,102,131,134,131,131
14182,2012-08-19,Fall,2012,Aug,2,0,Sunday,0,Misty,0.62,0.6061,0.69,0.0896,16,103,119,134,119,119
14183,2012-08-19,Fall,2012,Aug,3,0,Sunday,0,Misty,0.62,0.6061,0.61,0.1642,21,34,55,134,55,55
14184,2012-08-19,Fall,2012,Aug,4,0,Sunday,0,Misty,0.62,0.6061,0.65,0.1642,4,22,26,134,26,26
14185,2012-08-19,Fall,2012,Aug,5,0,Sunday,0,Misty,0.6,0.5909,0.73,0.1343,3,8,11,134,11,11
14186,2012-08-19,Fall,2012,Aug,6,0,Sunday,0,Misty,0.62,0.6061,0.69,0.1045,5,15,20,134,20,20
14187,2012-08-19,Fall,2012,Aug,7,0,Sunday,0,Misty,0.62,0.6061,0.69,0.1343,12,29,41,134,41,41
14188,2012-08-19,Fall,2012,Aug,8,0,Sunday,0,Misty,0.64,0.6061,0.69,0.1045,34,90,124,134,124,124
14189,2012-08-19,Fall,2012,Aug,9,0,Sunday,0,Misty,0.66,0.6212,0.74,0.0,86,184,270,134,270,270
14190,2012-08-19,Fall,2012,Aug,10,0,Sunday,0,Misty,0.68,0.6364,0.69,0.0,138,287,425,134,425,425
14191,2012-08-19,Fall,2012,Aug,11,0,Sunday,0,Light_rainsnow,0.64,0.5909,0.78,0.1642,83,189,272,134,272,272
14192,2012-08-19,Fall,2012,Aug,12,0,Sunday,0,Light_rainsnow,0.64,0.6061,0.73,0.0,112,186,298,134,298,298
14193,2012-08-19,Fall,2012,Aug,13,0,Sunday,0,Light_rainsnow,0.64,0.5758,0.83,0.1343,50,112,162,134,162,162
14194,2012-08-19,Fall,2012,Aug,14,0,Sunday,0,Light_rainsnow,0.64,0.6061,0.73,0.0,41,108,149,134,149,149
14195,2012-08-19,Fall,2012,Aug,15,0,Sunday,0,Misty,0.64,0.6061,0.65,0.0,89,187,276,134,276,276
14196,2012-08-19,Fall,2012,Aug,16,0,Sunday,0,Misty,0.66,0.6212,0.65,0.0,97,259,356,134,356,356
14197,2012-08-19,Fall,2012,Aug,17,0,Sunday,0,Misty,0.64,0.5909,0.78,0.1045,76,267,343,134,343,343
14198,2012-08-19,Fall,2012,Aug,18,0,Sunday,0,Misty,0.64,0.5909,0.78,0.1045,86,291,377,134,377,377
14199,2012-08-19,Fall,2012,Aug,19,0,Sunday,0,Misty,0.64,0.6061,0.73,0.1343,72,269,341,134,341,341
14200,2012-08-19,Fall,2012,Aug,20,0,Sunday,0,Misty,0.64,0.6061,0.73,0.194,61,213,274,134,274,274
14201,2012-08-19,Fall,2012,Aug,21,0,Sunday,0,Light_rainsnow,0.62,0.5909,0.78,0.0896,36,154,190,134,190,190
14202,2012-08-19,Fall,2012,Aug,22,0,Sunday,0,Misty,0.62,0.5909,0.78,0.1642,6,50,56,134,56,56
14203,2012-08-19,Fall,2012,Aug,23,0,Sunday,0,Misty,0.62,0.5909,0.73,0.0,7,39,46,134,46,46
14204,2012-08-20,Fall,2012,Aug,0,0,Monday,1,Misty,0.6,0.5606,0.83,0.1045,1,25,26,133,26,26
14205,2012-08-20,Fall,2012,Aug,1,0,Monday,1,Clear,0.6,0.5606,0.83,0.1642,0,10,10,133,10,10
14206,2012-08-20,Fall,2012,Aug,2,0,Monday,1,Clear,0.6,0.5606,0.83,0.1642,0,5,5,133,5,5
14207,2012-08-20,Fall,2012,Aug,3,0,Monday,1,Clear,0.6,0.5455,0.88,0.1045,0,3,3,133,3,3
14208,2012-08-20,Fall,2012,Aug,4,0,Monday,1,Misty,0.6,0.5606,0.83,0.0896,0,7,7,133,7,7
14209,2012-08-20,Fall,2012,Aug,5,0,Monday,1,Misty,0.6,0.5606,0.83,0.0,2,35,37,133,37,37
14210,2012-08-20,Fall,2012,Aug,6,0,Monday,1,Misty,0.6,0.5758,0.78,0.1343,6,155,161,133,161,161
14211,2012-08-20,Fall,2012,Aug,7,0,Monday,1,Misty,0.62,0.5909,0.78,0.1343,15,427,442,133,442,442
14212,2012-08-20,Fall,2012,Aug,8,0,Monday,1,Misty,0.62,0.5909,0.73,0.1045,37,618,655,133,655,655
14213,2012-08-20,Fall,2012,Aug,9,0,Monday,1,Misty,0.64,0.6061,0.69,0.0,55,302,357,133,357,357
14214,2012-08-20,Fall,2012,Aug,10,0,Monday,1,Misty,0.64,0.6061,0.69,0.0896,69,124,193,133,193,193
14215,2012-08-20,Fall,2012,Aug,11,0,Monday,1,Clear,0.66,0.6212,0.65,0.1045,90,151,241,133,241,241
14216,2012-08-20,Fall,2012,Aug,12,0,Monday,1,Misty,0.66,0.6212,0.61,0.1045,66,216,282,133,282,282
14217,2012-08-20,Fall,2012,Aug,13,0,Monday,1,Clear,0.7,0.6515,0.58,0.1343,97,194,291,133,291,291
14218,2012-08-20,Fall,2012,Aug,14,0,Monday,1,Clear,0.72,0.6667,0.54,0.1642,87,188,275,133,275,275
14219,2012-08-20,Fall,2012,Aug,15,0,Monday,1,Clear,0.72,0.6667,0.54,0.2537,102,207,309,133,309,309
14220,2012-08-20,Fall,2012,Aug,16,0,Monday,1,Clear,0.72,0.6667,0.54,0.2537,103,357,460,133,460,460
14221,2012-08-20,Fall,2012,Aug,17,0,Monday,1,Clear,0.7,0.6515,0.58,0.2836,83,810,893,133,893,893
14222,2012-08-20,Fall,2012,Aug,18,0,Monday,1,Misty,0.62,0.5909,0.78,0.2537,89,726,815,133,815,815
14223,2012-08-20,Fall,2012,Aug,19,0,Monday,1,Misty,0.62,0.5909,0.78,0.194,33,266,299,133,299,299
14224,2012-08-20,Fall,2012,Aug,20,0,Monday,1,Misty,0.62,0.5758,0.83,0.2836,30,231,261,133,261,261
14225,2012-08-20,Fall,2012,Aug,21,0,Monday,1,Clear,0.6,0.5606,0.83,0.0,26,219,245,133,245,245
14226,2012-08-20,Fall,2012,Aug,22,0,Monday,1,Misty,0.6,0.5606,0.83,0.0,25,136,161,133,161,161
14227,2012-08-20,Fall,2012,Aug,23,0,Monday,1,Misty,0.6,0.5606,0.83,0.0,10,92,102,133,102,102
14228,2012-08-21,Fall,2012,Aug,0,0,Tuesday,1,Misty,0.6,0.5606,0.83,0.0896,7,52,59,132,59,59
14229,2012-08-21,Fall,2012,Aug,1,0,Tuesday,1,Misty,0.6,0.5606,0.83,0.1343,11,22,33,132,33,33
14230,2012-08-21,Fall,2012,Aug,2,0,Tuesday,1,Misty,0.58,0.5455,0.88,0.2836,1,7,8,132,8,8
14231,2012-08-21,Fall,2012,Aug,3,0,Tuesday,1,Clear,0.56,0.5303,0.88,0.0,0,3,3,132,3,3
14232,2012-08-21,Fall,2012,Aug,4,0,Tuesday,1,Clear,0.56,0.5303,0.88,0.0,0,4,4,132,4,4
14233,2012-08-21,Fall,2012,Aug,5,0,Tuesday,1,Clear,0.56,0.5303,0.83,0.0896,4,30,34,132,34,34
14234,2012-08-21,Fall,2012,Aug,6,0,Tuesday,1,Clear,0.56,0.5303,0.83,0.1045,5,164,169,132,169,169
14235,2012-08-21,Fall,2012,Aug,7,0,Tuesday,1,Clear,0.6,0.5758,0.78,0.1045,19,500,519,132,519,519
14236,2012-08-21,Fall,2012,Aug,8,0,Tuesday,1,Clear,0.6,0.5758,0.78,0.1343,27,696,723,132,723,723
14237,2012-08-21,Fall,2012,Aug,9,0,Tuesday,1,Clear,0.64,0.6061,0.69,0.0,47,281,328,132,328,328
14238,2012-08-21,Fall,2012,Aug,10,0,Tuesday,1,Clear,0.66,0.6212,0.61,0.1045,58,120,178,132,178,178
14239,2012-08-21,Fall,2012,Aug,11,0,Tuesday,1,Clear,0.7,0.6515,0.54,0.0,61,195,256,132,256,256
14240,2012-08-21,Fall,2012,Aug,12,0,Tuesday,1,Clear,0.72,0.6515,0.45,0.0,79,226,305,132,305,305
14241,2012-08-21,Fall,2012,Aug,13,0,Tuesday,1,Clear,0.74,0.6515,0.4,0.0,76,255,331,132,331,331
14242,2012-08-21,Fall,2012,Aug,14,0,Tuesday,1,Clear,0.76,0.6667,0.37,0.0896,110,192,302,132,302,302
14243,2012-08-21,Fall,2012,Aug,15,0,Tuesday,1,Clear,0.76,0.6667,0.37,0.0,76,226,302,132,302,302
14244,2012-08-21,Fall,2012,Aug,16,0,Tuesday,1,Clear,0.76,0.6667,0.37,0.0,109,358,467,132,467,467
14245,2012-08-21,Fall,2012,Aug,17,0,Tuesday,1,Clear,0.74,0.6667,0.51,0.2836,92,786,878,132,878,878
14246,2012-08-21,Fall,2012,Aug,18,0,Tuesday,1,Clear,0.72,0.6667,0.54,0.2239,93,532,625,132,625,625
14247,2012-08-21,Fall,2012,Aug,19,0,Tuesday,1,Light_rainsnow,0.62,0.5909,0.73,0.1045,56,420,476,132,476,476
14248,2012-08-21,Fall,2012,Aug,20,0,Tuesday,1,Clear,0.64,0.6061,0.73,0.0,62,296,358,132,358,358
14249,2012-08-21,Fall,2012,Aug,21,0,Tuesday,1,Clear,0.64,0.6061,0.73,0.0,41,239,280,132,280,280
14250,2012-08-21,Fall,2012,Aug,22,0,Tuesday,1,Clear,0.64,0.5909,0.78,0.0,24,208,232,132,232,232
14251,2012-08-21,Fall,2012,Aug,23,0,Tuesday,1,Clear,0.62,0.5758,0.83,0.0,23,113,136,132,136,136
14252,2012-08-22,Fall,2012,Aug,0,0,Wednesday,1,Clear,0.62,0.5758,0.83,0.1045,9,46,55,131,55,55
14253,2012-08-22,Fall,2012,Aug,1,0,Wednesday,1,Clear,0.62,0.5909,0.78,0.0,1,20,21,131,21,21
14254,2012-08-22,Fall,2012,Aug,2,0,Wednesday,1,Clear,0.62,0.5909,0.78,0.0,7,10,17,131,17,17
14255,2012-08-22,Fall,2012,Aug,3,0,Wednesday,1,Clear,0.62,0.5909,0.78,0.0,0,7,7,131,7,7
14256,2012-08-22,Fall,2012,Aug,4,0,Wednesday,1,Clear,0.58,0.5455,0.83,0.1045,1,7,8,131,8,8
14257,2012-08-22,Fall,2012,Aug,5,0,Wednesday,1,Clear,0.6,0.5758,0.78,0.0,2,38,40,131,40,40
14258,2012-08-22,Fall,2012,Aug,6,0,Wednesday,1,Clear,0.62,0.5909,0.73,0.0,12,175,187,131,187,187
14259,2012-08-22,Fall,2012,Aug,7,0,Wednesday,1,Clear,0.62,0.5909,0.78,0.0,16,537,553,131,553,553
14260,2012-08-22,Fall,2012,Aug,8,0,Wednesday,1,Clear,0.64,0.6061,0.73,0.0896,37,703,740,131,740,740
14261,2012-08-22,Fall,2012,Aug,9,0,Wednesday,1,Clear,0.68,0.6364,0.65,0.0,41,335,376,131,376,376
14262,2012-08-22,Fall,2012,Aug,10,0,Wednesday,1,Clear,0.7,0.6515,0.61,0.0896,66,159,225,131,225,225
14263,2012-08-22,Fall,2012,Aug,11,0,Wednesday,1,Clear,0.72,0.6667,0.58,0.0896,71,196,267,131,267,267
14264,2012-08-22,Fall,2012,Aug,12,0,Wednesday,1,Clear,0.74,0.6667,0.51,0.0,59,253,312,131,312,312
14265,2012-08-22,Fall,2012,Aug,13,0,Wednesday,1,Clear,0.76,0.6818,0.48,0.1045,74,242,316,131,316,316
14266,2012-08-22,Fall,2012,Aug,14,0,Wednesday,1,Clear,0.76,0.6818,0.45,0.1045,82,184,266,131,266,266
14267,2012-08-22,Fall,2012,Aug,15,0,Wednesday,1,Clear,0.76,0.6818,0.48,0.1343,94,222,316,131,316,316
14268,2012-08-22,Fall,2012,Aug,16,0,Wednesday,1,Light_rainsnow,0.74,0.6818,0.55,0.2239,102,358,460,131,460,460
14269,2012-08-22,Fall,2012,Aug,17,0,Wednesday,1,Light_rainsnow,0.74,0.6818,0.55,0.2239,72,711,783,131,783,783
14270,2012-08-22,Fall,2012,Aug,18,0,Wednesday,1,Light_rainsnow,0.66,0.6212,0.61,0.2239,91,592,683,131,683,683
14271,2012-08-22,Fall,2012,Aug,19,0,Wednesday,1,Misty,0.66,0.6212,0.74,0.0,56,524,580,131,580,580
14272,2012-08-22,Fall,2012,Aug,20,0,Wednesday,1,Clear,0.64,0.6061,0.73,0.194,59,332,391,131,391,391
14273,2012-08-22,Fall,2012,Aug,21,0,Wednesday,1,Clear,0.64,0.6061,0.73,0.0,60,291,351,131,351,351
14274,2012-08-22,Fall,2012,Aug,22,0,Wednesday,1,Clear,0.64,0.6061,0.73,0.0,55,226,281,131,281,281
14275,2012-08-22,Fall,2012,Aug,23,0,Wednesday,1,Clear,0.64,0.5758,0.83,0.0,27,113,140,131,140,140
14276,2012-08-23,Fall,2012,Aug,0,0,Thursday,1,Clear,0.64,0.5909,0.78,0.0,9,51,60,130,60,60
14277,2012-08-23,Fall,2012,Aug,1,0,Thursday,1,Clear,0.62,0.5758,0.83,0.0,10,15,25,130,25,25
14278,2012-08-23,Fall,2012,Aug,2,0,Thursday,1,Clear,0.62,0.5758,0.83,0.0,9,11,20,130,20,20
14279,2012-08-23,Fall,2012,Aug,3,0,Thursday,1,Clear,0.62,0.5758,0.83,0.0896,3,6,9,130,9,9
14280,2012-08-23,Fall,2012,Aug,4,0,Thursday,1,Clear,0.62,0.5758,0.83,0.0,0,6,6,130,6,6
14281,2012-08-23,Fall,2012,Aug,5,0,Thursday,1,Clear,0.62,0.5758,0.83,0.0,1,36,37,130,37,37
14282,2012-08-23,Fall,2012,Aug,6,0,Thursday,1,Misty,0.6,0.5455,0.88,0.0896,14,178,192,130,192,192
14283,2012-08-23,Fall,2012,Aug,7,0,Thursday,1,Misty,0.62,0.5758,0.83,0.0896,18,463,481,130,481,481
14284,2012-08-23,Fall,2012,Aug,8,0,Thursday,1,Misty,0.66,0.6212,0.74,0.0896,45,662,707,130,707,707
14285,2012-08-23,Fall,2012,Aug,9,0,Thursday,1,Misty,0.7,0.6515,0.7,0.0,58,354,412,130,412,412
14286,2012-08-23,Fall,2012,Aug,10,0,Thursday,1,Clear,0.74,0.6818,0.58,0.0896,76,157,233,130,233,233
14287,2012-08-23,Fall,2012,Aug,11,0,Thursday,1,Clear,0.76,0.6818,0.48,0.0896,86,192,278,130,278,278
14288,2012-08-23,Fall,2012,Aug,12,0,Thursday,1,Clear,0.78,0.6818,0.38,0.0,97,235,332,130,332,332
14289,2012-08-23,Fall,2012,Aug,13,0,Thursday,1,Clear,0.82,0.7273,0.38,0.0896,93,253,346,130,346,346
14290,2012-08-23,Fall,2012,Aug,14,0,Thursday,1,Clear,0.78,0.697,0.46,0.2239,114,191,305,130,305,305
14291,2012-08-23,Fall,2012,Aug,15,0,Thursday,1,Clear,0.78,0.697,0.46,0.1343,104,201,305,130,305,305
14292,2012-08-23,Fall,2012,Aug,16,0,Thursday,1,Clear,0.76,0.6818,0.48,0.1642,121,344,465,130,465,465
14293,2012-08-23,Fall,2012,Aug,17,0,Thursday,1,Clear,0.76,0.6818,0.45,0.2239,111,709,820,130,820,820
14294,2012-08-23,Fall,2012,Aug,18,0,Thursday,1,Clear,0.74,0.6667,0.48,0.2239,130,811,941,130,941,941
14295,2012-08-23,Fall,2012,Aug,19,0,Thursday,1,Clear,0.72,0.6667,0.51,0.0896,96,537,633,130,633,633
14296,2012-08-23,Fall,2012,Aug,20,0,Thursday,1,Clear,0.7,0.6515,0.61,0.1045,70,404,474,130,474,474
14297,2012-08-23,Fall,2012,Aug,21,0,Thursday,1,Clear,0.7,0.6515,0.61,0.1343,53,276,329,130,329,329
14298,2012-08-23,Fall,2012,Aug,22,0,Thursday,1,Misty,0.68,0.6364,0.61,0.1045,21,177,198,130,198,198
14299,2012-08-23,Fall,2012,Aug,23,0,Thursday,1,Misty,0.66,0.6212,0.69,0.0,24,133,157,130,157,157
14300,2012-08-24,Fall,2012,Aug,0,0,Friday,1,Misty,0.66,0.6212,0.69,0.0,27,84,111,129,111,111
14301,2012-08-24,Fall,2012,Aug,1,0,Friday,1,Misty,0.64,0.6061,0.73,0.0,5,37,42,129,42,42
14302,2012-08-24,Fall,2012,Aug,2,0,Friday,1,Clear,0.66,0.6212,0.69,0.0,1,15,16,129,16,16
14303,2012-08-24,Fall,2012,Aug,3,0,Friday,1,Clear,0.64,0.6061,0.73,0.0,2,6,8,129,8,8
14304,2012-08-24,Fall,2012,Aug,4,0,Friday,1,Misty,0.64,0.6061,0.73,0.0,2,6,8,129,8,8
14305,2012-08-24,Fall,2012,Aug,5,0,Friday,1,Clear,0.64,0.5909,0.78,0.0,1,37,38,129,38,38
14306,2012-08-24,Fall,2012,Aug,6,0,Friday,1,Misty,0.62,0.5758,0.83,0.0,9,142,151,129,151,151
14307,2012-08-24,Fall,2012,Aug,7,0,Friday,1,Misty,0.64,0.5909,0.78,0.0,13,412,425,129,425,425
14308,2012-08-24,Fall,2012,Aug,8,0,Friday,1,Misty,0.66,0.6212,0.74,0.0,41,703,744,129,744,744
14309,2012-08-24,Fall,2012,Aug,9,0,Friday,1,Misty,0.72,0.6667,0.58,0.0,58,331,389,129,389,389
14310,2012-08-24,Fall,2012,Aug,10,0,Friday,1,Misty,0.76,0.6818,0.48,0.0,78,184,262,129,262,262
14311,2012-08-24,Fall,2012,Aug,11,0,Friday,1,Misty,0.76,0.6818,0.48,0.1045,69,212,281,129,281,281
14312,2012-08-24,Fall,2012,Aug,12,0,Friday,1,Misty,0.76,0.6818,0.45,0.0896,95,276,371,129,371,371
14313,2012-08-24,Fall,2012,Aug,13,0,Friday,1,Misty,0.8,0.7121,0.41,0.1045,79,272,351,129,351,351
14314,2012-08-24,Fall,2012,Aug,14,0,Friday,1,Clear,0.78,0.697,0.43,0.1045,109,229,338,129,338,338
14315,2012-08-24,Fall,2012,Aug,15,0,Friday,1,Misty,0.76,0.6818,0.48,0.1343,99,251,350,129,350,350
14316,2012-08-24,Fall,2012,Aug,16,0,Friday,1,Misty,0.76,0.6818,0.48,0.1343,101,414,515,129,515,515
14317,2012-08-24,Fall,2012,Aug,17,0,Friday,1,Misty,0.74,0.6667,0.51,0.2239,117,695,812,129,812,812
14318,2012-08-24,Fall,2012,Aug,18,0,Friday,1,Misty,0.72,0.6818,0.62,0.194,109,627,736,129,736,736
14319,2012-08-24,Fall,2012,Aug,19,0,Friday,1,Misty,0.72,0.6667,0.58,0.1642,106,430,536,129,536,536
14320,2012-08-24,Fall,2012,Aug,20,0,Friday,1,Misty,0.7,0.6515,0.65,0.2239,66,297,363,129,363,363
14321,2012-08-24,Fall,2012,Aug,21,0,Friday,1,Misty,0.7,0.6515,0.61,0.1642,58,248,306,129,306,306
14322,2012-08-24,Fall,2012,Aug,22,0,Friday,1,Misty,0.7,0.6515,0.61,0.0,42,209,251,129,251,251
14323,2012-08-24,Fall,2012,Aug,23,0,Friday,1,Misty,0.68,0.6364,0.69,0.0896,38,140,178,129,178,178
14324,2012-08-25,Fall,2012,Aug,0,0,Saturday,0,Misty,0.7,0.6515,0.61,0.0,21,114,135,128,135,135
14325,2012-08-25,Fall,2012,Aug,1,0,Saturday,0,Misty,0.68,0.6364,0.69,0.0,15,100,115,128,115,115
14326,2012-08-25,Fall,2012,Aug,2,0,Saturday,0,Misty,0.66,0.6212,0.74,0.0896,18,61,79,128,79,79
14327,2012-08-25,Fall,2012,Aug,3,0,Saturday,0,Clear,0.66,0.6212,0.69,0.0896,7,31,38,128,38,38
14328,2012-08-25,Fall,2012,Aug,4,0,Saturday,0,Misty,0.66,0.6212,0.69,0.1045,3,9,12,128,12,12
14329,2012-08-25,Fall,2012,Aug,5,0,Saturday,0,Misty,0.64,0.6061,0.73,0.1642,4,10,14,128,14,14
14330,2012-08-25,Fall,2012,Aug,6,0,Saturday,0,Misty,0.64,0.5909,0.78,0.1642,5,25,30,128,30,30
14331,2012-08-25,Fall,2012,Aug,7,0,Saturday,0,Misty,0.64,0.5909,0.78,0.194,14,88,102,128,102,102
14332,2012-08-25,Fall,2012,Aug,8,0,Saturday,0,Misty,0.66,0.6212,0.74,0.2537,29,133,162,128,162,162
14333,2012-08-25,Fall,2012,Aug,9,0,Saturday,0,Misty,0.68,0.6364,0.69,0.2836,60,228,288,128,288,288
14334,2012-08-25,Fall,2012,Aug,10,0,Saturday,0,Misty,0.7,0.6515,0.65,0.2985,148,294,442,128,442,442
14335,2012-08-25,Fall,2012,Aug,11,0,Saturday,0,Misty,0.72,0.6818,0.62,0.2836,143,314,457,128,457,457
14336,2012-08-25,Fall,2012,Aug,12,0,Saturday,0,Light_rainsnow,0.72,0.6667,0.54,0.3881,217,367,584,128,584,584
14337,2012-08-25,Fall,2012,Aug,13,0,Saturday,0,Misty,0.72,0.6667,0.51,0.3582,186,331,517,128,517,517
14338,2012-08-25,Fall,2012,Aug,14,0,Saturday,0,Light_rainsnow,0.66,0.6212,0.65,0.2537,150,332,482,128,482,482
14339,2012-08-25,Fall,2012,Aug,15,0,Saturday,0,Misty,0.64,0.6061,0.73,0.3284,79,154,233,128,233,233
14340,2012-08-25,Fall,2012,Aug,16,0,Saturday,0,Misty,0.66,0.6212,0.74,0.2985,174,260,434,128,434,434
14341,2012-08-25,Fall,2012,Aug,17,0,Saturday,0,Misty,0.66,0.6212,0.74,0.3284,132,271,403,128,403,403
14342,2012-08-25,Fall,2012,Aug,18,0,Saturday,0,Misty,0.66,0.6212,0.69,0.4627,122,261,383,128,383,383
14343,2012-08-25,Fall,2012,Aug,19,0,Saturday,0,Misty,0.64,0.5909,0.78,0.2985,97,257,354,128,354,354
14344,2012-08-25,Fall,2012,Aug,20,0,Saturday,0,Light_rainsnow,0.62,0.5758,0.83,0.2537,65,176,241,128,241,241
14345,2012-08-25,Fall,2012,Aug,21,0,Saturday,0,Clear,0.62,0.5758,0.83,0.3582,60,148,208,128,208,208
14346,2012-08-25,Fall,2012,Aug,22,0,Saturday,0,Clear,0.62,0.5758,0.83,0.3582,46,136,182,128,182,182
14347,2012-08-25,Fall,2012,Aug,23,0,Saturday,0,Misty,0.62,0.5758,0.83,0.2537,34,124,158,128,158,158
14348,2012-08-26,Fall,2012,Aug,0,0,Sunday,0,Clear,0.64,0.5758,0.89,0.2537,23,111,134,127,134,134
14349,2012-08-26,Fall,2012,Aug,1,0,Sunday,0,Clear,0.64,0.5758,0.89,0.194,18,116,134,127,134,134
14350,2012-08-26,Fall,2012,Aug,2,0,Sunday,0,Misty,0.64,0.5758,0.89,0.2239,12,104,116,127,116,116
14351,2012-08-26,Fall,2012,Aug,3,0,Sunday,0,Misty,0.64,0.5758,0.89,0.2537,11,42,53,127,53,53
14352,2012-08-26,Fall,2012,Aug,4,0,Sunday,0,Misty,0.64,0.5758,0.89,0.194,5,11,16,127,16,16
14353,2012-08-26,Fall,2012,Aug,5,0,Sunday,0,Clear,0.64,0.5758,0.89,0.194,3,13,16,127,16,16
14354,2012-08-26,Fall,2012,Aug,6,0,Sunday,0,Clear,0.62,0.5606,0.88,0.2985,5,16,21,127,21,21
14355,2012-08-26,Fall,2012,Aug,7,0,Sunday,0,Clear,0.64,0.5758,0.89,0.194,11,23,34,127,34,34
14356,2012-08-26,Fall,2012,Aug,8,0,Sunday,0,Clear,0.68,0.6364,0.79,0.2836,21,112,133,127,133,133
14357,2012-08-26,Fall,2012,Aug,9,0,Sunday,0,Clear,0.68,0.6364,0.79,0.2537,67,196,263,127,263,263
14358,2012-08-26,Fall,2012,Aug,10,0,Sunday,0,Clear,0.74,0.697,0.66,0.3881,127,258,385,127,385,385
14359,2012-08-26,Fall,2012,Aug,11,0,Sunday,0,Clear,0.74,0.697,0.66,0.3582,150,332,482,127,482,482
14360,2012-08-26,Fall,2012,Aug,12,0,Sunday,0,Light_rainsnow,0.72,0.697,0.74,0.3582,225,401,626,127,626,626
14361,2012-08-26,Fall,2012,Aug,13,0,Sunday,0,Light_rainsnow,0.66,0.6061,0.78,0.4179,166,375,541,127,541,541
14362,2012-08-26,Fall,2012,Aug,14,0,Sunday,0,Clear,0.64,0.5758,0.89,0.1045,125,252,377,127,377,377
14363,2012-08-26,Fall,2012,Aug,15,0,Sunday,0,Light_rainsnow,0.64,0.5758,0.89,0.2836,132,259,391,127,391,391
14364,2012-08-26,Fall,2012,Aug,16,0,Sunday,0,Light_rainsnow,0.64,0.5758,0.89,0.2836,57,116,173,127,173,173
14365,2012-08-26,Fall,2012,Aug,17,0,Sunday,0,Clear,0.64,0.5758,0.89,0.2239,61,172,233,127,233,233
14366,2012-08-26,Fall,2012,Aug,18,0,Sunday,0,Misty,0.64,0.5758,0.89,0.0896,77,187,264,127,264,264
14367,2012-08-26,Fall,2012,Aug,19,0,Sunday,0,Misty,0.64,0.5758,0.89,0.1642,80,212,292,127,292,292
14368,2012-08-26,Fall,2012,Aug,20,0,Sunday,0,Clear,0.64,0.5758,0.89,0.1642,40,171,211,127,211,211
14369,2012-08-26,Fall,2012,Aug,21,0,Sunday,0,Clear,0.64,0.5758,0.83,0.1343,26,140,166,127,166,166
14370,2012-08-26,Fall,2012,Aug,22,0,Sunday,0,Clear,0.62,0.5606,0.88,0.0896,20,94,114,127,114,114
14371,2012-08-26,Fall,2012,Aug,23,0,Sunday,0,Clear,0.62,0.5758,0.83,0.0896,21,59,80,127,80,80
14372,2012-08-27,Fall,2012,Aug,0,0,Monday,1,Clear,0.62,0.5758,0.83,0.0,4,28,32,126,32,32
14373,2012-08-27,Fall,2012,Aug,1,0,Monday,1,Clear,0.62,0.5606,0.88,0.0896,3,4,7,126,7,7
14374,2012-08-27,Fall,2012,Aug,2,0,Monday,1,Clear,0.62,0.5606,0.88,0.1343,0,8,8,126,8,8
14375,2012-08-27,Fall,2012,Aug,3,0,Monday,1,Clear,0.62,0.5606,0.88,0.0896,1,3,4,126,4,4
14376,2012-08-27,Fall,2012,Aug,4,0,Monday,1,Clear,0.62,0.5758,0.83,0.0,1,11,12,126,12,12
14377,2012-08-27,Fall,2012,Aug,5,0,Monday,1,Clear,0.62,0.5606,0.88,0.0,4,32,36,126,36,36
14378,2012-08-27,Fall,2012,Aug,6,0,Monday,1,Clear,0.62,0.5606,0.88,0.0,4,141,145,126,145,145
14379,2012-08-27,Fall,2012,Aug,7,0,Monday,1,Clear,0.66,0.6061,0.83,0.0,15,418,433,126,433,433
14380,2012-08-27,Fall,2012,Aug,8,0,Monday,1,Clear,0.66,0.6061,0.83,0.0896,29,670,699,126,699,699
14381,2012-08-27,Fall,2012,Aug,9,0,Monday,1,Clear,0.66,0.6061,0.83,0.1045,40,302,342,126,342,342
14382,2012-08-27,Fall,2012,Aug,10,0,Monday,1,Clear,0.72,0.697,0.74,0.1343,63,143,206,126,206,206
14383,2012-08-27,Fall,2012,Aug,11,0,Monday,1,Clear,0.74,0.697,0.66,0.194,47,182,229,126,229,229
14384,2012-08-27,Fall,2012,Aug,12,0,Monday,1,Clear,0.76,0.7121,0.62,0.0,69,214,283,126,283,283
14385,2012-08-27,Fall,2012,Aug,13,0,Monday,1,Clear,0.76,0.7121,0.57,0.1642,77,211,288,126,288,288
14386,2012-08-27,Fall,2012,Aug,14,0,Monday,1,Clear,0.8,0.7424,0.49,0.0896,66,180,246,126,246,246
14387,2012-08-27,Fall,2012,Aug,15,0,Monday,1,Clear,0.8,0.7576,0.55,0.2985,77,205,282,126,282,282
14388,2012-08-27,Fall,2012,Aug,16,0,Monday,1,Clear,0.8,0.7576,0.55,0.2537,77,367,444,126,444,444
14389,2012-08-27,Fall,2012,Aug,17,0,Monday,1,Clear,0.8,0.7273,0.46,0.2239,101,744,845,126,845,845
14390,2012-08-27,Fall,2012,Aug,18,0,Monday,1,Clear,0.78,0.7121,0.52,0.2537,83,751,834,126,834,834
14391,2012-08-27,Fall,2012,Aug,19,0,Monday,1,Clear,0.74,0.697,0.7,0.2239,74,499,573,126,573,573
14392,2012-08-27,Fall,2012,Aug,20,0,Monday,1,Clear,0.74,0.697,0.7,0.194,50,366,416,126,416,416
14393,2012-08-27,Fall,2012,Aug,21,0,Monday,1,Clear,0.72,0.697,0.74,0.194,39,239,278,126,278,278
14394,2012-08-27,Fall,2012,Aug,22,0,Monday,1,Clear,0.7,0.6667,0.84,0.194,30,131,161,126,161,161
14395,2012-08-27,Fall,2012,Aug,23,0,Monday,1,Clear,0.7,0.6667,0.84,0.1642,35,79,114,126,114,114
14396,2012-08-28,Fall,2012,Aug,0,0,Tuesday,1,Clear,0.7,0.6667,0.84,0.2537,9,29,38,125,38,38
14397,2012-08-28,Fall,2012,Aug,1,0,Tuesday,1,Clear,0.68,0.6364,0.89,0.194,4,17,21,125,21,21
14398,2012-08-28,Fall,2012,Aug,2,0,Tuesday,1,Clear,0.68,0.6364,0.83,0.2537,2,13,15,125,15,15
14399,2012-08-28,Fall,2012,Aug,3,0,Tuesday,1,Clear,0.66,0.5909,0.89,0.1343,0,4,4,125,4,4
14400,2012-08-28,Fall,2012,Aug,4,0,Tuesday,1,Clear,0.66,0.6061,0.83,0.1343,2,6,8,125,8,8
14401,2012-08-28,Fall,2012,Aug,5,0,Tuesday,1,Misty,0.66,0.6061,0.83,0.0896,3,39,42,125,42,42
14402,2012-08-28,Fall,2012,Aug,6,0,Tuesday,1,Misty,0.66,0.5909,0.89,0.1045,3,144,147,125,147,147
14403,2012-08-28,Fall,2012,Aug,7,0,Tuesday,1,Misty,0.66,0.6061,0.83,0.1045,14,255,269,125,269,269
14404,2012-08-28,Fall,2012,Aug,8,0,Tuesday,1,Misty,0.66,0.6212,0.85,0.1045,25,668,693,125,693,693
14405,2012-08-28,Fall,2012,Aug,9,0,Tuesday,1,Misty,0.7,0.6667,0.79,0.1642,44,351,395,125,395,395
14406,2012-08-28,Fall,2012,Aug,10,0,Tuesday,1,Clear,0.74,0.6818,0.62,0.2537,39,165,204,125,204,204
14407,2012-08-28,Fall,2012,Aug,11,0,Tuesday,1,Clear,0.78,0.7273,0.55,0.2537,47,171,218,125,218,218
14408,2012-08-28,Fall,2012,Aug,12,0,Tuesday,1,Clear,0.8,0.7424,0.49,0.2836,56,241,297,125,297,297
14409,2012-08-28,Fall,2012,Aug,13,0,Tuesday,1,Clear,0.82,0.7424,0.43,0.2985,56,232,288,125,288,288
14410,2012-08-28,Fall,2012,Aug,14,0,Tuesday,1,Clear,0.84,0.7424,0.38,0.3284,72,179,251,125,251,251
14411,2012-08-28,Fall,2012,Aug,15,0,Tuesday,1,Clear,0.82,0.7273,0.34,0.2985,59,258,317,125,317,317
14412,2012-08-28,Fall,2012,Aug,16,0,Tuesday,1,Clear,0.82,0.7121,0.33,0.3284,84,396,480,125,480,480
14413,2012-08-28,Fall,2012,Aug,17,0,Tuesday,1,Clear,0.8,0.697,0.35,0.3881,90,774,864,125,864,864
14414,2012-08-28,Fall,2012,Aug,18,0,Tuesday,1,Clear,0.78,0.697,0.4,0.2537,82,736,818,125,818,818
14415,2012-08-28,Fall,2012,Aug,19,0,Tuesday,1,Clear,0.74,0.6667,0.45,0.1642,82,515,597,125,597,597
14416,2012-08-28,Fall,2012,Aug,20,0,Tuesday,1,Clear,0.72,0.6667,0.48,0.1045,87,348,435,125,435,435
14417,2012-08-28,Fall,2012,Aug,21,0,Tuesday,1,Clear,0.72,0.6667,0.48,0.0896,38,276,314,125,314,314
14418,2012-08-28,Fall,2012,Aug,22,0,Tuesday,1,Clear,0.7,0.6515,0.54,0.0,20,196,216,125,216,216
14419,2012-08-28,Fall,2012,Aug,23,0,Tuesday,1,Clear,0.68,0.6364,0.57,0.0,17,92,109,125,109,109
14420,2012-08-29,Fall,2012,Aug,0,0,Wednesday,1,Clear,0.66,0.6212,0.69,0.0,8,39,47,124,47,47
14421,2012-08-29,Fall,2012,Aug,1,0,Wednesday,1,Clear,0.64,0.6061,0.69,0.1343,2,12,14,124,14,14
14422,2012-08-29,Fall,2012,Aug,2,0,Wednesday,1,Clear,0.62,0.5909,0.73,0.1343,2,4,6,124,6,6
14423,2012-08-29,Fall,2012,Aug,3,0,Wednesday,1,Clear,0.62,0.5909,0.73,0.1045,0,9,9,124,9,9
14424,2012-08-29,Fall,2012,Aug,4,0,Wednesday,1,Clear,0.6,0.5909,0.73,0.2239,2,8,10,124,10,10
14425,2012-08-29,Fall,2012,Aug,5,0,Wednesday,1,Clear,0.6,0.5909,0.73,0.194,3,37,40,124,40,40
14426,2012-08-29,Fall,2012,Aug,6,0,Wednesday,1,Clear,0.6,0.5909,0.73,0.194,6,175,181,124,181,181
14427,2012-08-29,Fall,2012,Aug,7,0,Wednesday,1,Clear,0.64,0.6061,0.65,0.0896,23,531,554,124,554,554
14428,2012-08-29,Fall,2012,Aug,8,0,Wednesday,1,Clear,0.66,0.6212,0.61,0.1642,28,780,808,124,808,808
14429,2012-08-29,Fall,2012,Aug,9,0,Wednesday,1,Clear,0.7,0.6515,0.51,0.194,40,308,348,124,348,348
14430,2012-08-29,Fall,2012,Aug,10,0,Wednesday,1,Clear,0.72,0.6667,0.48,0.1642,34,144,178,124,178,178
14431,2012-08-29,Fall,2012,Aug,11,0,Wednesday,1,Clear,0.72,0.6515,0.45,0.0,67,186,253,124,253,253
14432,2012-08-29,Fall,2012,Aug,12,0,Wednesday,1,Clear,0.76,0.6818,0.4,0.0,79,281,360,124,360,360
14433,2012-08-29,Fall,2012,Aug,13,0,Wednesday,1,Clear,0.74,0.6667,0.42,0.0,68,232,300,124,300,300
14434,2012-08-29,Fall,2012,Aug,14,0,Wednesday,1,Clear,0.76,0.6818,0.4,0.0896,87,214,301,124,301,301
14435,2012-08-29,Fall,2012,Aug,15,0,Wednesday,1,Clear,0.76,0.6818,0.4,0.194,96,242,338,124,338,338
14436,2012-08-29,Fall,2012,Aug,16,0,Wednesday,1,Clear,0.76,0.6667,0.37,0.1343,104,389,493,124,493,493
14437,2012-08-29,Fall,2012,Aug,17,0,Wednesday,1,Clear,0.78,0.6818,0.35,0.2239,108,762,870,124,870,870
14438,2012-08-29,Fall,2012,Aug,18,0,Wednesday,1,Clear,0.74,0.6667,0.42,0.1642,119,693,812,124,812,812
14439,2012-08-29,Fall,2012,Aug,19,0,Wednesday,1,Clear,0.7,0.6515,0.54,0.194,120,523,643,124,643,643
14440,2012-08-29,Fall,2012,Aug,20,0,Wednesday,1,Clear,0.68,0.6364,0.57,0.0,49,378,427,124,427,427
14441,2012-08-29,Fall,2012,Aug,21,0,Wednesday,1,Clear,0.66,0.6212,0.54,0.1045,48,265,313,124,313,313
14442,2012-08-29,Fall,2012,Aug,22,0,Wednesday,1,Clear,0.66,0.6212,0.54,0.0,50,185,235,124,235,235
14443,2012-08-29,Fall,2012,Aug,23,0,Wednesday,1,Clear,0.66,0.6212,0.57,0.0,34,123,157,124,157,157
14444,2012-08-30,Fall,2012,Aug,0,0,Thursday,1,Clear,0.64,0.6061,0.69,0.0,14,51,65,123,65,65
14445,2012-08-30,Fall,2012,Aug,1,0,Thursday,1,Clear,0.64,0.6061,0.65,0.0,6,17,23,123,23,23
14446,2012-08-30,Fall,2012,Aug,2,0,Thursday,1,Clear,0.62,0.5909,0.73,0.0,3,14,17,123,17,17
14447,2012-08-30,Fall,2012,Aug,3,0,Thursday,1,Clear,0.62,0.5909,0.73,0.0,0,5,5,123,5,5
14448,2012-08-30,Fall,2012,Aug,4,0,Thursday,1,Clear,0.62,0.5909,0.73,0.0,4,4,8,123,8,8
14449,2012-08-30,Fall,2012,Aug,5,0,Thursday,1,Clear,0.62,0.5909,0.73,0.0,2,33,35,123,35,35
14450,2012-08-30,Fall,2012,Aug,6,0,Thursday,1,Clear,0.6,0.5606,0.83,0.1642,8,155,163,123,163,163
14451,2012-08-30,Fall,2012,Aug,7,0,Thursday,1,Clear,0.64,0.6061,0.73,0.0,31,501,532,123,532,532
14452,2012-08-30,Fall,2012,Aug,8,0,Thursday,1,Clear,0.66,0.6212,0.65,0.0,53,701,754,123,754,754
14453,2012-08-30,Fall,2012,Aug,9,0,Thursday,1,Clear,0.7,0.6515,0.58,0.0,57,339,396,123,396,396
14454,2012-08-30,Fall,2012,Aug,10,0,Thursday,1,Clear,0.72,0.6667,0.54,0.0,73,161,234,123,234,234
14455,2012-08-30,Fall,2012,Aug,11,0,Thursday,1,Clear,0.76,0.6818,0.4,0.0896,85,191,276,123,276,276
14456,2012-08-30,Fall,2012,Aug,12,0,Thursday,1,Clear,0.76,0.6818,0.45,0.1343,73,221,294,123,294,294
14457,2012-08-30,Fall,2012,Aug,13,0,Thursday,1,Clear,0.76,0.6818,0.48,0.1045,76,214,290,123,290,290
14458,2012-08-30,Fall,2012,Aug,14,0,Thursday,1,Clear,0.76,0.6818,0.48,0.1343,74,199,273,123,273,273
14459,2012-08-30,Fall,2012,Aug,15,0,Thursday,1,Clear,0.8,0.7273,0.46,0.1642,99,239,338,123,338,338
14460,2012-08-30,Fall,2012,Aug,16,0,Thursday,1,Clear,0.8,0.7273,0.43,0.1642,77,405,482,123,482,482
14461,2012-08-30,Fall,2012,Aug,17,0,Thursday,1,Clear,0.82,0.7273,0.34,0.2239,93,751,844,123,844,844
14462,2012-08-30,Fall,2012,Aug,18,0,Thursday,1,Clear,0.8,0.7121,0.38,0.1343,109,744,853,123,853,853
14463,2012-08-30,Fall,2012,Aug,19,0,Thursday,1,Clear,0.76,0.6818,0.48,0.1343,78,532,610,123,610,610
14464,2012-08-30,Fall,2012,Aug,20,0,Thursday,1,Clear,0.74,0.6818,0.58,0.1642,68,403,471,123,471,471
14465,2012-08-30,Fall,2012,Aug,21,0,Thursday,1,Clear,0.72,0.6818,0.66,0.1343,32,275,307,123,307,307
14466,2012-08-30,Fall,2012,Aug,22,0,Thursday,1,Clear,0.7,0.6515,0.7,0.0,38,253,291,123,291,291
14467,2012-08-30,Fall,2012,Aug,23,0,Thursday,1,Clear,0.7,0.6667,0.74,0.1045,19,133,152,123,152,152
14468,2012-08-31,Fall,2012,Aug,0,0,Friday,1,Clear,0.68,0.6364,0.83,0.1642,13,69,82,122,82,82
14469,2012-08-31,Fall,2012,Aug,1,0,Friday,1,Clear,0.68,0.6364,0.83,0.1642,8,24,32,122,32,32
14470,2012-08-31,Fall,2012,Aug,2,0,Friday,1,Clear,0.66,0.5909,0.89,0.1343,9,11,20,122,20,20
14471,2012-08-31,Fall,2012,Aug,3,0,Friday,1,Clear,0.66,0.5909,0.89,0.1045,3,2,5,122,5,5
14472,2012-08-31,Fall,2012,Aug,4,0,Friday,1,Clear,0.64,0.5758,0.89,0.1343,0,7,7,122,7,7
14473,2012-08-31,Fall,2012,Aug,5,0,Friday,1,Clear,0.64,0.5758,0.89,0.1642,2,27,29,122,29,29
14474,2012-08-31,Fall,2012,Aug,6,0,Friday,1,Misty,0.64,0.5758,0.89,0.1642,7,101,108,122,108,108
14475,2012-08-31,Fall,2012,Aug,7,0,Friday,1,Misty,0.64,0.5758,0.89,0.0896,21,400,421,122,421,421
14476,2012-08-31,Fall,2012,Aug,8,0,Friday,1,Misty,0.7,0.6667,0.74,0.0,36,654,690,122,690,690
14477,2012-08-31,Fall,2012,Aug,9,0,Friday,1,Clear,0.74,0.697,0.7,0.0,61,337,398,122,398,398
14478,2012-08-31,Fall,2012,Aug,10,0,Friday,1,Clear,0.76,0.7121,0.62,0.0896,59,197,256,122,256,256
14479,2012-08-31,Fall,2012,Aug,11,0,Friday,1,Clear,0.86,0.7424,0.28,0.2985,88,221,309,122,309,309
14480,2012-08-31,Fall,2012,Aug,12,0,Friday,1,Clear,0.86,0.7424,0.26,0.2537,120,290,410,122,410,410
14481,2012-08-31,Fall,2012,Aug,13,0,Friday,1,Clear,0.88,0.7576,0.27,0.3284,97,271,368,122,368,368
14482,2012-08-31,Fall,2012,Aug,14,0,Friday,1,Clear,0.9,0.7727,0.25,0.2239,112,324,436,122,436,436
14483,2012-08-31,Fall,2012,Aug,15,0,Friday,1,Clear,0.9,0.7879,0.27,0.2985,109,417,526,122,526,526
14484,2012-08-31,Fall,2012,Aug,16,0,Friday,1,Clear,0.9,0.7879,0.27,0.2537,111,417,528,122,528,528
14485,2012-08-31,Fall,2012,Aug,17,0,Friday,1,Clear,0.88,0.7727,0.32,0.1642,129,488,617,122,617,617
14486,2012-08-31,Fall,2012,Aug,18,0,Friday,1,Clear,0.86,0.7576,0.36,0.2537,87,459,546,122,546,546
14487,2012-08-31,Fall,2012,Aug,19,0,Friday,1,Clear,0.8,0.7424,0.49,0.1343,91,361,452,122,452,452
14488,2012-08-31,Fall,2012,Aug,20,0,Friday,1,Clear,0.8,0.7424,0.49,0.1343,102,254,356,122,356,356
14489,2012-08-31,Fall,2012,Aug,21,0,Friday,1,Clear,0.76,0.7121,0.58,0.194,71,232,303,122,303,303
14490,2012-08-31,Fall,2012,Aug,22,0,Friday,1,Clear,0.76,0.7121,0.58,0.194,65,212,277,122,277,277
14491,2012-08-31,Fall,2012,Aug,23,0,Friday,1,Clear,0.74,0.6818,0.62,0.1045,32,142,174,122,174,174
14492,2012-09-01,Fall,2012,Sep,0,0,Saturday,0,Clear,0.74,0.6818,0.62,0.1045,22,146,168,121,168,168
14493,2012-09-01,Fall,2012,Sep,1,0,Saturday,0,Clear,0.72,0.697,0.74,0.1343,11,68,79,121,79,79
14494,2012-09-01,Fall,2012,Sep,2,0,Saturday,0,Clear,0.7,0.6515,0.7,0.1642,8,61,69,121,69,69
14495,2012-09-01,Fall,2012,Sep,3,0,Saturday,0,Clear,0.7,0.6515,0.7,0.1045,6,29,35,121,35,35
14496,2012-09-01,Fall,2012,Sep,4,0,Saturday,0,Clear,0.7,0.6515,0.7,0.0,3,9,12,121,12,12
14497,2012-09-01,Fall,2012,Sep,5,0,Saturday,0,Clear,0.68,0.6364,0.79,0.0,2,20,22,121,22,22
14498,2012-09-01,Fall,2012,Sep,6,0,Saturday,0,Clear,0.68,0.6364,0.79,0.0,13,23,36,121,36,36
14499,2012-09-01,Fall,2012,Sep,7,0,Saturday,0,Misty,0.74,0.6818,0.58,0.1343,8,58,66,121,66,66
14500,2012-09-01,Fall,2012,Sep,8,0,Saturday,0,Misty,0.76,0.7121,0.58,0.2537,28,134,162,121,162,162
14501,2012-09-01,Fall,2012,Sep,9,0,Saturday,0,Misty,0.76,0.7121,0.58,0.194,62,175,237,121,237,237
14502,2012-09-01,Fall,2012,Sep,10,0,Saturday,0,Misty,0.78,0.7273,0.55,0.194,128,289,417,121,417,417
14503,2012-09-01,Fall,2012,Sep,11,0,Saturday,0,Misty,0.8,0.7576,0.55,0.2239,219,273,492,121,492,492
14504,2012-09-01,Fall,2012,Sep,12,0,Saturday,0,Misty,0.8,0.7576,0.55,0.1642,187,284,471,121,471,471
14505,2012-09-01,Fall,2012,Sep,13,0,Saturday,0,Misty,0.82,0.7727,0.52,0.0896,237,267,504,121,504,504
14506,2012-09-01,Fall,2012,Sep,14,0,Saturday,0,Misty,0.86,0.7879,0.44,0.1642,240,274,514,121,514,514
14507,2012-09-01,Fall,2012,Sep,15,0,Saturday,0,Misty,0.86,0.7879,0.44,0.2836,257,306,563,121,563,563
14508,2012-09-01,Fall,2012,Sep,16,0,Saturday,0,Misty,0.84,0.7879,0.49,0.1642,209,253,462,121,462,462
14509,2012-09-01,Fall,2012,Sep,17,0,Saturday,0,Misty,0.82,0.7727,0.52,0.0,205,258,463,121,463,463
14510,2012-09-01,Fall,2012,Sep,18,0,Saturday,0,Misty,0.82,0.7727,0.52,0.0,184,258,442,121,442,442
14511,2012-09-01,Fall,2012,Sep,19,0,Saturday,0,Light_rainsnow,0.78,0.7424,0.62,0.0,157,235,392,121,392,392
14512,2012-09-01,Fall,2012,Sep,20,0,Saturday,0,Light_rainsnow,0.76,0.7273,0.67,0.2537,67,140,207,121,207,207
14513,2012-09-01,Fall,2012,Sep,21,0,Saturday,0,Light_rainsnow,0.64,0.5758,0.89,0.0,21,83,104,121,104,104
14514,2012-09-01,Fall,2012,Sep,22,0,Saturday,0,Misty,0.66,0.5909,0.89,0.0,21,57,78,121,78,78
14515,2012-09-01,Fall,2012,Sep,23,0,Saturday,0,Clear,0.66,0.5909,0.89,0.0896,57,88,145,121,145,145
14516,2012-09-02,Fall,2012,Sep,0,0,Sunday,0,Misty,0.66,0.5909,0.89,0.0896,27,72,99,120,99,99
14517,2012-09-02,Fall,2012,Sep,1,0,Sunday,0,Clear,0.66,0.5909,0.89,0.0,15,58,73,120,73,73
14518,2012-09-02,Fall,2012,Sep,2,0,Sunday,0,Clear,0.66,0.5909,0.89,0.0,28,56,84,120,84,84
14519,2012-09-02,Fall,2012,Sep,3,0,Sunday,0,Clear,0.66,0.5909,0.89,0.0896,9,33,42,120,42,42
14520,2012-09-02,Fall,2012,Sep,4,0,Sunday,0,Clear,0.66,0.5909,0.89,0.0,7,15,22,120,22,22
14521,2012-09-02,Fall,2012,Sep,5,0,Sunday,0,Clear,0.66,0.5909,0.89,0.0,2,10,12,120,12,12
14522,2012-09-02,Fall,2012,Sep,6,0,Sunday,0,Misty,0.66,0.5909,0.89,0.0,2,13,15,120,15,15
14523,2012-09-02,Fall,2012,Sep,7,0,Sunday,0,Clear,0.66,0.5909,0.94,0.0896,13,29,42,120,42,42
14524,2012-09-02,Fall,2012,Sep,8,0,Sunday,0,Clear,0.68,0.6364,0.89,0.0896,30,99,129,120,129,129
14525,2012-09-02,Fall,2012,Sep,9,0,Sunday,0,Misty,0.7,0.6667,0.84,0.0,88,144,232,120,232,232
14526,2012-09-02,Fall,2012,Sep,10,0,Sunday,0,Misty,0.72,0.697,0.79,0.0,158,230,388,120,388,388
14527,2012-09-02,Fall,2012,Sep,11,0,Sunday,0,Misty,0.74,0.697,0.7,0.0,226,263,489,120,489,489
14528,2012-09-02,Fall,2012,Sep,12,0,Sunday,0,Light_rainsnow,0.74,0.697,0.7,0.0,248,297,545,120,545,545
14529,2012-09-02,Fall,2012,Sep,13,0,Sunday,0,Light_rainsnow,0.72,0.697,0.74,0.0896,263,230,493,120,493,493
14530,2012-09-02,Fall,2012,Sep,14,0,Sunday,0,Light_rainsnow,0.72,0.697,0.79,0.0896,249,208,457,120,457,457
14531,2012-09-02,Fall,2012,Sep,15,0,Sunday,0,Light_rainsnow,0.74,0.7121,0.74,0.1343,179,176,355,120,355,355
14532,2012-09-02,Fall,2012,Sep,16,0,Sunday,0,Clear,0.74,0.697,0.7,0.0,222,252,474,120,474,474
14533,2012-09-02,Fall,2012,Sep,17,0,Sunday,0,Clear,0.76,0.7273,0.66,0.0896,219,284,503,120,503,503
14534,2012-09-02,Fall,2012,Sep,18,0,Sunday,0,Clear,0.74,0.7121,0.74,0.0,227,273,500,120,500,500
14535,2012-09-02,Fall,2012,Sep,19,0,Sunday,0,Misty,0.7,0.6667,0.84,0.2239,140,152,292,120,292,292
14536,2012-09-02,Fall,2012,Sep,20,0,Sunday,0,Misty,0.7,0.6667,0.84,0.1642,63,41,104,120,104,104
14537,2012-09-02,Fall,2012,Sep,21,0,Sunday,0,Clear,0.7,0.6515,0.7,0.1642,79,92,171,120,171,171
14538,2012-09-02,Fall,2012,Sep,22,0,Sunday,0,Light_rainsnow,0.68,0.6364,0.83,0.1343,66,100,166,120,166,166
14539,2012-09-02,Fall,2012,Sep,23,0,Sunday,0,Light_rainsnow,0.66,0.5909,0.89,0.0896,53,70,123,120,123,123
14540,2012-09-03,Fall,2012,Sep,0,1,Monday,0,Misty,0.66,0.5909,0.94,0.0,42,62,104,119,104,104
14541,2012-09-03,Fall,2012,Sep,1,1,Monday,0,Misty,0.68,0.6364,0.89,0.1642,18,37,55,119,55,55
14542,2012-09-03,Fall,2012,Sep,2,1,Monday,0,Clear,0.66,0.5909,0.89,0.1045,10,30,40,119,40,40
14543,2012-09-03,Fall,2012,Sep,3,1,Monday,0,Clear,0.66,0.5909,0.89,0.1343,6,22,28,119,28,28
14544,2012-09-03,Fall,2012,Sep,4,1,Monday,0,Clear,0.66,0.5909,0.89,0.0896,6,5,11,119,11,11
14545,2012-09-03,Fall,2012,Sep,5,1,Monday,0,Clear,0.66,0.5909,0.89,0.0,1,3,4,119,4,4
14546,2012-09-03,Fall,2012,Sep,6,1,Monday,0,Clear,0.66,0.5909,0.94,0.0,3,12,15,119,15,15
14547,2012-09-03,Fall,2012,Sep,7,1,Monday,0,Clear,0.68,0.6364,0.85,0.0,6,37,43,119,43,43
14548,2012-09-03,Fall,2012,Sep,8,1,Monday,0,Misty,0.7,0.6667,0.84,0.1045,36,91,127,119,127,127
14549,2012-09-03,Fall,2012,Sep,9,1,Monday,0,Misty,0.7,0.6667,0.84,0.1343,71,158,229,119,229,229
14550,2012-09-03,Fall,2012,Sep,10,1,Monday,0,Misty,0.74,0.7121,0.74,0.2239,135,224,359,119,359,359
14551,2012-09-03,Fall,2012,Sep,11,1,Monday,0,Misty,0.74,0.697,0.7,0.2836,187,272,459,119,459,459
14552,2012-09-03,Fall,2012,Sep,12,1,Monday,0,Misty,0.76,0.7121,0.62,0.2985,191,352,543,119,543,543
14553,2012-09-03,Fall,2012,Sep,13,1,Monday,0,Misty,0.76,0.7273,0.66,0.2537,209,357,566,119,566,566
14554,2012-09-03,Fall,2012,Sep,14,1,Monday,0,Clear,0.74,0.697,0.7,0.2985,163,349,512,119,512,512
14555,2012-09-03,Fall,2012,Sep,15,1,Monday,0,Clear,0.74,0.697,0.7,0.2239,168,281,449,119,449,449
14556,2012-09-03,Fall,2012,Sep,16,1,Monday,0,Clear,0.74,0.697,0.7,0.2239,165,335,500,119,500,500
14557,2012-09-03,Fall,2012,Sep,17,1,Monday,0,Clear,0.74,0.697,0.7,0.1343,181,317,498,119,498,498
14558,2012-09-03,Fall,2012,Sep,18,1,Monday,0,Clear,0.74,0.697,0.66,0.1642,145,337,482,119,482,482
14559,2012-09-03,Fall,2012,Sep,19,1,Monday,0,Clear,0.72,0.697,0.74,0.194,73,301,374,119,374,374
14560,2012-09-03,Fall,2012,Sep,20,1,Monday,0,Clear,0.72,0.6818,0.76,0.1045,78,183,261,119,261,261
14561,2012-09-03,Fall,2012,Sep,21,1,Monday,0,Clear,0.72,0.6818,0.76,0.1045,42,142,184,119,184,184
14562,2012-09-03,Fall,2012,Sep,22,1,Monday,0,Misty,0.7,0.6667,0.84,0.1343,17,104,121,119,121,121
14563,2012-09-03,Fall,2012,Sep,23,1,Monday,0,Misty,0.7,0.6667,0.84,0.2537,12,58,70,119,70,70
14564,2012-09-04,Fall,2012,Sep,0,0,Tuesday,1,Misty,0.7,0.6667,0.84,0.2537,10,19,29,118,29,29
14565,2012-09-04,Fall,2012,Sep,1,0,Tuesday,1,Clear,0.68,0.6364,0.82,0.1343,15,9,24,118,24,24
14566,2012-09-04,Fall,2012,Sep,2,0,Tuesday,1,Clear,0.68,0.6364,0.82,0.1343,1,4,5,118,5,5
14567,2012-09-04,Fall,2012,Sep,3,0,Tuesday,1,Misty,0.66,0.5909,0.89,0.0896,1,9,10,118,10,10
14568,2012-09-04,Fall,2012,Sep,4,0,Tuesday,1,Misty,0.66,0.5909,0.89,0.0,0,8,8,118,8,8
14569,2012-09-04,Fall,2012,Sep,5,0,Tuesday,1,Misty,0.66,0.5909,0.89,0.0,1,37,38,118,38,38
14570,2012-09-04,Fall,2012,Sep,6,0,Tuesday,1,Misty,0.68,0.6364,0.89,0.1045,7,165,172,118,172,172
14571,2012-09-04,Fall,2012,Sep,7,0,Tuesday,1,Misty,0.68,0.6364,0.89,0.1045,13,480,493,118,493,493
14572,2012-09-04,Fall,2012,Sep,8,0,Tuesday,1,Clear,0.7,0.6667,0.84,0.1642,15,617,632,118,632,632
14573,2012-09-04,Fall,2012,Sep,9,0,Tuesday,1,Misty,0.72,0.697,0.79,0.2239,30,293,323,118,323,323
14574,2012-09-04,Fall,2012,Sep,10,0,Tuesday,1,Misty,0.72,0.697,0.74,0.2537,42,130,172,118,172,172
14575,2012-09-04,Fall,2012,Sep,11,0,Tuesday,1,Misty,0.74,0.697,0.7,0.2836,39,159,198,118,198,198
14576,2012-09-04,Fall,2012,Sep,12,0,Tuesday,1,Clear,0.76,0.7273,0.7,0.2836,54,233,287,118,287,287
14577,2012-09-04,Fall,2012,Sep,13,0,Tuesday,1,Clear,0.8,0.7576,0.55,0.4478,72,203,275,118,275,275
14578,2012-09-04,Fall,2012,Sep,14,0,Tuesday,1,Clear,0.8,0.7576,0.55,0.4179,72,202,274,118,274,274
14579,2012-09-04,Fall,2012,Sep,15,0,Tuesday,1,Clear,0.8,0.7727,0.59,0.4627,68,224,292,118,292,292
14580,2012-09-04,Fall,2012,Sep,16,0,Tuesday,1,Clear,0.76,0.7273,0.7,0.4179,61,397,458,118,458,458
14581,2012-09-04,Fall,2012,Sep,17,0,Tuesday,1,Clear,0.76,0.7273,0.7,0.3582,110,746,856,118,856,856
14582,2012-09-04,Fall,2012,Sep,18,0,Tuesday,1,Clear,0.76,0.7424,0.75,0.2239,94,745,839,118,839,839
14583,2012-09-04,Fall,2012,Sep,19,0,Tuesday,1,Clear,0.76,0.7273,0.7,0.2239,50,502,552,118,552,552
14584,2012-09-04,Fall,2012,Sep,20,0,Tuesday,1,Clear,0.74,0.697,0.7,0.2537,47,338,385,118,385,385
14585,2012-09-04,Fall,2012,Sep,21,0,Tuesday,1,Clear,0.74,0.7121,0.74,0.2537,28,240,268,118,268,268
14586,2012-09-04,Fall,2012,Sep,22,0,Tuesday,1,Clear,0.74,0.697,0.7,0.2836,25,154,179,118,179,179
14587,2012-09-04,Fall,2012,Sep,23,0,Tuesday,1,Clear,0.72,0.697,0.74,0.2985,12,83,95,118,95,95
14588,2012-09-05,Fall,2012,Sep,0,0,Wednesday,1,Clear,0.72,0.697,0.74,0.2537,10,27,37,117,37,37
14589,2012-09-05,Fall,2012,Sep,1,0,Wednesday,1,Clear,0.7,0.6667,0.84,0.194,2,11,13,117,13,13
14590,2012-09-05,Fall,2012,Sep,2,0,Wednesday,1,Clear,0.7,0.6667,0.84,0.194,0,9,9,117,9,9
14591,2012-09-05,Fall,2012,Sep,3,0,Wednesday,1,Clear,0.7,0.6667,0.79,0.2836,0,4,4,117,4,4
14592,2012-09-05,Fall,2012,Sep,4,0,Wednesday,1,Clear,0.7,0.6667,0.79,0.2836,2,3,5,117,5,5
14593,2012-09-05,Fall,2012,Sep,5,0,Wednesday,1,Misty,0.7,0.6667,0.79,0.2985,1,39,40,117,40,40
14594,2012-09-05,Fall,2012,Sep,6,0,Wednesday,1,Clear,0.7,0.6667,0.79,0.2836,7,203,210,117,210,210
14595,2012-09-05,Fall,2012,Sep,7,0,Wednesday,1,Misty,0.7,0.6667,0.79,0.2537,11,489,500,117,500,500
14596,2012-09-05,Fall,2012,Sep,8,0,Wednesday,1,Clear,0.72,0.697,0.74,0.194,33,692,725,117,725,725
14597,2012-09-05,Fall,2012,Sep,9,0,Wednesday,1,Clear,0.74,0.697,0.7,0.2537,27,263,290,117,290,290
14598,2012-09-05,Fall,2012,Sep,10,0,Wednesday,1,Misty,0.76,0.7273,0.7,0.1642,54,181,235,117,235,235
14599,2012-09-05,Fall,2012,Sep,11,0,Wednesday,1,Misty,0.78,0.7424,0.62,0.1642,61,156,217,117,217,217
14600,2012-09-05,Fall,2012,Sep,12,0,Wednesday,1,Clear,0.78,0.7727,0.7,0.1045,49,217,266,117,266,266
14601,2012-09-05,Fall,2012,Sep,13,0,Wednesday,1,Clear,0.8,0.7879,0.63,0.1642,50,184,234,117,234,234
14602,2012-09-05,Fall,2012,Sep,14,0,Wednesday,1,Clear,0.82,0.7879,0.56,0.1045,34,177,211,117,211,211
14603,2012-09-05,Fall,2012,Sep,15,0,Wednesday,1,Clear,0.78,0.7727,0.7,0.194,41,204,245,117,245,245
14604,2012-09-05,Fall,2012,Sep,16,0,Wednesday,1,Clear,0.76,0.7273,0.7,0.2537,86,344,430,117,430,430
14605,2012-09-05,Fall,2012,Sep,17,0,Wednesday,1,Clear,0.76,0.7273,0.66,0.2537,83,780,863,117,863,863
14606,2012-09-05,Fall,2012,Sep,18,0,Wednesday,1,Clear,0.76,0.7424,0.75,0.194,82,757,839,117,839,839
14607,2012-09-05,Fall,2012,Sep,19,0,Wednesday,1,Clear,0.74,0.697,0.7,0.1642,64,598,662,117,662,662
14608,2012-09-05,Fall,2012,Sep,20,0,Wednesday,1,Clear,0.72,0.7121,0.84,0.1642,55,357,412,117,412,412
14609,2012-09-05,Fall,2012,Sep,21,0,Wednesday,1,Clear,0.72,0.697,0.79,0.0,18,278,296,117,296,296
14610,2012-09-05,Fall,2012,Sep,22,0,Wednesday,1,Clear,0.72,0.697,0.79,0.0,38,181,219,117,219,219
14611,2012-09-05,Fall,2012,Sep,23,0,Wednesday,1,Clear,0.7,0.6667,0.84,0.0896,24,126,150,117,150,150
14612,2012-09-06,Fall,2012,Sep,0,0,Thursday,1,Misty,0.7,0.6667,0.84,0.0896,30,35,65,116,65,65
14613,2012-09-06,Fall,2012,Sep,1,0,Thursday,1,Misty,0.7,0.6667,0.84,0.0,2,16,18,116,18,18
14614,2012-09-06,Fall,2012,Sep,2,0,Thursday,1,Clear,0.72,0.697,0.79,0.0,1,7,8,116,8,8
14615,2012-09-06,Fall,2012,Sep,3,0,Thursday,1,Clear,0.7,0.6667,0.84,0.1045,0,9,9,116,9,9
14616,2012-09-06,Fall,2012,Sep,4,0,Thursday,1,Misty,0.7,0.6667,0.84,0.0896,0,8,8,116,8,8
14617,2012-09-06,Fall,2012,Sep,5,0,Thursday,1,Misty,0.7,0.6667,0.84,0.194,3,35,38,116,38,38
14618,2012-09-06,Fall,2012,Sep,6,0,Thursday,1,Misty,0.7,0.6667,0.84,0.0896,11,189,200,116,200,200
14619,2012-09-06,Fall,2012,Sep,7,0,Thursday,1,Misty,0.7,0.6667,0.84,0.1045,21,461,482,116,482,482
14620,2012-09-06,Fall,2012,Sep,8,0,Thursday,1,Light_rainsnow,0.7,0.6667,0.79,0.0,24,622,646,116,646,646
14621,2012-09-06,Fall,2012,Sep,9,0,Thursday,1,Light_rainsnow,0.66,0.5909,0.94,0.1343,8,115,123,116,123,123
14622,2012-09-06,Fall,2012,Sep,10,0,Thursday,1,Light_rainsnow,0.66,0.5909,0.94,0.1343,9,40,49,116,49,49
14623,2012-09-06,Fall,2012,Sep,11,0,Thursday,1,Light_rainsnow,0.7,0.6667,0.84,0.1642,10,52,62,116,62,62
14624,2012-09-06,Fall,2012,Sep,12,0,Thursday,1,Misty,0.72,0.697,0.79,0.2239,11,126,137,116,137,137
14625,2012-09-06,Fall,2012,Sep,13,0,Thursday,1,Misty,0.72,0.697,0.79,0.1045,39,152,191,116,191,191
14626,2012-09-06,Fall,2012,Sep,14,0,Thursday,1,Clear,0.74,0.7121,0.74,0.0896,38,178,216,116,216,216
14627,2012-09-06,Fall,2012,Sep,15,0,Thursday,1,Clear,0.74,0.697,0.66,0.194,42,228,270,116,270,270
14628,2012-09-06,Fall,2012,Sep,16,0,Thursday,1,Clear,0.74,0.697,0.7,0.2239,42,374,416,116,416,416
14629,2012-09-06,Fall,2012,Sep,17,0,Thursday,1,Clear,0.74,0.697,0.7,0.2537,67,741,808,116,808,808
14630,2012-09-06,Fall,2012,Sep,18,0,Thursday,1,Clear,0.72,0.6818,0.7,0.2537,74,761,835,116,835,835
14631,2012-09-06,Fall,2012,Sep,19,0,Thursday,1,Clear,0.68,0.6364,0.74,0.2537,54,504,558,116,558,558
14632,2012-09-06,Fall,2012,Sep,20,0,Thursday,1,Clear,0.66,0.6061,0.78,0.2239,50,356,406,116,406,406
14633,2012-09-06,Fall,2012,Sep,21,0,Thursday,1,Clear,0.64,0.5758,0.89,0.1642,32,240,272,116,272,272
14634,2012-09-06,Fall,2012,Sep,22,0,Thursday,1,Clear,0.64,0.5758,0.89,0.1642,24,193,217,116,217,217
14635,2012-09-06,Fall,2012,Sep,23,0,Thursday,1,Clear,0.64,0.5758,0.89,0.1642,19,150,169,116,169,169
14636,2012-09-07,Fall,2012,Sep,0,0,Friday,1,Clear,0.64,0.5758,0.89,0.1343,17,79,96,115,96,96
14637,2012-09-07,Fall,2012,Sep,1,0,Friday,1,Clear,0.62,0.5606,0.88,0.1045,10,19,29,115,29,29
14638,2012-09-07,Fall,2012,Sep,2,0,Friday,1,Clear,0.62,0.5758,0.83,0.0896,1,10,11,115,11,11
14639,2012-09-07,Fall,2012,Sep,3,0,Friday,1,Clear,0.62,0.5758,0.83,0.0896,0,9,9,115,9,9
14640,2012-09-07,Fall,2012,Sep,4,0,Friday,1,Clear,0.62,0.5606,0.88,0.0,1,7,8,115,8,8
14641,2012-09-07,Fall,2012,Sep,5,0,Friday,1,Clear,0.62,0.5606,0.88,0.0,1,39,40,115,40,40
14642,2012-09-07,Fall,2012,Sep,6,0,Friday,1,Clear,0.62,0.5606,0.88,0.1045,5,135,140,115,140,140
14643,2012-09-07,Fall,2012,Sep,7,0,Friday,1,Clear,0.64,0.5758,0.89,0.1045,21,465,486,115,486,486
14644,2012-09-07,Fall,2012,Sep,8,0,Friday,1,Clear,0.66,0.6061,0.83,0.1045,29,690,719,115,719,719
14645,2012-09-07,Fall,2012,Sep,9,0,Friday,1,Clear,0.7,0.6667,0.79,0.1343,33,311,344,115,344,344
14646,2012-09-07,Fall,2012,Sep,10,0,Friday,1,Clear,0.72,0.697,0.74,0.1343,53,171,224,115,224,224
14647,2012-09-07,Fall,2012,Sep,11,0,Friday,1,Clear,0.76,0.7121,0.62,0.1343,81,215,296,115,296,296
14648,2012-09-07,Fall,2012,Sep,12,0,Friday,1,Clear,0.78,0.7424,0.59,0.1642,76,247,323,115,323,323
14649,2012-09-07,Fall,2012,Sep,13,0,Friday,1,Clear,0.8,0.7727,0.59,0.2537,71,283,354,115,354,354
14650,2012-09-07,Fall,2012,Sep,14,0,Friday,1,Clear,0.8,0.7727,0.59,0.2537,66,187,253,115,253,253
14651,2012-09-07,Fall,2012,Sep,15,0,Friday,1,Clear,0.8,0.7576,0.55,0.2537,66,265,331,115,331,331
14652,2012-09-07,Fall,2012,Sep,16,0,Friday,1,Clear,0.8,0.7576,0.55,0.2836,75,395,470,115,470,470
14653,2012-09-07,Fall,2012,Sep,17,0,Friday,1,Clear,0.78,0.7424,0.59,0.3284,88,684,772,115,772,772
14654,2012-09-07,Fall,2012,Sep,18,0,Friday,1,Clear,0.76,0.7121,0.62,0.2985,95,697,792,115,792,792
14655,2012-09-07,Fall,2012,Sep,19,0,Friday,1,Clear,0.74,0.6818,0.62,0.2836,70,498,568,115,568,568
14656,2012-09-07,Fall,2012,Sep,20,0,Friday,1,Clear,0.72,0.6818,0.66,0.2239,51,340,391,115,391,391
14657,2012-09-07,Fall,2012,Sep,21,0,Friday,1,Clear,0.7,0.6667,0.74,0.1642,55,246,301,115,301,301
14658,2012-09-07,Fall,2012,Sep,22,0,Friday,1,Clear,0.7,0.6667,0.74,0.2239,52,247,299,115,299,299
14659,2012-09-07,Fall,2012,Sep,23,0,Friday,1,Clear,0.66,0.5909,0.89,0.2537,28,220,248,115,248,248
14660,2012-09-08,Fall,2012,Sep,0,0,Saturday,0,Clear,0.66,0.5909,0.89,0.2537,20,130,150,114,150,150
14661,2012-09-08,Fall,2012,Sep,1,0,Saturday,0,Misty,0.66,0.5909,0.89,0.2836,10,107,117,114,117,117
14662,2012-09-08,Fall,2012,Sep,2,0,Saturday,0,Clear,0.66,0.5909,0.89,0.3284,9,68,77,114,77,77
14663,2012-09-08,Fall,2012,Sep,3,0,Saturday,0,Misty,0.66,0.5909,0.89,0.2239,3,40,43,114,43,43
14664,2012-09-08,Fall,2012,Sep,4,0,Saturday,0,Misty,0.66,0.5909,0.94,0.2239,3,8,11,114,11,11
14665,2012-09-08,Fall,2012,Sep,5,0,Saturday,0,Misty,0.66,0.5909,0.94,0.2537,2,13,15,114,15,15
14666,2012-09-08,Fall,2012,Sep,6,0,Saturday,0,Misty,0.66,0.5909,0.89,0.2836,8,26,34,114,34,34
14667,2012-09-08,Fall,2012,Sep,7,0,Saturday,0,Clear,0.66,0.5909,0.89,0.2836,11,71,82,114,82,82
14668,2012-09-08,Fall,2012,Sep,8,0,Saturday,0,Clear,0.7,0.6667,0.79,0.3284,33,197,230,114,230,230
14669,2012-09-08,Fall,2012,Sep,9,0,Saturday,0,Clear,0.7,0.6667,0.74,0.3881,87,261,348,114,348,348
14670,2012-09-08,Fall,2012,Sep,10,0,Saturday,0,Clear,0.74,0.697,0.7,0.3881,100,322,422,114,422,422
14671,2012-09-08,Fall,2012,Sep,11,0,Saturday,0,Clear,0.76,0.7121,0.62,0.4478,173,405,578,114,578,578
14672,2012-09-08,Fall,2012,Sep,12,0,Saturday,0,Clear,0.8,0.7576,0.55,0.4925,220,474,694,114,694,694
14673,2012-09-08,Fall,2012,Sep,13,0,Saturday,0,Clear,0.82,0.7727,0.52,0.5224,233,435,668,114,668,668
14674,2012-09-08,Fall,2012,Sep,14,0,Saturday,0,Clear,0.82,0.7727,0.52,0.4478,260,366,626,114,626,626
14675,2012-09-08,Fall,2012,Sep,15,0,Saturday,0,Light_rainsnow,0.56,0.5303,0.88,0.2537,175,337,512,114,512,512
14676,2012-09-08,Fall,2012,Sep,16,0,Saturday,0,Light_rainsnow,0.56,0.5303,0.88,0.194,19,95,114,114,114,114
14677,2012-09-08,Fall,2012,Sep,17,0,Saturday,0,Light_rainsnow,0.58,0.5455,0.83,0.194,52,119,171,114,171,171
14678,2012-09-08,Fall,2012,Sep,18,0,Saturday,0,Light_rainsnow,0.58,0.5455,0.83,0.1343,27,140,167,114,167,167
14679,2012-09-08,Fall,2012,Sep,19,0,Saturday,0,Light_rainsnow,0.58,0.5455,0.88,0.1045,28,187,215,114,215,215
14680,2012-09-08,Fall,2012,Sep,20,0,Saturday,0,Misty,0.58,0.5455,0.88,0.0896,28,166,194,114,194,194
14681,2012-09-08,Fall,2012,Sep,21,0,Saturday,0,Misty,0.6,0.5606,0.83,0.1642,26,155,181,114,181,181
14682,2012-09-08,Fall,2012,Sep,22,0,Saturday,0,Misty,0.58,0.5455,0.78,0.2985,18,176,194,114,194,194
14683,2012-09-08,Fall,2012,Sep,23,0,Saturday,0,Misty,0.58,0.5455,0.73,0.1642,12,121,133,114,133,133
14684,2012-09-09,Fall,2012,Sep,0,0,Sunday,0,Misty,0.56,0.5303,0.73,0.194,18,106,124,113,124,124
14685,2012-09-09,Fall,2012,Sep,1,0,Sunday,0,Clear,0.56,0.5303,0.73,0.2239,20,104,124,113,124,124
14686,2012-09-09,Fall,2012,Sep,2,0,Sunday,0,Clear,0.54,0.5152,0.77,0.2836,15,81,96,113,96,96
14687,2012-09-09,Fall,2012,Sep,3,0,Sunday,0,Clear,0.54,0.5152,0.73,0.2239,14,32,46,113,46,46
14688,2012-09-09,Fall,2012,Sep,4,0,Sunday,0,Clear,0.52,0.5,0.77,0.2537,12,16,28,113,28,28
14689,2012-09-09,Fall,2012,Sep,5,0,Sunday,0,Clear,0.52,0.5,0.77,0.194,16,39,55,113,55,55
14690,2012-09-09,Fall,2012,Sep,6,0,Sunday,0,Clear,0.52,0.5,0.77,0.194,11,24,35,113,35,35
14691,2012-09-09,Fall,2012,Sep,7,0,Sunday,0,Clear,0.54,0.5152,0.73,0.1642,20,50,70,113,70,70
14692,2012-09-09,Fall,2012,Sep,8,0,Sunday,0,Clear,0.58,0.5455,0.68,0.2239,27,143,170,113,170,170
14693,2012-09-09,Fall,2012,Sep,9,0,Sunday,0,Clear,0.62,0.6061,0.61,0.2537,85,214,299,113,299,299
14694,2012-09-09,Fall,2012,Sep,10,0,Sunday,0,Clear,0.64,0.6212,0.57,0.2985,172,323,495,113,495,495
14695,2012-09-09,Fall,2012,Sep,11,0,Sunday,0,Clear,0.66,0.6212,0.47,0.2537,194,391,585,113,585,585
14696,2012-09-09,Fall,2012,Sep,12,0,Sunday,0,Clear,0.66,0.6212,0.47,0.0,247,510,757,113,757,757
14697,2012-09-09,Fall,2012,Sep,13,0,Sunday,0,Clear,0.68,0.6364,0.39,0.0,238,491,729,113,729,729
14698,2012-09-09,Fall,2012,Sep,14,0,Sunday,0,Clear,0.72,0.6515,0.3,0.2836,232,415,647,113,647,647
14699,2012-09-09,Fall,2012,Sep,15,0,Sunday,0,Clear,0.72,0.6515,0.32,0.2537,284,412,696,113,696,696
14700,2012-09-09,Fall,2012,Sep,16,0,Sunday,0,Clear,0.68,0.6364,0.36,0.2836,228,473,701,113,701,701
14701,2012-09-09,Fall,2012,Sep,17,0,Sunday,0,Clear,0.7,0.6364,0.37,0.2537,213,458,671,113,671,671
14702,2012-09-09,Fall,2012,Sep,18,0,Sunday,0,Clear,0.66,0.6212,0.36,0.2537,156,404,560,113,560,560
14703,2012-09-09,Fall,2012,Sep,19,0,Sunday,0,Clear,0.66,0.6212,0.36,0.2537,134,362,496,113,496,496
14704,2012-09-09,Fall,2012,Sep,20,0,Sunday,0,Clear,0.62,0.6212,0.41,0.2836,91,265,356,113,356,356
14705,2012-09-09,Fall,2012,Sep,21,0,Sunday,0,Clear,0.6,0.6212,0.46,0.2239,57,149,206,113,206,206
14706,2012-09-09,Fall,2012,Sep,22,0,Sunday,0,Clear,0.58,0.5455,0.49,0.2537,64,125,189,113,189,189
14707,2012-09-09,Fall,2012,Sep,23,0,Sunday,0,Clear,0.56,0.5303,0.52,0.2836,22,70,92,113,92,92
14708,2012-09-10,Fall,2012,Sep,0,0,Monday,1,Clear,0.56,0.5303,0.52,0.2836,6,35,41,112,41,41
14709,2012-09-10,Fall,2012,Sep,1,0,Monday,1,Clear,0.54,0.5152,0.6,0.194,7,11,18,112,18,18
14710,2012-09-10,Fall,2012,Sep,2,0,Monday,1,Clear,0.54,0.5152,0.6,0.3582,11,6,17,112,17,17
14711,2012-09-10,Fall,2012,Sep,3,0,Monday,1,Clear,0.52,0.5,0.68,0.2836,5,7,12,112,12,12
14712,2012-09-10,Fall,2012,Sep,4,0,Monday,1,Clear,0.52,0.5,0.68,0.2836,1,4,5,112,5,5
14713,2012-09-10,Fall,2012,Sep,5,0,Monday,1,Clear,0.5,0.4848,0.72,0.2537,4,36,40,112,40,40
14714,2012-09-10,Fall,2012,Sep,6,0,Monday,1,Clear,0.5,0.4848,0.72,0.1343,8,172,180,112,180,180
14715,2012-09-10,Fall,2012,Sep,7,0,Monday,1,Clear,0.52,0.5,0.68,0.2239,20,427,447,112,447,447
14716,2012-09-10,Fall,2012,Sep,8,0,Monday,1,Clear,0.56,0.5303,0.6,0.2836,33,697,730,112,730,730
14717,2012-09-10,Fall,2012,Sep,9,0,Monday,1,Clear,0.6,0.6212,0.53,0.2985,40,321,361,112,361,361
14718,2012-09-10,Fall,2012,Sep,10,0,Monday,1,Clear,0.62,0.6212,0.5,0.2836,42,168,210,112,210,210
14719,2012-09-10,Fall,2012,Sep,11,0,Monday,1,Clear,0.62,0.6212,0.43,0.2985,69,167,236,112,236,236
14720,2012-09-10,Fall,2012,Sep,12,0,Monday,1,Clear,0.64,0.6212,0.44,0.3881,76,256,332,112,332,332
14721,2012-09-10,Fall,2012,Sep,13,0,Monday,1,Clear,0.64,0.6212,0.38,0.2239,72,251,323,112,323,323
14722,2012-09-10,Fall,2012,Sep,14,0,Monday,1,Clear,0.66,0.6212,0.36,0.2836,107,233,340,112,340,340
14723,2012-09-10,Fall,2012,Sep,15,0,Monday,1,Clear,0.66,0.6212,0.31,0.3881,115,231,346,112,346,346
14724,2012-09-10,Fall,2012,Sep,16,0,Monday,1,Clear,0.66,0.6212,0.34,0.3284,108,380,488,112,488,488
14725,2012-09-10,Fall,2012,Sep,17,0,Monday,1,Clear,0.66,0.6212,0.34,0.3284,127,744,871,112,871,871
14726,2012-09-10,Fall,2012,Sep,18,0,Monday,1,Clear,0.62,0.6212,0.35,0.2985,111,857,968,112,968,968
14727,2012-09-10,Fall,2012,Sep,19,0,Monday,1,Clear,0.62,0.6212,0.38,0.2985,71,562,633,112,633,633
14728,2012-09-10,Fall,2012,Sep,20,0,Monday,1,Clear,0.6,0.6212,0.4,0.194,34,356,390,112,390,390
14729,2012-09-10,Fall,2012,Sep,21,0,Monday,1,Clear,0.56,0.5303,0.49,0.1642,29,256,285,112,285,285
14730,2012-09-10,Fall,2012,Sep,22,0,Monday,1,Clear,0.54,0.5152,0.52,0.1343,15,144,159,112,159,159
14731,2012-09-10,Fall,2012,Sep,23,0,Monday,1,Clear,0.54,0.5152,0.52,0.0,7,86,93,112,93,93
14732,2012-09-11,Fall,2012,Sep,0,0,Tuesday,1,Clear,0.52,0.5,0.59,0.1045,5,27,32,111,32,32
14733,2012-09-11,Fall,2012,Sep,1,0,Tuesday,1,Clear,0.5,0.4848,0.63,0.0,0,10,10,111,10,10
14734,2012-09-11,Fall,2012,Sep,2,0,Tuesday,1,Clear,0.48,0.4697,0.77,0.1642,1,5,6,111,6,6
14735,2012-09-11,Fall,2012,Sep,3,0,Tuesday,1,Clear,0.48,0.4697,0.67,0.1343,1,7,8,111,8,8
14736,2012-09-11,Fall,2012,Sep,4,0,Tuesday,1,Clear,0.48,0.4697,0.72,0.1045,1,8,9,111,9,9
14737,2012-09-11,Fall,2012,Sep,5,0,Tuesday,1,Clear,0.46,0.4545,0.72,0.0896,3,41,44,111,44,44
14738,2012-09-11,Fall,2012,Sep,6,0,Tuesday,1,Clear,0.46,0.4545,0.77,0.1045,11,200,211,111,211,211
14739,2012-09-11,Fall,2012,Sep,7,0,Tuesday,1,Clear,0.5,0.4848,0.72,0.1045,24,572,596,111,596,596
14740,2012-09-11,Fall,2012,Sep,8,0,Tuesday,1,Clear,0.54,0.5152,0.68,0.0896,48,702,750,111,750,750
14741,2012-09-11,Fall,2012,Sep,9,0,Tuesday,1,Clear,0.6,0.6212,0.49,0.0,35,323,358,111,358,358
14742,2012-09-11,Fall,2012,Sep,10,0,Tuesday,1,Clear,0.62,0.6212,0.38,0.0,54,142,196,111,196,196
14743,2012-09-11,Fall,2012,Sep,11,0,Tuesday,1,Clear,0.64,0.6212,0.33,0.0896,60,187,247,111,247,247
14744,2012-09-11,Fall,2012,Sep,12,0,Tuesday,1,Clear,0.64,0.6212,0.33,0.0,62,254,316,111,316,316
14745,2012-09-11,Fall,2012,Sep,13,0,Tuesday,1,Clear,0.66,0.6212,0.29,0.0896,72,256,328,111,328,328
14746,2012-09-11,Fall,2012,Sep,14,0,Tuesday,1,Clear,0.68,0.6212,0.3,0.0896,74,181,255,111,255,255
14747,2012-09-11,Fall,2012,Sep,15,0,Tuesday,1,Clear,0.7,0.6364,0.28,0.1045,73,253,326,111,326,326
14748,2012-09-11,Fall,2012,Sep,16,0,Tuesday,1,Clear,0.7,0.6364,0.28,0.1343,99,437,536,111,536,536
14749,2012-09-11,Fall,2012,Sep,17,0,Tuesday,1,Clear,0.7,0.6364,0.28,0.0,168,802,970,111,970,970
14750,2012-09-11,Fall,2012,Sep,18,0,Tuesday,1,Clear,0.64,0.6212,0.36,0.1642,110,767,877,111,877,877
14751,2012-09-11,Fall,2012,Sep,19,0,Tuesday,1,Clear,0.62,0.6212,0.41,0.194,56,540,596,111,596,596
14752,2012-09-11,Fall,2012,Sep,20,0,Tuesday,1,Clear,0.58,0.5455,0.56,0.1343,40,421,461,111,461,461
14753,2012-09-11,Fall,2012,Sep,21,0,Tuesday,1,Clear,0.56,0.5303,0.6,0.1045,28,282,310,111,310,310
14754,2012-09-11,Fall,2012,Sep,22,0,Tuesday,1,Clear,0.56,0.5303,0.64,0.1045,27,189,216,111,216,216
14755,2012-09-11,Fall,2012,Sep,23,0,Tuesday,1,Clear,0.54,0.5152,0.68,0.1045,18,91,109,111,109,109
14756,2012-09-12,Fall,2012,Sep,0,0,Wednesday,1,Clear,0.52,0.5,0.72,0.1045,8,41,49,110,49,49
14757,2012-09-12,Fall,2012,Sep,1,0,Wednesday,1,Clear,0.52,0.5,0.72,0.1045,2,19,21,110,21,21
14758,2012-09-12,Fall,2012,Sep,2,0,Wednesday,1,Clear,0.52,0.5,0.72,0.0896,2,9,11,110,11,11
14759,2012-09-12,Fall,2012,Sep,3,0,Wednesday,1,Clear,0.5,0.4848,0.77,0.0896,0,7,7,110,7,7
14760,2012-09-12,Fall,2012,Sep,4,0,Wednesday,1,Clear,0.5,0.4848,0.72,0.0896,0,5,5,110,5,5
14761,2012-09-12,Fall,2012,Sep,5,0,Wednesday,1,Clear,0.5,0.4848,0.72,0.0896,4,44,48,110,48,48
14762,2012-09-12,Fall,2012,Sep,6,0,Wednesday,1,Clear,0.5,0.4848,0.72,0.0896,6,199,205,110,205,205
14763,2012-09-12,Fall,2012,Sep,7,0,Wednesday,1,Clear,0.52,0.5,0.72,0.0,24,533,557,110,557,557
14764,2012-09-12,Fall,2012,Sep,8,0,Wednesday,1,Clear,0.56,0.5303,0.64,0.1045,43,727,770,110,770,770
14765,2012-09-12,Fall,2012,Sep,9,0,Wednesday,1,Clear,0.6,0.6061,0.64,0.1343,50,278,328,110,328,328
14766,2012-09-12,Fall,2012,Sep,10,0,Wednesday,1,Clear,0.62,0.6061,0.61,0.1343,57,148,205,110,205,205
14767,2012-09-12,Fall,2012,Sep,11,0,Wednesday,1,Clear,0.66,0.6212,0.5,0.194,51,181,232,110,232,232
14768,2012-09-12,Fall,2012,Sep,12,0,Wednesday,1,Clear,0.68,0.6364,0.36,0.1343,88,264,352,110,352,352
14769,2012-09-12,Fall,2012,Sep,13,0,Wednesday,1,Clear,0.7,0.6364,0.34,0.1343,85,238,323,110,323,323
14770,2012-09-12,Fall,2012,Sep,14,0,Wednesday,1,Clear,0.7,0.6364,0.37,0.1642,78,200,278,110,278,278
14771,2012-09-12,Fall,2012,Sep,15,0,Wednesday,1,Clear,0.72,0.6515,0.37,0.1343,75,243,318,110,318,318
14772,2012-09-12,Fall,2012,Sep,16,0,Wednesday,1,Clear,0.72,0.6515,0.37,0.1642,90,419,509,110,509,509
14773,2012-09-12,Fall,2012,Sep,17,0,Wednesday,1,Clear,0.7,0.6364,0.41,0.2985,114,811,925,110,925,925
14774,2012-09-12,Fall,2012,Sep,18,0,Wednesday,1,Clear,0.66,0.6212,0.44,0.2537,91,886,977,110,977,977
14775,2012-09-12,Fall,2012,Sep,19,0,Wednesday,1,Clear,0.64,0.6212,0.5,0.194,78,557,635,110,635,635
14776,2012-09-12,Fall,2012,Sep,20,0,Wednesday,1,Clear,0.62,0.6212,0.57,0.1343,38,432,470,110,470,470
14777,2012-09-12,Fall,2012,Sep,21,0,Wednesday,1,Clear,0.6,0.6061,0.6,0.1343,27,279,306,110,306,306
14778,2012-09-12,Fall,2012,Sep,22,0,Wednesday,1,Clear,0.56,0.5303,0.64,0.0896,23,189,212,110,212,212
14779,2012-09-12,Fall,2012,Sep,23,0,Wednesday,1,Clear,0.56,0.5303,0.68,0.1045,16,111,127,110,127,127
14780,2012-09-13,Fall,2012,Sep,0,0,Thursday,1,Clear,0.56,0.5303,0.73,0.0896,11,46,57,109,57,57
14781,2012-09-13,Fall,2012,Sep,1,0,Thursday,1,Clear,0.54,0.5152,0.77,0.0896,6,22,28,109,28,28
14782,2012-09-13,Fall,2012,Sep,2,0,Thursday,1,Clear,0.54,0.5152,0.77,0.0,0,9,9,109,9,9
14783,2012-09-13,Fall,2012,Sep,3,0,Thursday,1,Clear,0.52,0.5,0.83,0.0,2,9,11,109,11,11
14784,2012-09-13,Fall,2012,Sep,4,0,Thursday,1,Clear,0.52,0.5,0.83,0.0,0,6,6,109,6,6
14785,2012-09-13,Fall,2012,Sep,5,0,Thursday,1,Clear,0.52,0.5,0.83,0.0,3,54,57,109,57,57
14786,2012-09-13,Fall,2012,Sep,6,0,Thursday,1,Clear,0.5,0.4848,0.82,0.0,9,186,195,109,195,195
14787,2012-09-13,Fall,2012,Sep,7,0,Thursday,1,Clear,0.54,0.5152,0.77,0.0,22,549,571,109,571,571
14788,2012-09-13,Fall,2012,Sep,8,0,Thursday,1,Clear,0.56,0.5303,0.73,0.0,33,725,758,109,758,758
14789,2012-09-13,Fall,2012,Sep,9,0,Thursday,1,Clear,0.6,0.6061,0.64,0.0896,46,292,338,109,338,338
14790,2012-09-13,Fall,2012,Sep,10,0,Thursday,1,Clear,0.64,0.6212,0.61,0.0896,63,149,212,109,212,212
14791,2012-09-13,Fall,2012,Sep,11,0,Thursday,1,Clear,0.66,0.6212,0.5,0.1642,71,183,254,109,254,254
14792,2012-09-13,Fall,2012,Sep,12,0,Thursday,1,Clear,0.68,0.6364,0.44,0.1045,57,240,297,109,297,297
14793,2012-09-13,Fall,2012,Sep,13,0,Thursday,1,Clear,0.7,0.6364,0.42,0.0,60,223,283,109,283,283
14794,2012-09-13,Fall,2012,Sep,14,0,Thursday,1,Clear,0.72,0.6515,0.39,0.1343,60,214,274,109,274,274
14795,2012-09-13,Fall,2012,Sep,15,0,Thursday,1,Clear,0.72,0.6515,0.42,0.1045,99,253,352,109,352,352
14796,2012-09-13,Fall,2012,Sep,16,0,Thursday,1,Clear,0.72,0.6515,0.39,0.0896,85,406,491,109,491,491
14797,2012-09-13,Fall,2012,Sep,17,0,Thursday,1,Clear,0.72,0.6515,0.42,0.194,97,787,884,109,884,884
14798,2012-09-13,Fall,2012,Sep,18,0,Thursday,1,Clear,0.68,0.6364,0.57,0.2537,108,744,852,109,852,852
14799,2012-09-13,Fall,2012,Sep,19,0,Thursday,1,Clear,0.64,0.6061,0.65,0.1343,80,594,674,109,674,674
14800,2012-09-13,Fall,2012,Sep,20,0,Thursday,1,Clear,0.62,0.6061,0.69,0.1045,55,408,463,109,463,463
14801,2012-09-13,Fall,2012,Sep,21,0,Thursday,1,Clear,0.62,0.6061,0.65,0.1045,26,291,317,109,317,317
14802,2012-09-13,Fall,2012,Sep,22,0,Thursday,1,Clear,0.6,0.5909,0.69,0.1343,28,223,251,109,251,251
14803,2012-09-13,Fall,2012,Sep,23,0,Thursday,1,Clear,0.58,0.5455,0.73,0.1045,33,137,170,109,170,170
14804,2012-09-14,Fall,2012,Sep,0,0,Friday,1,Clear,0.56,0.5303,0.73,0.0896,24,63,87,108,87,87
14805,2012-09-14,Fall,2012,Sep,1,0,Friday,1,Clear,0.56,0.5303,0.73,0.0896,6,35,41,108,41,41
14806,2012-09-14,Fall,2012,Sep,2,0,Friday,1,Clear,0.56,0.5303,0.73,0.0,7,23,30,108,30,30
14807,2012-09-14,Fall,2012,Sep,3,0,Friday,1,Clear,0.54,0.5152,0.77,0.0,5,9,14,108,14,14
14808,2012-09-14,Fall,2012,Sep,4,0,Friday,1,Clear,0.54,0.5152,0.77,0.0,1,11,12,108,12,12
14809,2012-09-14,Fall,2012,Sep,5,0,Friday,1,Clear,0.54,0.5152,0.83,0.0,1,40,41,108,41,41
14810,2012-09-14,Fall,2012,Sep,6,0,Friday,1,Clear,0.54,0.5152,0.88,0.0,8,144,152,108,152,152
14811,2012-09-14,Fall,2012,Sep,7,0,Friday,1,Misty,0.56,0.5303,0.88,0.0,17,437,454,108,454,454
14812,2012-09-14,Fall,2012,Sep,8,0,Friday,1,Misty,0.6,0.5758,0.78,0.1642,51,715,766,108,766,766
14813,2012-09-14,Fall,2012,Sep,9,0,Friday,1,Misty,0.62,0.5909,0.78,0.1642,46,301,347,108,347,347
14814,2012-09-14,Fall,2012,Sep,10,0,Friday,1,Misty,0.68,0.6364,0.65,0.0,75,171,246,108,246,246
14815,2012-09-14,Fall,2012,Sep,11,0,Friday,1,Misty,0.68,0.6364,0.61,0.1045,84,196,280,108,280,280
14816,2012-09-14,Fall,2012,Sep,12,0,Friday,1,Misty,0.7,0.6515,0.54,0.194,119,290,409,108,409,409
14817,2012-09-14,Fall,2012,Sep,13,0,Friday,1,Misty,0.7,0.6515,0.54,0.194,107,301,408,108,408,408
14818,2012-09-14,Fall,2012,Sep,14,0,Friday,1,Misty,0.72,0.6515,0.45,0.1642,113,258,371,108,371,371
14819,2012-09-14,Fall,2012,Sep,15,0,Friday,1,Misty,0.72,0.6667,0.48,0.1343,94,273,367,108,367,367
14820,2012-09-14,Fall,2012,Sep,16,0,Friday,1,Misty,0.72,0.6667,0.51,0.0,109,454,563,108,563,563
14821,2012-09-14,Fall,2012,Sep,17,0,Friday,1,Clear,0.72,0.6667,0.51,0.194,137,757,894,108,894,894
14822,2012-09-14,Fall,2012,Sep,18,0,Friday,1,Clear,0.72,0.6515,0.45,0.2239,116,692,808,108,808,808
14823,2012-09-14,Fall,2012,Sep,19,0,Friday,1,Clear,0.68,0.6364,0.57,0.1642,83,496,579,108,579,579
14824,2012-09-14,Fall,2012,Sep,20,0,Friday,1,Clear,0.66,0.6212,0.61,0.1045,67,337,404,108,404,404
14825,2012-09-14,Fall,2012,Sep,21,0,Friday,1,Clear,0.64,0.6061,0.73,0.2239,42,270,312,108,312,312
14826,2012-09-14,Fall,2012,Sep,22,0,Friday,1,Clear,0.62,0.5758,0.83,0.194,40,189,229,108,229,229
14827,2012-09-14,Fall,2012,Sep,23,0,Friday,1,Clear,0.62,0.5909,0.78,0.0896,27,168,195,108,195,195
14828,2012-09-15,Fall,2012,Sep,0,0,Saturday,0,Clear,0.6,0.5606,0.83,0.1045,38,169,207,107,207,207
14829,2012-09-15,Fall,2012,Sep,1,0,Saturday,0,Clear,0.6,0.5909,0.73,0.0,8,101,109,107,109,109
14830,2012-09-15,Fall,2012,Sep,2,0,Saturday,0,Clear,0.58,0.5455,0.78,0.1045,18,75,93,107,93,93
14831,2012-09-15,Fall,2012,Sep,3,0,Saturday,0,Clear,0.6,0.5909,0.73,0.2537,6,31,37,107,37,37
14832,2012-09-15,Fall,2012,Sep,4,0,Saturday,0,Misty,0.6,0.5909,0.69,0.3582,3,3,6,107,6,6
14833,2012-09-15,Fall,2012,Sep,5,0,Saturday,0,Clear,0.58,0.5455,0.6,0.5224,1,15,16,107,16,16
14834,2012-09-15,Fall,2012,Sep,6,0,Saturday,0,Clear,0.54,0.5152,0.49,0.4179,6,27,33,107,33,33
14835,2012-09-15,Fall,2012,Sep,7,0,Saturday,0,Clear,0.54,0.5152,0.52,0.2836,10,63,73,107,73,73
14836,2012-09-15,Fall,2012,Sep,8,0,Saturday,0,Clear,0.56,0.5303,0.49,0.4179,43,169,212,107,212,212
14837,2012-09-15,Fall,2012,Sep,9,0,Saturday,0,Clear,0.6,0.6212,0.43,0.4179,79,263,342,107,342,342
14838,2012-09-15,Fall,2012,Sep,10,0,Saturday,0,Clear,0.62,0.6212,0.41,0.3881,119,323,442,107,442,442
14839,2012-09-15,Fall,2012,Sep,11,0,Saturday,0,Clear,0.64,0.6212,0.38,0.3881,228,399,627,107,627,627
14840,2012-09-15,Fall,2012,Sep,12,0,Saturday,0,Clear,0.66,0.6212,0.36,0.3582,287,419,706,107,706,706
14841,2012-09-15,Fall,2012,Sep,13,0,Saturday,0,Clear,0.68,0.6364,0.36,0.194,327,377,704,107,704,704
14842,2012-09-15,Fall,2012,Sep,14,0,Saturday,0,Clear,0.68,0.6364,0.34,0.3284,325,390,715,107,715,715
14843,2012-09-15,Fall,2012,Sep,15,0,Saturday,0,Misty,0.68,0.6364,0.34,0.2836,312,342,654,107,654,654
14844,2012-09-15,Fall,2012,Sep,16,0,Saturday,0,Misty,0.66,0.6212,0.36,0.2239,350,433,783,107,783,783
14845,2012-09-15,Fall,2012,Sep,17,0,Saturday,0,Misty,0.66,0.6212,0.36,0.2537,295,434,729,107,729,729
14846,2012-09-15,Fall,2012,Sep,18,0,Saturday,0,Misty,0.64,0.6212,0.36,0.2836,232,382,614,107,614,614
14847,2012-09-15,Fall,2012,Sep,19,0,Saturday,0,Clear,0.62,0.6212,0.41,0.1642,169,309,478,107,478,478
14848,2012-09-15,Fall,2012,Sep,20,0,Saturday,0,Clear,0.6,0.6212,0.43,0.0896,89,241,330,107,330,330
14849,2012-09-15,Fall,2012,Sep,21,0,Saturday,0,Clear,0.56,0.5303,0.52,0.1045,86,210,296,107,296,296
14850,2012-09-15,Fall,2012,Sep,22,0,Saturday,0,Clear,0.56,0.5303,0.52,0.0,82,197,279,107,279,279
14851,2012-09-15,Fall,2012,Sep,23,0,Saturday,0,Clear,0.54,0.5152,0.6,0.0,47,182,229,107,229,229
14852,2012-09-16,Fall,2012,Sep,0,0,Sunday,0,Clear,0.54,0.5152,0.64,0.0,28,123,151,106,151,151
14853,2012-09-16,Fall,2012,Sep,1,0,Sunday,0,Clear,0.54,0.5152,0.64,0.0,35,82,117,106,117,117
14854,2012-09-16,Fall,2012,Sep,2,0,Sunday,0,Clear,0.52,0.5,0.63,0.0,27,62,89,106,89,89
14855,2012-09-16,Fall,2012,Sep,3,0,Sunday,0,Clear,0.5,0.4848,0.68,0.0,10,38,48,106,48,48
14856,2012-09-16,Fall,2012,Sep,4,0,Sunday,0,Clear,0.5,0.4848,0.72,0.0,2,6,8,106,8,8
14857,2012-09-16,Fall,2012,Sep,5,0,Sunday,0,Clear,0.5,0.4848,0.72,0.0,3,10,13,106,13,13
14858,2012-09-16,Fall,2012,Sep,6,0,Sunday,0,Clear,0.5,0.4848,0.72,0.0,9,26,35,106,35,35
14859,2012-09-16,Fall,2012,Sep,7,0,Sunday,0,Clear,0.5,0.4848,0.77,0.1045,28,43,71,106,71,71
14860,2012-09-16,Fall,2012,Sep,8,0,Sunday,0,Clear,0.54,0.5152,0.64,0.1642,34,94,128,106,128,128
14861,2012-09-16,Fall,2012,Sep,9,0,Sunday,0,Clear,0.58,0.5455,0.6,0.1343,70,226,296,106,296,296
14862,2012-09-16,Fall,2012,Sep,10,0,Sunday,0,Clear,0.62,0.6212,0.5,0.1045,160,330,490,106,490,490
14863,2012-09-16,Fall,2012,Sep,11,0,Sunday,0,Clear,0.64,0.6212,0.47,0.1642,183,376,559,106,559,559
14864,2012-09-16,Fall,2012,Sep,12,0,Sunday,0,Clear,0.66,0.6212,0.44,0.1642,188,468,656,106,656,656
14865,2012-09-16,Fall,2012,Sep,13,0,Sunday,0,Clear,0.64,0.6212,0.41,0.1642,240,454,694,106,694,694
14866,2012-09-16,Fall,2012,Sep,14,0,Sunday,0,Clear,0.66,0.6212,0.39,0.1343,225,410,635,106,635,635
14867,2012-09-16,Fall,2012,Sep,15,0,Sunday,0,Clear,0.64,0.6212,0.41,0.1642,215,342,557,106,557,557
14868,2012-09-16,Fall,2012,Sep,16,0,Sunday,0,Clear,0.64,0.6212,0.44,0.1642,194,402,596,106,596,596
14869,2012-09-16,Fall,2012,Sep,17,0,Sunday,0,Clear,0.66,0.6212,0.41,0.0,177,393,570,106,570,570
14870,2012-09-16,Fall,2012,Sep,18,0,Sunday,0,Clear,0.62,0.6212,0.5,0.1642,120,361,481,106,481,481
14871,2012-09-16,Fall,2012,Sep,19,0,Sunday,0,Clear,0.62,0.6212,0.5,0.1343,91,312,403,106,403,403
14872,2012-09-16,Fall,2012,Sep,20,0,Sunday,0,Clear,0.6,0.6212,0.53,0.1045,57,267,324,106,324,324
14873,2012-09-16,Fall,2012,Sep,21,0,Sunday,0,Clear,0.6,0.6212,0.56,0.1045,43,148,191,106,191,191
14874,2012-09-16,Fall,2012,Sep,22,0,Sunday,0,Clear,0.56,0.5303,0.68,0.0896,18,109,127,106,127,127
14875,2012-09-16,Fall,2012,Sep,23,0,Sunday,0,Clear,0.54,0.5152,0.68,0.1045,9,85,94,106,94,94
14876,2012-09-17,Fall,2012,Sep,0,0,Monday,1,Clear,0.54,0.5152,0.68,0.1642,14,31,45,105,45,45
14877,2012-09-17,Fall,2012,Sep,1,0,Monday,1,Clear,0.52,0.5,0.72,0.0896,9,12,21,105,21,21
14878,2012-09-17,Fall,2012,Sep,2,0,Monday,1,Clear,0.52,0.5,0.72,0.0,5,8,13,105,13,13
14879,2012-09-17,Fall,2012,Sep,3,0,Monday,1,Clear,0.5,0.4848,0.77,0.0896,0,7,7,105,7,7
14880,2012-09-17,Fall,2012,Sep,4,0,Monday,1,Clear,0.5,0.4848,0.77,0.0,2,9,11,105,11,11
14881,2012-09-17,Fall,2012,Sep,5,0,Monday,1,Clear,0.48,0.4697,0.82,0.0896,1,44,45,105,45,45
14882,2012-09-17,Fall,2012,Sep,6,0,Monday,1,Clear,0.48,0.4697,0.82,0.0,7,157,164,105,164,164
14883,2012-09-17,Fall,2012,Sep,7,0,Monday,1,Clear,0.52,0.5,0.77,0.0,18,474,492,105,492,492
14884,2012-09-17,Fall,2012,Sep,8,0,Monday,1,Clear,0.54,0.5152,0.77,0.0896,36,647,683,105,683,683
14885,2012-09-17,Fall,2012,Sep,9,0,Monday,1,Clear,0.58,0.5455,0.68,0.1343,34,265,299,105,299,299
14886,2012-09-17,Fall,2012,Sep,10,0,Monday,1,Misty,0.62,0.6061,0.65,0.194,73,129,202,105,202,202
14887,2012-09-17,Fall,2012,Sep,11,0,Monday,1,Misty,0.62,0.6061,0.69,0.2239,61,191,252,105,252,252
14888,2012-09-17,Fall,2012,Sep,12,0,Monday,1,Misty,0.62,0.6061,0.69,0.194,62,233,295,105,295,295
14889,2012-09-17,Fall,2012,Sep,13,0,Monday,1,Clear,0.64,0.6061,0.65,0.2537,112,231,343,105,343,343
14890,2012-09-17,Fall,2012,Sep,14,0,Monday,1,Misty,0.64,0.6061,0.65,0.2537,129,203,332,105,332,332
14891,2012-09-17,Fall,2012,Sep,15,0,Monday,1,Misty,0.64,0.6061,0.65,0.2537,82,256,338,105,338,338
14892,2012-09-17,Fall,2012,Sep,16,0,Monday,1,Misty,0.64,0.6061,0.69,0.2537,74,379,453,105,453,453
14893,2012-09-17,Fall,2012,Sep,17,0,Monday,1,Misty,0.64,0.6061,0.65,0.2239,102,740,842,105,842,842
14894,2012-09-17,Fall,2012,Sep,18,0,Monday,1,Misty,0.62,0.5909,0.73,0.1642,66,708,774,105,774,774
14895,2012-09-17,Fall,2012,Sep,19,0,Monday,1,Misty,0.62,0.5909,0.73,0.1045,51,435,486,105,486,486
14896,2012-09-17,Fall,2012,Sep,20,0,Monday,1,Misty,0.62,0.5909,0.73,0.1343,32,308,340,105,340,340
14897,2012-09-17,Fall,2012,Sep,21,0,Monday,1,Light_rainsnow,0.62,0.5758,0.83,0.2239,28,205,233,105,233,233
14898,2012-09-17,Fall,2012,Sep,22,0,Monday,1,Light_rainsnow,0.62,0.5758,0.83,0.2537,20,109,129,105,129,129
14899,2012-09-17,Fall,2012,Sep,23,0,Monday,1,Light_rainsnow,0.6,0.5152,0.94,0.2537,4,66,70,105,70,70
14900,2012-09-18,Fall,2012,Sep,0,0,Tuesday,1,Light_rainsnow,0.6,0.5152,0.94,0.2537,2,11,13,104,13,13
14901,2012-09-18,Fall,2012,Sep,1,0,Tuesday,1,Light_rainsnow,0.6,0.5152,0.94,0.194,0,5,5,104,5,5
14902,2012-09-18,Fall,2012,Sep,2,0,Tuesday,1,Light_rainsnow,0.6,0.5152,0.94,0.194,0,4,4,104,4,4
14903,2012-09-18,Fall,2012,Sep,3,0,Tuesday,1,Misty,0.62,0.5455,0.94,0.2836,0,6,6,104,6,6
14904,2012-09-18,Fall,2012,Sep,4,0,Tuesday,1,Misty,0.62,0.5455,0.94,0.3582,2,5,7,104,7,7
14905,2012-09-18,Fall,2012,Sep,5,0,Tuesday,1,Misty,0.64,0.5758,0.89,0.3284,3,45,48,104,48,48
14906,2012-09-18,Fall,2012,Sep,6,0,Tuesday,1,Misty,0.64,0.5758,0.89,0.3284,4,163,167,104,167,167
14907,2012-09-18,Fall,2012,Sep,7,0,Tuesday,1,Misty,0.64,0.5758,0.89,0.4478,13,343,356,104,356,356
14908,2012-09-18,Fall,2012,Sep,8,0,Tuesday,1,Misty,0.66,0.6061,0.83,0.5522,32,640,672,104,672,672
14909,2012-09-18,Fall,2012,Sep,9,0,Tuesday,1,Misty,0.66,0.6061,0.83,0.5821,27,266,293,104,293,293
14910,2012-09-18,Fall,2012,Sep,10,0,Tuesday,1,Light_rainsnow,0.68,0.6364,0.79,0.6418,30,130,160,104,160,160
14911,2012-09-18,Fall,2012,Sep,11,0,Tuesday,1,Misty,0.68,0.6364,0.79,0.6418,36,115,151,104,151,151
14912,2012-09-18,Fall,2012,Sep,12,0,Tuesday,1,Light_rainsnow,0.68,0.6364,0.83,0.4478,16,72,88,104,88,88
14913,2012-09-18,Fall,2012,Sep,13,0,Tuesday,1,Misty,0.7,0.6667,0.74,0.5821,17,97,114,104,114,114
14914,2012-09-18,Fall,2012,Sep,14,0,Tuesday,1,Light_rainsnow,0.6,0.5152,0.94,0.4627,27,116,143,104,143,143
14915,2012-09-18,Fall,2012,Sep,15,0,Tuesday,1,Light_rainsnow,0.6,0.5455,0.88,0.2537,1,35,36,104,36,36
14916,2012-09-18,Fall,2012,Sep,16,0,Tuesday,1,Light_rainsnow,0.6,0.5455,0.88,0.2985,19,122,141,104,141,141
14917,2012-09-18,Fall,2012,Sep,17,0,Tuesday,1,Light_rainsnow,0.6,0.5455,0.88,0.194,36,302,338,104,338,338
14918,2012-09-18,Fall,2012,Sep,18,0,Tuesday,1,Misty,0.6,0.5455,0.88,0.1642,19,262,281,104,281,281
14919,2012-09-18,Fall,2012,Sep,19,0,Tuesday,1,Misty,0.6,0.5455,0.88,0.2985,22,302,324,104,324,324
14920,2012-09-18,Fall,2012,Sep,20,0,Tuesday,1,Misty,0.6,0.5455,0.88,0.194,19,271,290,104,290,290
14921,2012-09-18,Fall,2012,Sep,21,0,Tuesday,1,Misty,0.6,0.5455,0.88,0.194,21,186,207,104,207,207
14922,2012-09-18,Fall,2012,Sep,22,0,Tuesday,1,Light_rainsnow,0.58,0.5455,0.83,0.4627,14,137,151,104,151,151
14923,2012-09-18,Fall,2012,Sep,23,0,Tuesday,1,Misty,0.56,0.5303,0.83,0.2239,11,67,78,104,78,78
14924,2012-09-19,Fall,2012,Sep,0,0,Wednesday,1,Misty,0.56,0.5303,0.68,0.2836,3,23,26,103,26,26
14925,2012-09-19,Fall,2012,Sep,1,0,Wednesday,1,Misty,0.54,0.5152,0.68,0.2537,0,12,12,103,12,12
14926,2012-09-19,Fall,2012,Sep,2,0,Wednesday,1,Misty,0.54,0.5152,0.64,0.3284,0,3,3,103,3,3
14927,2012-09-19,Fall,2012,Sep,3,0,Wednesday,1,Misty,0.52,0.5,0.63,0.2537,1,4,5,103,5,5
14928,2012-09-19,Fall,2012,Sep,4,0,Wednesday,1,Misty,0.52,0.5,0.68,0.3582,0,10,10,103,10,10
14929,2012-09-19,Fall,2012,Sep,5,0,Wednesday,1,Misty,0.52,0.5,0.68,0.2836,2,54,56,103,56,56
14930,2012-09-19,Fall,2012,Sep,6,0,Wednesday,1,Clear,0.52,0.5,0.63,0.2537,6,166,172,103,172,172
14931,2012-09-19,Fall,2012,Sep,7,0,Wednesday,1,Clear,0.52,0.5,0.63,0.2239,16,529,545,103,545,545
14932,2012-09-19,Fall,2012,Sep,8,0,Wednesday,1,Clear,0.52,0.5,0.59,0.2239,39,758,797,103,797,797
14933,2012-09-19,Fall,2012,Sep,9,0,Wednesday,1,Clear,0.54,0.5152,0.6,0.2537,26,336,362,103,362,362
14934,2012-09-19,Fall,2012,Sep,10,0,Wednesday,1,Clear,0.56,0.5303,0.52,0.194,23,169,192,103,192,192
14935,2012-09-19,Fall,2012,Sep,11,0,Wednesday,1,Clear,0.6,0.6212,0.43,0.2537,44,203,247,103,247,247
14936,2012-09-19,Fall,2012,Sep,12,0,Wednesday,1,Clear,0.6,0.6212,0.43,0.2537,53,260,313,103,313,313
14937,2012-09-19,Fall,2012,Sep,13,0,Wednesday,1,Clear,0.6,0.6212,0.4,0.2537,55,234,289,103,289,289
14938,2012-09-19,Fall,2012,Sep,14,0,Wednesday,1,Clear,0.62,0.6212,0.38,0.2537,59,227,286,103,286,286
14939,2012-09-19,Fall,2012,Sep,15,0,Wednesday,1,Clear,0.62,0.6212,0.35,0.0,57,254,311,103,311,311
14940,2012-09-19,Fall,2012,Sep,16,0,Wednesday,1,Clear,0.62,0.6212,0.35,0.0,69,397,466,103,466,466
14941,2012-09-19,Fall,2012,Sep,17,0,Wednesday,1,Clear,0.6,0.6212,0.38,0.2239,74,812,886,103,886,886
14942,2012-09-19,Fall,2012,Sep,18,0,Wednesday,1,Clear,0.58,0.5455,0.4,0.2836,85,807,892,103,892,892
14943,2012-09-19,Fall,2012,Sep,19,0,Wednesday,1,Clear,0.56,0.5303,0.43,0.2239,72,539,611,103,611,611
14944,2012-09-19,Fall,2012,Sep,20,0,Wednesday,1,Clear,0.52,0.5,0.48,0.1642,31,378,409,103,409,409
14945,2012-09-19,Fall,2012,Sep,21,0,Wednesday,1,Clear,0.5,0.4848,0.59,0.1642,25,324,349,103,349,349
14946,2012-09-19,Fall,2012,Sep,22,0,Wednesday,1,Clear,0.5,0.4848,0.63,0.0896,31,198,229,103,229,229
14947,2012-09-19,Fall,2012,Sep,23,0,Wednesday,1,Clear,0.48,0.4697,0.67,0.0896,17,106,123,103,123,123
14948,2012-09-20,Fall,2012,Sep,0,0,Thursday,1,Clear,0.5,0.4848,0.63,0.0,12,46,58,102,58,58
14949,2012-09-20,Fall,2012,Sep,1,0,Thursday,1,Clear,0.46,0.4545,0.72,0.1045,4,14,18,102,18,18
14950,2012-09-20,Fall,2012,Sep,2,0,Thursday,1,Clear,0.46,0.4545,0.72,0.0896,2,9,11,102,11,11
14951,2012-09-20,Fall,2012,Sep,3,0,Thursday,1,Clear,0.44,0.4394,0.77,0.0,0,6,6,102,6,6
14952,2012-09-20,Fall,2012,Sep,4,0,Thursday,1,Clear,0.44,0.4394,0.77,0.1045,0,6,6,102,6,6
14953,2012-09-20,Fall,2012,Sep,5,0,Thursday,1,Clear,0.44,0.4394,0.77,0.1045,4,52,56,102,56,56
14954,2012-09-20,Fall,2012,Sep,6,0,Thursday,1,Clear,0.44,0.4394,0.77,0.0,9,161,170,102,170,170
14955,2012-09-20,Fall,2012,Sep,7,0,Thursday,1,Clear,0.46,0.4545,0.82,0.1045,20,514,534,102,534,534
14956,2012-09-20,Fall,2012,Sep,8,0,Thursday,1,Clear,0.5,0.4848,0.68,0.0896,44,746,790,102,790,790
14957,2012-09-20,Fall,2012,Sep,9,0,Thursday,1,Clear,0.56,0.5303,0.6,0.0896,25,330,355,102,355,355
14958,2012-09-20,Fall,2012,Sep,10,0,Thursday,1,Clear,0.58,0.5455,0.53,0.0896,33,157,190,102,190,190
14959,2012-09-20,Fall,2012,Sep,11,0,Thursday,1,Clear,0.62,0.6212,0.43,0.0,37,206,243,102,243,243
14960,2012-09-20,Fall,2012,Sep,12,0,Thursday,1,Clear,0.62,0.6212,0.43,0.1343,57,233,290,102,290,290
14961,2012-09-20,Fall,2012,Sep,13,0,Thursday,1,Clear,0.64,0.6212,0.44,0.1343,68,268,336,102,336,336
14962,2012-09-20,Fall,2012,Sep,14,0,Thursday,1,Clear,0.64,0.6212,0.47,0.194,76,222,298,102,298,298
14963,2012-09-20,Fall,2012,Sep,15,0,Thursday,1,Clear,0.66,0.6212,0.47,0.194,60,231,291,102,291,291
14964,2012-09-20,Fall,2012,Sep,16,0,Thursday,1,Clear,0.64,0.6212,0.47,0.1642,72,385,457,102,457,457
14965,2012-09-20,Fall,2012,Sep,17,0,Thursday,1,Clear,0.64,0.6212,0.5,0.2239,91,885,976,102,976,976
14966,2012-09-20,Fall,2012,Sep,18,0,Thursday,1,Clear,0.6,0.6212,0.56,0.2537,119,781,900,102,900,900
14967,2012-09-20,Fall,2012,Sep,19,0,Thursday,1,Clear,0.58,0.5455,0.6,0.2239,69,534,603,102,603,603
14968,2012-09-20,Fall,2012,Sep,20,0,Thursday,1,Clear,0.56,0.5303,0.64,0.1343,57,360,417,102,417,417
14969,2012-09-20,Fall,2012,Sep,21,0,Thursday,1,Clear,0.56,0.5303,0.64,0.194,28,246,274,102,274,274
14970,2012-09-20,Fall,2012,Sep,22,0,Thursday,1,Clear,0.54,0.5152,0.73,0.1045,35,252,287,102,287,287
14971,2012-09-20,Fall,2012,Sep,23,0,Thursday,1,Clear,0.54,0.5152,0.68,0.1045,17,137,154,102,154,154
14972,2012-09-21,Fall,2012,Sep,0,0,Friday,1,Clear,0.54,0.5152,0.68,0.0,13,53,66,101,66,66
14973,2012-09-21,Fall,2012,Sep,1,0,Friday,1,Clear,0.52,0.5,0.72,0.0,11,38,49,101,49,49
14974,2012-09-21,Fall,2012,Sep,2,0,Friday,1,Clear,0.52,0.5,0.72,0.0,6,8,14,101,14,14
14975,2012-09-21,Fall,2012,Sep,3,0,Friday,1,Clear,0.5,0.4848,0.77,0.0896,1,11,12,101,12,12
14976,2012-09-21,Fall,2012,Sep,4,0,Friday,1,Clear,0.5,0.4848,0.77,0.0,1,9,10,101,10,10
14977,2012-09-21,Fall,2012,Sep,5,0,Friday,1,Clear,0.5,0.4848,0.82,0.0,2,47,49,101,49,49
14978,2012-09-21,Fall,2012,Sep,6,0,Friday,1,Clear,0.5,0.4848,0.77,0.0896,19,146,165,101,165,165
14979,2012-09-21,Fall,2012,Sep,7,0,Friday,1,Clear,0.52,0.5,0.77,0.0,35,468,503,101,503,503
14980,2012-09-21,Fall,2012,Sep,8,0,Friday,1,Clear,0.54,0.5152,0.73,0.1343,31,726,757,101,757,757
14981,2012-09-21,Fall,2012,Sep,9,0,Friday,1,Clear,0.58,0.5455,0.68,0.1343,35,348,383,101,383,383
14982,2012-09-21,Fall,2012,Sep,10,0,Friday,1,Clear,0.62,0.6061,0.61,0.2239,44,181,225,101,225,225
14983,2012-09-21,Fall,2012,Sep,11,0,Friday,1,Clear,0.66,0.6212,0.57,0.2239,79,242,321,101,321,321
14984,2012-09-21,Fall,2012,Sep,12,0,Friday,1,Clear,0.68,0.6364,0.57,0.1642,84,305,389,101,389,389
14985,2012-09-21,Fall,2012,Sep,13,0,Friday,1,Clear,0.7,0.6515,0.54,0.1642,105,316,421,101,421,421
14986,2012-09-21,Fall,2012,Sep,14,0,Friday,1,Clear,0.7,0.6515,0.54,0.2985,113,299,412,101,412,412
14987,2012-09-21,Fall,2012,Sep,15,0,Friday,1,Clear,0.7,0.6515,0.54,0.2239,90,333,423,101,423,423
14988,2012-09-21,Fall,2012,Sep,16,0,Friday,1,Clear,0.7,0.6515,0.54,0.194,103,464,567,101,567,567
14989,2012-09-21,Fall,2012,Sep,17,0,Friday,1,Clear,0.68,0.6364,0.57,0.2836,107,739,846,101,846,846
14990,2012-09-21,Fall,2012,Sep,18,0,Friday,1,Clear,0.66,0.6212,0.61,0.2537,106,699,805,101,805,805
14991,2012-09-21,Fall,2012,Sep,19,0,Friday,1,Clear,0.64,0.6061,0.65,0.2537,95,493,588,101,588,588
14992,2012-09-21,Fall,2012,Sep,20,0,Friday,1,Clear,0.62,0.6061,0.69,0.194,54,315,369,101,369,369
14993,2012-09-21,Fall,2012,Sep,21,0,Friday,1,Clear,0.6,0.5909,0.73,0.2537,46,266,312,101,312,312
14994,2012-09-21,Fall,2012,Sep,22,0,Friday,1,Clear,0.6,0.5909,0.73,0.194,47,248,295,101,295,295
14995,2012-09-21,Fall,2012,Sep,23,0,Friday,1,Clear,0.6,0.5909,0.73,0.3284,23,163,186,101,186,186
14996,2012-09-22,Fall,2012,Sep,0,0,Saturday,0,Clear,0.6,0.5909,0.73,0.2836,32,140,172,100,172,172
14997,2012-09-22,Fall,2012,Sep,1,0,Saturday,0,Clear,0.58,0.5455,0.83,0.2985,18,106,124,100,124,124
14998,2012-09-22,Fall,2012,Sep,2,0,Saturday,0,Clear,0.56,0.5303,0.88,0.2537,10,73,83,100,83,83
14999,2012-09-22,Fall,2012,Sep,3,0,Saturday,0,Clear,0.56,0.5303,0.83,0.2836,6,39,45,100,45,45
15000,2012-09-22,Fall,2012,Sep,4,0,Saturday,0,Clear,0.56,0.5303,0.83,0.2836,5,10,15,100,15,15
15001,2012-09-22,Fall,2012,Sep,5,0,Saturday,0,Clear,0.56,0.5303,0.83,0.3284,2,15,17,100,17,17
15002,2012-09-22,Fall,2012,Sep,6,0,Saturday,0,Clear,0.56,0.5303,0.83,0.2985,6,35,41,100,41,41
15003,2012-09-22,Fall,2012,Sep,7,0,Saturday,0,Clear,0.58,0.5455,0.78,0.2537,7,70,77,100,77,77
15004,2012-09-22,Fall,2012,Sep,8,0,Saturday,0,Clear,0.6,0.5909,0.73,0.2985,21,197,218,100,218,218
15005,2012-09-22,Fall,2012,Sep,9,0,Saturday,0,Clear,0.64,0.6061,0.69,0.2537,88,289,377,100,377,377
15006,2012-09-22,Fall,2012,Sep,10,0,Saturday,0,Clear,0.66,0.6212,0.65,0.3284,124,350,474,100,474,474
15007,2012-09-22,Fall,2012,Sep,11,0,Saturday,0,Clear,0.7,0.6515,0.58,0.2836,189,437,626,100,626,626
15008,2012-09-22,Fall,2012,Sep,12,0,Saturday,0,Clear,0.72,0.6667,0.54,0.2985,228,460,688,100,688,688
15009,2012-09-22,Fall,2012,Sep,13,0,Saturday,0,Clear,0.74,0.6667,0.51,0.3582,273,434,707,100,707,707
15010,2012-09-22,Fall,2012,Sep,14,0,Saturday,0,Clear,0.76,0.6818,0.48,0.2836,250,404,654,100,654,654
15011,2012-09-22,Fall,2012,Sep,15,0,Saturday,0,Clear,0.74,0.6667,0.48,0.3881,307,443,750,100,750,750
15012,2012-09-22,Fall,2012,Sep,16,0,Saturday,0,Clear,0.74,0.6667,0.51,0.3284,253,427,680,100,680,680
15013,2012-09-22,Fall,2012,Sep,17,0,Saturday,0,Clear,0.74,0.6667,0.51,0.3284,195,451,646,100,646,646
15014,2012-09-22,Fall,2012,Sep,18,0,Saturday,0,Clear,0.72,0.6667,0.54,0.2836,171,427,598,100,598,598
15015,2012-09-22,Fall,2012,Sep,19,0,Saturday,0,Clear,0.7,0.6515,0.58,0.194,99,308,407,100,407,407
15016,2012-09-22,Fall,2012,Sep,20,0,Saturday,0,Clear,0.7,0.6515,0.54,0.2537,76,249,325,100,325,325
15017,2012-09-22,Fall,2012,Sep,21,0,Saturday,0,Clear,0.64,0.6212,0.57,0.2537,59,202,261,100,261,261
15018,2012-09-22,Fall,2012,Sep,22,0,Saturday,0,Clear,0.62,0.6212,0.57,0.194,59,180,239,100,239,239
15019,2012-09-22,Fall,2012,Sep,23,0,Saturday,0,Clear,0.62,0.6212,0.5,0.194,34,137,171,100,171,171
15020,2012-09-23,Winter,2012,Sep,0,0,Sunday,0,Clear,0.62,0.6212,0.38,0.2537,34,146,180,99,180,180
15021,2012-09-23,Winter,2012,Sep,1,0,Sunday,0,Clear,0.54,0.5152,0.52,0.3582,23,119,142,99,142,142
15022,2012-09-23,Winter,2012,Sep,2,0,Sunday,0,Clear,0.52,0.5,0.48,0.2537,18,77,95,99,95,95
15023,2012-09-23,Winter,2012,Sep,3,0,Sunday,0,Clear,0.48,0.4697,0.55,0.2985,13,41,54,99,54,54
15024,2012-09-23,Winter,2012,Sep,4,0,Sunday,0,Clear,0.46,0.4545,0.55,0.2239,1,9,10,99,10,10
15025,2012-09-23,Winter,2012,Sep,5,0,Sunday,0,Clear,0.46,0.4545,0.59,0.2537,1,5,6,99,6,6
15026,2012-09-23,Winter,2012,Sep,6,0,Sunday,0,Clear,0.44,0.4394,0.62,0.2537,5,11,16,99,16,16
15027,2012-09-23,Winter,2012,Sep,7,0,Sunday,0,Clear,0.46,0.4545,0.59,0.2239,9,48,57,99,57,57
15028,2012-09-23,Winter,2012,Sep,8,0,Sunday,0,Clear,0.48,0.4697,0.55,0.3582,38,137,175,99,175,175
15029,2012-09-23,Winter,2012,Sep,9,0,Sunday,0,Clear,0.5,0.4848,0.51,0.3284,71,205,276,99,276,276
15030,2012-09-23,Winter,2012,Sep,10,0,Sunday,0,Clear,0.54,0.5152,0.45,0.2537,138,351,489,99,489,489
15031,2012-09-23,Winter,2012,Sep,11,0,Sunday,0,Clear,0.56,0.5303,0.46,0.2537,186,384,570,99,570,570
15032,2012-09-23,Winter,2012,Sep,12,0,Sunday,0,Clear,0.56,0.5303,0.43,0.1045,250,526,776,99,776,776
15033,2012-09-23,Winter,2012,Sep,13,0,Sunday,0,Clear,0.6,0.6212,0.38,0.1642,257,445,702,99,702,702
15034,2012-09-23,Winter,2012,Sep,14,0,Sunday,0,Clear,0.6,0.6212,0.38,0.194,266,400,666,99,666,666
15035,2012-09-23,Winter,2012,Sep,15,0,Sunday,0,Clear,0.6,0.6212,0.33,0.2239,265,375,640,99,640,640
15036,2012-09-23,Winter,2012,Sep,16,0,Sunday,0,Clear,0.6,0.6212,0.33,0.3284,254,437,691,99,691,691
15037,2012-09-23,Winter,2012,Sep,17,0,Sunday,0,Clear,0.56,0.5303,0.35,0.2985,227,496,723,99,723,723
15038,2012-09-23,Winter,2012,Sep,18,0,Sunday,0,Clear,0.54,0.5152,0.37,0.194,135,405,540,99,540,540
15039,2012-09-23,Winter,2012,Sep,19,0,Sunday,0,Clear,0.52,0.5,0.42,0.1642,82,331,413,99,413,413
15040,2012-09-23,Winter,2012,Sep,20,0,Sunday,0,Clear,0.52,0.5,0.42,0.1642,60,192,252,99,252,252
15041,2012-09-23,Winter,2012,Sep,21,0,Sunday,0,Misty,0.52,0.5,0.48,0.1045,51,145,196,99,196,196
15042,2012-09-23,Winter,2012,Sep,22,0,Sunday,0,Clear,0.52,0.5,0.48,0.0,40,98,138,99,138,138
15043,2012-09-23,Winter,2012,Sep,23,0,Sunday,0,Misty,0.5,0.4848,0.59,0.1045,30,70,100,99,100,100
15044,2012-09-24,Winter,2012,Sep,0,0,Monday,1,Clear,0.46,0.4545,0.63,0.194,10,54,64,98,64,64
15045,2012-09-24,Winter,2012,Sep,1,0,Monday,1,Clear,0.46,0.4545,0.67,0.1343,6,12,18,98,18,18
15046,2012-09-24,Winter,2012,Sep,2,0,Monday,1,Misty,0.46,0.4545,0.63,0.1343,0,8,8,98,8,8
15047,2012-09-24,Winter,2012,Sep,3,0,Monday,1,Clear,0.46,0.4545,0.63,0.1642,0,5,5,98,5,5
15048,2012-09-24,Winter,2012,Sep,4,0,Monday,1,Clear,0.44,0.4394,0.67,0.1045,0,8,8,98,8,8
15049,2012-09-24,Winter,2012,Sep,5,0,Monday,1,Clear,0.46,0.4545,0.63,0.0,2,35,37,98,37,37
15050,2012-09-24,Winter,2012,Sep,6,0,Monday,1,Clear,0.46,0.4545,0.59,0.0,6,162,168,98,168,168
15051,2012-09-24,Winter,2012,Sep,7,0,Monday,1,Clear,0.46,0.4545,0.67,0.1343,17,513,530,98,530,530
15052,2012-09-24,Winter,2012,Sep,8,0,Monday,1,Clear,0.5,0.4848,0.55,0.194,31,719,750,98,750,750
15053,2012-09-24,Winter,2012,Sep,9,0,Monday,1,Clear,0.52,0.5,0.52,0.194,42,286,328,98,328,328
15054,2012-09-24,Winter,2012,Sep,10,0,Monday,1,Clear,0.54,0.5152,0.49,0.2239,52,146,198,98,198,198
15055,2012-09-24,Winter,2012,Sep,11,0,Monday,1,Clear,0.56,0.5303,0.37,0.194,71,167,238,98,238,238
15056,2012-09-24,Winter,2012,Sep,12,0,Monday,1,Clear,0.56,0.5303,0.35,0.2985,77,265,342,98,342,342
15057,2012-09-24,Winter,2012,Sep,13,0,Monday,1,Clear,0.6,0.6212,0.31,0.2985,80,248,328,98,328,328
15058,2012-09-24,Winter,2012,Sep,14,0,Monday,1,Clear,0.6,0.6061,0.28,0.0,77,226,303,98,303,303
15059,2012-09-24,Winter,2012,Sep,15,0,Monday,1,Clear,0.6,0.6212,0.31,0.0,84,216,300,98,300,300
15060,2012-09-24,Winter,2012,Sep,16,0,Monday,1,Clear,0.58,0.5455,0.3,0.2537,99,417,516,98,516,516
15061,2012-09-24,Winter,2012,Sep,17,0,Monday,1,Clear,0.58,0.5455,0.3,0.0,89,809,898,98,898,898
15062,2012-09-24,Winter,2012,Sep,18,0,Monday,1,Clear,0.54,0.5152,0.37,0.1642,95,758,853,98,853,853
15063,2012-09-24,Winter,2012,Sep,19,0,Monday,1,Clear,0.52,0.5,0.39,0.1343,56,534,590,98,590,590
15064,2012-09-24,Winter,2012,Sep,20,0,Monday,1,Clear,0.52,0.5,0.52,0.1045,52,380,432,98,432,432
15065,2012-09-24,Winter,2012,Sep,21,0,Monday,1,Clear,0.5,0.4848,0.51,0.1343,26,230,256,98,256,256
15066,2012-09-24,Winter,2012,Sep,22,0,Monday,1,Clear,0.5,0.4848,0.51,0.2239,18,154,172,98,172,172
15067,2012-09-24,Winter,2012,Sep,23,0,Monday,1,Clear,0.46,0.4545,0.63,0.1343,11,83,94,98,94,94
15068,2012-09-25,Winter,2012,Sep,0,0,Tuesday,1,Clear,0.46,0.4545,0.67,0.1642,8,56,64,97,64,64
15069,2012-09-25,Winter,2012,Sep,1,0,Tuesday,1,Clear,0.44,0.4394,0.72,0.1343,2,11,13,97,13,13
15070,2012-09-25,Winter,2012,Sep,2,0,Tuesday,1,Clear,0.42,0.4242,0.77,0.1343,5,9,14,97,14,14
15071,2012-09-25,Winter,2012,Sep,3,0,Tuesday,1,Clear,0.42,0.4242,0.71,0.0896,2,3,5,97,5,5
15072,2012-09-25,Winter,2012,Sep,4,0,Tuesday,1,Clear,0.42,0.4242,0.71,0.1343,2,7,9,97,9,9
15073,2012-09-25,Winter,2012,Sep,5,0,Tuesday,1,Clear,0.42,0.4242,0.77,0.0896,1,46,47,97,47,47
15074,2012-09-25,Winter,2012,Sep,6,0,Tuesday,1,Clear,0.44,0.4394,0.77,0.2239,5,189,194,97,194,194
15075,2012-09-25,Winter,2012,Sep,7,0,Tuesday,1,Clear,0.44,0.4394,0.77,0.194,17,539,556,97,556,556
15076,2012-09-25,Winter,2012,Sep,8,0,Tuesday,1,Clear,0.48,0.4697,0.67,0.194,41,764,805,97,805,805
15077,2012-09-25,Winter,2012,Sep,9,0,Tuesday,1,Clear,0.54,0.5152,0.56,0.2537,28,381,409,97,409,409
15078,2012-09-25,Winter,2012,Sep,10,0,Tuesday,1,Clear,0.56,0.5303,0.52,0.2985,45,125,170,97,170,170
15079,2012-09-25,Winter,2012,Sep,11,0,Tuesday,1,Clear,0.6,0.6212,0.46,0.2985,63,155,218,97,218,218
15080,2012-09-25,Winter,2012,Sep,12,0,Tuesday,1,Clear,0.62,0.6212,0.43,0.2836,69,233,302,97,302,302
15081,2012-09-25,Winter,2012,Sep,13,0,Tuesday,1,Clear,0.64,0.6212,0.47,0.2537,48,257,305,97,305,305
15082,2012-09-25,Winter,2012,Sep,14,0,Tuesday,1,Clear,0.66,0.6212,0.39,0.3284,80,213,293,97,293,293
15083,2012-09-25,Winter,2012,Sep,15,0,Tuesday,1,Clear,0.66,0.6212,0.36,0.3284,56,247,303,97,303,303
15084,2012-09-25,Winter,2012,Sep,16,0,Tuesday,1,Clear,0.66,0.6212,0.39,0.2985,59,436,495,97,495,495
15085,2012-09-25,Winter,2012,Sep,17,0,Tuesday,1,Clear,0.66,0.6212,0.39,0.2836,107,860,967,97,967,967
15086,2012-09-25,Winter,2012,Sep,18,0,Tuesday,1,Clear,0.64,0.6212,0.41,0.2239,64,758,822,97,822,822
15087,2012-09-25,Winter,2012,Sep,19,0,Tuesday,1,Clear,0.62,0.6212,0.5,0.2537,49,490,539,97,539,539
15088,2012-09-25,Winter,2012,Sep,20,0,Tuesday,1,Clear,0.6,0.6212,0.56,0.2985,37,388,425,97,425,425
15089,2012-09-25,Winter,2012,Sep,21,0,Tuesday,1,Clear,0.6,0.6212,0.56,0.2985,34,263,297,97,297,297
15090,2012-09-25,Winter,2012,Sep,22,0,Tuesday,1,Clear,0.6,0.6212,0.56,0.2836,14,174,188,97,188,188
15091,2012-09-25,Winter,2012,Sep,23,0,Tuesday,1,Clear,0.6,0.6212,0.56,0.3284,9,89,98,97,98,98
15092,2012-09-26,Winter,2012,Sep,0,0,Wednesday,1,Clear,0.58,0.5455,0.64,0.2985,6,34,40,96,40,40
15093,2012-09-26,Winter,2012,Sep,1,0,Wednesday,1,Clear,0.58,0.5455,0.64,0.3284,10,19,29,96,29,29
15094,2012-09-26,Winter,2012,Sep,2,0,Wednesday,1,Misty,0.58,0.5455,0.64,0.2836,2,15,17,96,17,17
15095,2012-09-26,Winter,2012,Sep,3,0,Wednesday,1,Misty,0.58,0.5455,0.64,0.2836,4,6,10,96,10,10
15096,2012-09-26,Winter,2012,Sep,4,0,Wednesday,1,Clear,0.56,0.5303,0.73,0.2537,2,12,14,96,14,14
15097,2012-09-26,Winter,2012,Sep,5,0,Wednesday,1,Clear,0.56,0.5303,0.73,0.2239,1,35,36,96,36,36
15098,2012-09-26,Winter,2012,Sep,6,0,Wednesday,1,Clear,0.54,0.5152,0.73,0.194,3,179,182,96,182,182
15099,2012-09-26,Winter,2012,Sep,7,0,Wednesday,1,Clear,0.54,0.5152,0.77,0.1343,9,523,532,96,532,532
15100,2012-09-26,Winter,2012,Sep,8,0,Wednesday,1,Clear,0.56,0.5303,0.73,0.2985,30,808,838,96,838,838
15101,2012-09-26,Winter,2012,Sep,9,0,Wednesday,1,Clear,0.6,0.6061,0.64,0.194,27,307,334,96,334,334
15102,2012-09-26,Winter,2012,Sep,10,0,Wednesday,1,Clear,0.6,0.5909,0.73,0.2836,29,156,185,96,185,185
15103,2012-09-26,Winter,2012,Sep,11,0,Wednesday,1,Clear,0.64,0.6212,0.61,0.2537,46,181,227,96,227,227
15104,2012-09-26,Winter,2012,Sep,12,0,Wednesday,1,Clear,0.68,0.6364,0.61,0.2239,56,260,316,96,316,316
15105,2012-09-26,Winter,2012,Sep,13,0,Wednesday,1,Clear,0.7,0.6515,0.58,0.2239,67,273,340,96,340,340
15106,2012-09-26,Winter,2012,Sep,14,0,Wednesday,1,Clear,0.74,0.6667,0.48,0.2836,60,217,277,96,277,277
15107,2012-09-26,Winter,2012,Sep,15,0,Wednesday,1,Clear,0.74,0.6667,0.48,0.2985,69,231,300,96,300,300
15108,2012-09-26,Winter,2012,Sep,16,0,Wednesday,1,Clear,0.74,0.6667,0.45,0.2836,71,397,468,96,468,468
15109,2012-09-26,Winter,2012,Sep,17,0,Wednesday,1,Clear,0.74,0.6667,0.48,0.2985,77,876,953,96,953,953
15110,2012-09-26,Winter,2012,Sep,18,0,Wednesday,1,Clear,0.74,0.6667,0.48,0.2239,69,815,884,96,884,884
15111,2012-09-26,Winter,2012,Sep,19,0,Wednesday,1,Clear,0.7,0.6515,0.54,0.1642,38,589,627,96,627,627
15112,2012-09-26,Winter,2012,Sep,20,0,Wednesday,1,Clear,0.66,0.6212,0.69,0.194,45,389,434,96,434,434
15113,2012-09-26,Winter,2012,Sep,21,0,Wednesday,1,Clear,0.66,0.6212,0.65,0.194,32,328,360,96,360,360
15114,2012-09-26,Winter,2012,Sep,22,0,Wednesday,1,Light_rainsnow,0.62,0.6061,0.69,0.194,21,194,215,96,215,215
15115,2012-09-26,Winter,2012,Sep,23,0,Wednesday,1,Misty,0.6,0.5758,0.78,0.2537,13,102,115,96,115,115
15116,2012-09-27,Winter,2012,Sep,0,0,Thursday,1,Clear,0.6,0.5758,0.78,0.0896,5,60,65,95,65,65
15117,2012-09-27,Winter,2012,Sep,1,0,Thursday,1,Clear,0.6,0.5758,0.78,0.0896,5,16,21,95,21,21
15118,2012-09-27,Winter,2012,Sep,2,0,Thursday,1,Clear,0.6,0.5758,0.78,0.0896,3,13,16,95,16,16
15119,2012-09-27,Winter,2012,Sep,3,0,Thursday,1,Clear,0.6,0.5758,0.78,0.0,0,7,7,95,7,7
15120,2012-09-27,Winter,2012,Sep,4,0,Thursday,1,Clear,0.56,0.5303,0.94,0.1343,2,6,8,95,8,8
15121,2012-09-27,Winter,2012,Sep,5,0,Thursday,1,Clear,0.58,0.5455,0.83,0.0,2,64,66,95,66,66
15122,2012-09-27,Winter,2012,Sep,6,0,Thursday,1,Clear,0.56,0.5303,0.88,0.0896,5,164,169,95,169,169
15123,2012-09-27,Winter,2012,Sep,7,0,Thursday,1,Clear,0.6,0.5758,0.78,0.0,12,546,558,95,558,558
15124,2012-09-27,Winter,2012,Sep,8,0,Thursday,1,Clear,0.62,0.6061,0.71,0.0896,20,774,794,95,794,794
15125,2012-09-27,Winter,2012,Sep,9,0,Thursday,1,Clear,0.66,0.6212,0.65,0.0,30,305,335,95,335,335
15126,2012-09-27,Winter,2012,Sep,10,0,Thursday,1,Misty,0.7,0.6515,0.51,0.2836,40,168,208,95,208,208
15127,2012-09-27,Winter,2012,Sep,11,0,Thursday,1,Misty,0.72,0.6667,0.51,0.1642,67,227,294,95,294,294
15128,2012-09-27,Winter,2012,Sep,12,0,Thursday,1,Misty,0.74,0.6667,0.48,0.1343,63,272,335,95,335,335
15129,2012-09-27,Winter,2012,Sep,13,0,Thursday,1,Misty,0.74,0.6667,0.48,0.0,61,265,326,95,326,326
15130,2012-09-27,Winter,2012,Sep,14,0,Thursday,1,Misty,0.76,0.6818,0.45,0.0896,44,214,258,95,258,258
15131,2012-09-27,Winter,2012,Sep,15,0,Thursday,1,Misty,0.76,0.6818,0.45,0.0,41,255,296,95,296,296
15132,2012-09-27,Winter,2012,Sep,16,0,Thursday,1,Misty,0.72,0.6667,0.58,0.3284,73,399,472,95,472,472
15133,2012-09-27,Winter,2012,Sep,17,0,Thursday,1,Misty,0.66,0.6212,0.69,0.2985,87,818,905,95,905,905
15134,2012-09-27,Winter,2012,Sep,18,0,Thursday,1,Misty,0.66,0.6212,0.69,0.2239,77,822,899,95,899,899
15135,2012-09-27,Winter,2012,Sep,19,0,Thursday,1,Clear,0.66,0.6212,0.65,0.1343,48,511,559,95,559,559
15136,2012-09-27,Winter,2012,Sep,20,0,Thursday,1,Misty,0.64,0.6061,0.69,0.2239,45,412,457,95,457,457
15137,2012-09-27,Winter,2012,Sep,21,0,Thursday,1,Light_rainsnow,0.62,0.5758,0.83,0.2985,18,235,253,95,253,253
15138,2012-09-27,Winter,2012,Sep,22,0,Thursday,1,Light_rainsnow,0.62,0.5758,0.83,0.2985,2,45,47,95,47,47
15139,2012-09-27,Winter,2012,Sep,23,0,Thursday,1,Light_rainsnow,0.62,0.5758,0.83,0.1642,1,44,45,95,45,45
15140,2012-09-28,Winter,2012,Sep,0,0,Friday,1,Light_rainsnow,0.6,0.5455,0.88,0.1642,2,15,17,94,17,17
15141,2012-09-28,Winter,2012,Sep,1,0,Friday,1,Light_rainsnow,0.6,0.5455,0.88,0.0,0,13,13,94,13,13
15142,2012-09-28,Winter,2012,Sep,2,0,Friday,1,Light_rainsnow,0.6,0.5455,0.88,0.2985,1,9,10,94,10,10
15143,2012-09-28,Winter,2012,Sep,3,0,Friday,1,Misty,0.6,0.5606,0.83,0.1343,0,7,7,94,7,7
15144,2012-09-28,Winter,2012,Sep,4,0,Friday,1,Light_rainsnow,0.56,0.5303,0.88,0.1045,2,10,12,94,12,12
15145,2012-09-28,Winter,2012,Sep,5,0,Friday,1,Clear,0.56,0.5303,0.88,0.0,1,37,38,94,38,38
15146,2012-09-28,Winter,2012,Sep,6,0,Friday,1,Misty,0.56,0.5303,0.94,0.0896,2,136,138,94,138,138
15147,2012-09-28,Winter,2012,Sep,7,0,Friday,1,Misty,0.56,0.5303,0.94,0.0,10,384,394,94,394,394
15148,2012-09-28,Winter,2012,Sep,8,0,Friday,1,Clear,0.6,0.5606,0.83,0.0896,31,674,705,94,705,705
15149,2012-09-28,Winter,2012,Sep,9,0,Friday,1,Misty,0.62,0.5758,0.83,0.1045,27,399,426,94,426,426
15150,2012-09-28,Winter,2012,Sep,10,0,Friday,1,Misty,0.64,0.5909,0.78,0.1343,51,194,245,94,245,245
15151,2012-09-28,Winter,2012,Sep,11,0,Friday,1,Misty,0.66,0.6212,0.69,0.0,109,252,361,94,361,361
15152,2012-09-28,Winter,2012,Sep,12,0,Friday,1,Misty,0.7,0.6515,0.54,0.2537,94,286,380,94,380,380
15153,2012-09-28,Winter,2012,Sep,13,0,Friday,1,Misty,0.7,0.6515,0.51,0.2537,106,304,410,94,410,410
15154,2012-09-28,Winter,2012,Sep,14,0,Friday,1,Misty,0.7,0.6515,0.54,0.2537,105,294,399,94,399,399
15155,2012-09-28,Winter,2012,Sep,15,0,Friday,1,Misty,0.68,0.6364,0.54,0.2836,104,288,392,94,392,392
15156,2012-09-28,Winter,2012,Sep,16,0,Friday,1,Misty,0.66,0.6212,0.5,0.2239,83,419,502,94,502,502
15157,2012-09-28,Winter,2012,Sep,17,0,Friday,1,Misty,0.66,0.6212,0.54,0.2985,101,707,808,94,808,808
15158,2012-09-28,Winter,2012,Sep,18,0,Friday,1,Misty,0.64,0.6212,0.5,0.2239,58,609,667,94,667,667
15159,2012-09-28,Winter,2012,Sep,19,0,Friday,1,Light_rainsnow,0.62,0.6212,0.5,0.2537,38,470,508,94,508,508
15160,2012-09-28,Winter,2012,Sep,20,0,Friday,1,Light_rainsnow,0.6,0.6212,0.53,0.1642,32,304,336,94,336,336
15161,2012-09-28,Winter,2012,Sep,21,0,Friday,1,Light_rainsnow,0.6,0.6212,0.53,0.194,32,205,237,94,237,237
15162,2012-09-28,Winter,2012,Sep,22,0,Friday,1,Misty,0.58,0.5455,0.53,0.2239,30,190,220,94,220,220
15163,2012-09-28,Winter,2012,Sep,23,0,Friday,1,Misty,0.56,0.5303,0.56,0.194,26,164,190,94,190,190
15164,2012-09-29,Winter,2012,Sep,0,0,Saturday,0,Clear,0.54,0.5152,0.6,0.2239,15,134,149,93,149,149
15165,2012-09-29,Winter,2012,Sep,1,0,Saturday,0,Clear,0.54,0.5152,0.6,0.2239,12,89,101,93,101,101
15166,2012-09-29,Winter,2012,Sep,2,0,Saturday,0,Misty,0.54,0.5152,0.56,0.2239,12,80,92,93,92,92
15167,2012-09-29,Winter,2012,Sep,3,0,Saturday,0,Misty,0.52,0.5,0.59,0.194,4,25,29,93,29,29
15168,2012-09-29,Winter,2012,Sep,4,0,Saturday,0,Clear,0.52,0.5,0.59,0.2537,6,8,14,93,14,14
15169,2012-09-29,Winter,2012,Sep,5,0,Saturday,0,Clear,0.5,0.4848,0.63,0.194,2,13,15,93,15,15
15170,2012-09-29,Winter,2012,Sep,6,0,Saturday,0,Clear,0.5,0.4848,0.63,0.2537,4,33,37,93,37,37
15171,2012-09-29,Winter,2012,Sep,7,0,Saturday,0,Clear,0.48,0.4697,0.67,0.2836,12,61,73,93,73,73
15172,2012-09-29,Winter,2012,Sep,8,0,Saturday,0,Clear,0.5,0.4848,0.68,0.2836,37,174,211,93,211,211
15173,2012-09-29,Winter,2012,Sep,9,0,Saturday,0,Clear,0.5,0.4848,0.63,0.194,69,263,332,93,332,332
15174,2012-09-29,Winter,2012,Sep,10,0,Saturday,0,Clear,0.54,0.5152,0.56,0.2537,134,338,472,93,472,472
15175,2012-09-29,Winter,2012,Sep,11,0,Saturday,0,Clear,0.56,0.5303,0.52,0.2836,217,446,663,93,663,663
15176,2012-09-29,Winter,2012,Sep,12,0,Saturday,0,Clear,0.62,0.6212,0.41,0.2985,191,491,682,93,682,682
15177,2012-09-29,Winter,2012,Sep,13,0,Saturday,0,Clear,0.62,0.6212,0.41,0.2985,233,453,686,93,686,686
15178,2012-09-29,Winter,2012,Sep,14,0,Saturday,0,Clear,0.6,0.6212,0.4,0.2537,302,448,750,93,750,750
15179,2012-09-29,Winter,2012,Sep,15,0,Saturday,0,Clear,0.6,0.6212,0.43,0.2537,271,456,727,93,727,727
15180,2012-09-29,Winter,2012,Sep,16,0,Saturday,0,Clear,0.62,0.6212,0.41,0.2537,275,447,722,93,722,722
15181,2012-09-29,Winter,2012,Sep,17,0,Saturday,0,Clear,0.6,0.6212,0.38,0.3582,256,456,712,93,712,712
15182,2012-09-29,Winter,2012,Sep,18,0,Saturday,0,Clear,0.56,0.5303,0.46,0.194,174,420,594,93,594,594
15183,2012-09-29,Winter,2012,Sep,19,0,Saturday,0,Clear,0.52,0.5,0.55,0.1642,119,351,470,93,470,470
15184,2012-09-29,Winter,2012,Sep,20,0,Saturday,0,Clear,0.52,0.5,0.55,0.194,88,227,315,93,315,315
15185,2012-09-29,Winter,2012,Sep,21,0,Saturday,0,Clear,0.52,0.5,0.55,0.1343,73,219,292,93,292,292
15186,2012-09-29,Winter,2012,Sep,22,0,Saturday,0,Clear,0.5,0.4848,0.63,0.1045,48,173,221,93,221,221
15187,2012-09-29,Winter,2012,Sep,23,0,Saturday,0,Clear,0.5,0.4848,0.59,0.0896,35,161,196,93,196,196
15188,2012-09-30,Winter,2012,Sep,0,0,Sunday,0,Clear,0.5,0.4848,0.59,0.0,35,112,147,92,147,147
15189,2012-09-30,Winter,2012,Sep,1,0,Sunday,0,Clear,0.5,0.4848,0.59,0.0,31,85,116,92,116,116
15190,2012-09-30,Winter,2012,Sep,2,0,Sunday,0,Clear,0.48,0.4697,0.63,0.0,21,71,92,92,92,92
15191,2012-09-30,Winter,2012,Sep,3,0,Sunday,0,Clear,0.46,0.4545,0.67,0.0896,17,41,58,92,58,58
15192,2012-09-30,Winter,2012,Sep,4,0,Sunday,0,Clear,0.46,0.4545,0.67,0.0896,1,6,7,92,7,7
15193,2012-09-30,Winter,2012,Sep,5,0,Sunday,0,Clear,0.44,0.4394,0.72,0.0,1,9,10,92,10,10
15194,2012-09-30,Winter,2012,Sep,6,0,Sunday,0,Clear,0.44,0.4394,0.72,0.0896,2,20,22,92,22,22
15195,2012-09-30,Winter,2012,Sep,7,0,Sunday,0,Clear,0.44,0.4394,0.77,0.0,14,43,57,92,57,57
15196,2012-09-30,Winter,2012,Sep,8,0,Sunday,0,Clear,0.48,0.4697,0.67,0.1045,18,126,144,92,144,144
15197,2012-09-30,Winter,2012,Sep,9,0,Sunday,0,Clear,0.52,0.5,0.63,0.1045,74,211,285,92,285,285
15198,2012-09-30,Winter,2012,Sep,10,0,Sunday,0,Clear,0.58,0.5455,0.46,0.1642,160,319,479,92,479,479
15199,2012-09-30,Winter,2012,Sep,11,0,Sunday,0,Clear,0.6,0.6212,0.43,0.2239,222,369,591,92,591,591
15200,2012-09-30,Winter,2012,Sep,12,0,Sunday,0,Clear,0.62,0.6212,0.41,0.2985,206,474,680,92,680,680
15201,2012-09-30,Winter,2012,Sep,13,0,Sunday,0,Clear,0.62,0.6212,0.41,0.2537,180,414,594,92,594,594
15202,2012-09-30,Winter,2012,Sep,14,0,Sunday,0,Clear,0.62,0.6212,0.41,0.2537,208,404,612,92,612,612
15203,2012-09-30,Winter,2012,Sep,15,0,Sunday,0,Clear,0.64,0.6212,0.36,0.2537,230,419,649,92,649,649
15204,2012-09-30,Winter,2012,Sep,16,0,Sunday,0,Clear,0.64,0.6212,0.36,0.2239,202,446,648,92,648,648
15205,2012-09-30,Winter,2012,Sep,17,0,Sunday,0,Clear,0.62,0.6212,0.35,0.2836,195,380,575,92,575,575
15206,2012-09-30,Winter,2012,Sep,18,0,Sunday,0,Clear,0.52,0.5,0.59,0.4478,91,310,401,92,401,401
15207,2012-09-30,Winter,2012,Sep,19,0,Sunday,0,Light_rainsnow,0.5,0.4848,0.72,0.1343,34,223,257,92,257,257
15208,2012-09-30,Winter,2012,Sep,20,0,Sunday,0,Light_rainsnow,0.5,0.4848,0.72,0.1343,31,163,194,92,194,194
15209,2012-09-30,Winter,2012,Sep,21,0,Sunday,0,Clear,0.5,0.4848,0.68,0.0,19,104,123,92,123,123
15210,2012-09-30,Winter,2012,Sep,22,0,Sunday,0,Clear,0.48,0.4697,0.72,0.0,15,76,91,92,91,91
15211,2012-09-30,Winter,2012,Sep,23,0,Sunday,0,Clear,0.48,0.4697,0.72,0.0896,8,49,57,92,57,57
15212,2012-10-01,Winter,2012,Oct,0,0,Monday,1,Clear,0.46,0.4545,0.72,0.1045,6,39,45,91,45,45
15213,2012-10-01,Winter,2012,Oct,1,0,Monday,1,Clear,0.44,0.4394,0.77,0.0896,5,13,18,91,18,18
15214,2012-10-01,Winter,2012,Oct,2,0,Monday,1,Clear,0.46,0.4545,0.72,0.0,6,6,12,91,12,12
15215,2012-10-01,Winter,2012,Oct,3,0,Monday,1,Clear,0.44,0.4394,0.77,0.0,1,6,7,91,7,7
15216,2012-10-01,Winter,2012,Oct,4,0,Monday,1,Clear,0.42,0.4242,0.82,0.1045,0,10,10,91,10,10
15217,2012-10-01,Winter,2012,Oct,5,0,Monday,1,Clear,0.44,0.4394,0.77,0.0,2,34,36,91,36,36
15218,2012-10-01,Winter,2012,Oct,6,0,Monday,1,Clear,0.44,0.4394,0.77,0.1045,8,147,155,91,155,155
15219,2012-10-01,Winter,2012,Oct,7,0,Monday,1,Clear,0.44,0.4394,0.77,0.1642,13,470,483,91,483,483
15220,2012-10-01,Winter,2012,Oct,8,0,Monday,1,Misty,0.46,0.4545,0.77,0.1045,40,744,784,91,784,784
15221,2012-10-01,Winter,2012,Oct,9,0,Monday,1,Misty,0.52,0.5,0.63,0.0,26,314,340,91,340,340
15222,2012-10-01,Winter,2012,Oct,10,0,Monday,1,Clear,0.54,0.5152,0.56,0.0,44,135,179,91,179,179
15223,2012-10-01,Winter,2012,Oct,11,0,Monday,1,Clear,0.58,0.5455,0.46,0.0,76,196,272,91,272,272
15224,2012-10-01,Winter,2012,Oct,12,0,Monday,1,Misty,0.6,0.6212,0.43,0.1642,61,262,323,91,323,323
15225,2012-10-01,Winter,2012,Oct,13,0,Monday,1,Misty,0.6,0.6212,0.43,0.1642,80,225,305,91,305,305
15226,2012-10-01,Winter,2012,Oct,14,0,Monday,1,Misty,0.6,0.6212,0.43,0.1045,51,193,244,91,244,244
15227,2012-10-01,Winter,2012,Oct,15,0,Monday,1,Misty,0.62,0.6212,0.43,0.1343,95,234,329,91,329,329
15228,2012-10-01,Winter,2012,Oct,16,0,Monday,1,Misty,0.62,0.6212,0.46,0.2537,51,408,459,91,459,459
15229,2012-10-01,Winter,2012,Oct,17,0,Monday,1,Light_rainsnow,0.56,0.5303,0.6,0.2537,65,791,856,91,856,856
15230,2012-10-01,Winter,2012,Oct,18,0,Monday,1,Light_rainsnow,0.56,0.5303,0.64,0.1045,42,571,613,91,613,613
15231,2012-10-01,Winter,2012,Oct,19,0,Monday,1,Misty,0.54,0.5152,0.68,0.1045,33,483,516,91,516,516
15232,2012-10-01,Winter,2012,Oct,20,0,Monday,1,Light_rainsnow,0.54,0.5152,0.68,0.0,11,251,262,91,262,262
15233,2012-10-01,Winter,2012,Oct,21,0,Monday,1,Misty,0.54,0.5152,0.73,0.1343,13,205,218,91,218,218
15234,2012-10-01,Winter,2012,Oct,22,0,Monday,1,Light_rainsnow,0.54,0.5152,0.77,0.0896,17,190,207,91,207,207
15235,2012-10-01,Winter,2012,Oct,23,0,Monday,1,Light_rainsnow,0.54,0.5152,0.77,0.0,17,88,105,91,105,105
15236,2012-10-02,Winter,2012,Oct,0,0,Tuesday,1,Misty,0.56,0.5303,0.73,0.0,1,30,31,90,31,31
15237,2012-10-02,Winter,2012,Oct,1,0,Tuesday,1,Misty,0.54,0.5152,0.77,0.1045,0,11,11,90,11,11
15238,2012-10-02,Winter,2012,Oct,2,0,Tuesday,1,Misty,0.54,0.5152,0.77,0.1045,0,2,2,90,2,2
15239,2012-10-02,Winter,2012,Oct,3,0,Tuesday,1,Misty,0.54,0.5152,0.88,0.194,1,4,5,90,5,5
15240,2012-10-02,Winter,2012,Oct,4,0,Tuesday,1,Misty,0.56,0.5303,0.83,0.0896,2,8,10,90,10,10
15241,2012-10-02,Winter,2012,Oct,5,0,Tuesday,1,Misty,0.56,0.5303,0.83,0.1343,1,42,43,90,43,43
15242,2012-10-02,Winter,2012,Oct,6,0,Tuesday,1,Light_rainsnow,0.58,0.5455,0.83,0.1045,3,176,179,90,179,179
15243,2012-10-02,Winter,2012,Oct,7,0,Tuesday,1,Light_rainsnow,0.58,0.5455,0.83,0.1045,4,256,260,90,260,260
15244,2012-10-02,Winter,2012,Oct,8,0,Tuesday,1,Light_rainsnow,0.6,0.5455,0.88,0.0,6,128,134,90,134,134
15245,2012-10-02,Winter,2012,Oct,9,0,Tuesday,1,Light_rainsnow,0.58,0.5455,0.88,0.1343,3,83,86,90,86,86
15246,2012-10-02,Winter,2012,Oct,10,0,Tuesday,1,Light_rainsnow,0.58,0.5455,0.88,0.1343,3,42,45,90,45,45
15247,2012-10-02,Winter,2012,Oct,11,0,Tuesday,1,Light_rainsnow,0.58,0.5455,0.94,0.1343,7,92,99,90,99,99
15248,2012-10-02,Winter,2012,Oct,12,0,Tuesday,1,Misty,0.6,0.5455,0.88,0.194,6,98,104,90,104,104
15249,2012-10-02,Winter,2012,Oct,13,0,Tuesday,1,Misty,0.6,0.5455,0.88,0.1343,6,148,154,90,154,154
15250,2012-10-02,Winter,2012,Oct,14,0,Tuesday,1,Light_rainsnow,0.6,0.5455,0.88,0.1343,16,147,163,90,163,163
15251,2012-10-02,Winter,2012,Oct,15,0,Tuesday,1,Light_rainsnow,0.62,0.5758,0.83,0.1343,14,195,209,90,209,209
15252,2012-10-02,Winter,2012,Oct,16,0,Tuesday,1,Light_rainsnow,0.62,0.5606,0.88,0.1343,46,328,374,90,374,374
15253,2012-10-02,Winter,2012,Oct,17,0,Tuesday,1,Light_rainsnow,0.62,0.5606,0.88,0.1045,38,677,715,90,715,715
15254,2012-10-02,Winter,2012,Oct,18,0,Tuesday,1,Light_rainsnow,0.62,0.5455,0.94,0.0896,48,639,687,90,687,687
15255,2012-10-02,Winter,2012,Oct,19,0,Tuesday,1,Light_rainsnow,0.62,0.5455,0.94,0.0,27,368,395,90,395,395
15256,2012-10-02,Winter,2012,Oct,20,0,Tuesday,1,Light_rainsnow,0.62,0.5455,0.94,0.1343,20,286,306,90,306,306
15257,2012-10-02,Winter,2012,Oct,21,0,Tuesday,1,Light_rainsnow,0.62,0.5455,0.94,0.1045,24,265,289,90,289,289
15258,2012-10-02,Winter,2012,Oct,22,0,Tuesday,1,Misty,0.62,0.5455,0.94,0.1045,28,212,240,90,240,240
15259,2012-10-02,Winter,2012,Oct,23,0,Tuesday,1,Misty,0.62,0.5455,0.94,0.0,11,87,98,90,98,98
15260,2012-10-03,Winter,2012,Oct,0,0,Wednesday,1,Light_rainsnow,0.62,0.5455,0.94,0.0,5,47,52,89,52,52
15261,2012-10-03,Winter,2012,Oct,1,0,Wednesday,1,Misty,0.62,0.5455,0.94,0.0,3,16,19,89,19,19
15262,2012-10-03,Winter,2012,Oct,2,0,Wednesday,1,Misty,0.62,0.5455,0.94,0.0,2,7,9,89,9,9
15263,2012-10-03,Winter,2012,Oct,3,0,Wednesday,1,Misty,0.6,0.5152,0.94,0.0,0,7,7,89,7,7
15264,2012-10-03,Winter,2012,Oct,4,0,Wednesday,1,Misty,0.6,0.5,1.0,0.0,2,9,11,89,11,11
15265,2012-10-03,Winter,2012,Oct,5,0,Wednesday,1,Misty,0.62,0.5455,0.94,0.1045,2,32,34,89,34,34
15266,2012-10-03,Winter,2012,Oct,6,0,Wednesday,1,Misty,0.6,0.5152,0.94,0.1343,4,173,177,89,177,177
15267,2012-10-03,Winter,2012,Oct,7,0,Wednesday,1,Misty,0.6,0.5152,0.94,0.194,11,504,515,89,515,515
15268,2012-10-03,Winter,2012,Oct,8,0,Wednesday,1,Misty,0.62,0.5606,0.88,0.1045,28,781,809,89,809,809
15269,2012-10-03,Winter,2012,Oct,9,0,Wednesday,1,Misty,0.62,0.5758,0.83,0.194,30,332,362,89,362,362
15270,2012-10-03,Winter,2012,Oct,10,0,Wednesday,1,Clear,0.66,0.6061,0.78,0.1642,29,146,175,89,175,175
15271,2012-10-03,Winter,2012,Oct,11,0,Wednesday,1,Clear,0.66,0.6061,0.78,0.1642,52,178,230,89,230,230
15272,2012-10-03,Winter,2012,Oct,12,0,Wednesday,1,Misty,0.7,0.6515,0.7,0.1045,69,289,358,89,358,358
15273,2012-10-03,Winter,2012,Oct,13,0,Wednesday,1,Misty,0.7,0.6667,0.74,0.1045,55,224,279,89,279,279
15274,2012-10-03,Winter,2012,Oct,14,0,Wednesday,1,Misty,0.72,0.6818,0.7,0.1642,56,195,251,89,251,251
15275,2012-10-03,Winter,2012,Oct,15,0,Wednesday,1,Misty,0.72,0.6818,0.62,0.1642,59,260,319,89,319,319
15276,2012-10-03,Winter,2012,Oct,16,0,Wednesday,1,Misty,0.72,0.6667,0.58,0.0,42,436,478,89,478,478
15277,2012-10-03,Winter,2012,Oct,17,0,Wednesday,1,Clear,0.7,0.6515,0.65,0.0,84,833,917,89,917,917
15278,2012-10-03,Winter,2012,Oct,18,0,Wednesday,1,Clear,0.7,0.6515,0.65,0.0,54,756,810,89,810,810
15279,2012-10-03,Winter,2012,Oct,19,0,Wednesday,1,Clear,0.7,0.6515,0.65,0.0,49,544,593,89,593,593
15280,2012-10-03,Winter,2012,Oct,20,0,Wednesday,1,Clear,0.7,0.6515,0.65,0.0,48,449,497,89,497,497
15281,2012-10-03,Winter,2012,Oct,21,0,Wednesday,1,Misty,0.66,0.6212,0.74,0.0,14,195,209,89,209,209
15282,2012-10-03,Winter,2012,Oct,22,0,Wednesday,1,Clear,0.66,0.6212,0.74,0.0,9,232,241,89,241,241
15283,2012-10-03,Winter,2012,Oct,23,0,Wednesday,1,Misty,0.66,0.6061,0.78,0.0,21,199,220,89,220,220
15284,2012-10-04,Winter,2012,Oct,0,0,Thursday,1,Light_rainsnow,0.64,0.5758,0.89,0.0,11,65,76,88,76,76
15285,2012-10-04,Winter,2012,Oct,1,0,Thursday,1,Misty,0.62,0.5455,0.94,0.0,2,23,25,88,25,25
15286,2012-10-04,Winter,2012,Oct,2,0,Thursday,1,Clear,0.64,0.5758,0.89,0.0,3,10,13,88,13,13
15287,2012-10-04,Winter,2012,Oct,3,0,Thursday,1,Misty,0.62,0.5606,0.88,0.0,5,6,11,88,11,11
15288,2012-10-04,Winter,2012,Oct,4,0,Thursday,1,Misty,0.64,0.5758,0.89,0.0,0,10,10,88,10,10
15289,2012-10-04,Winter,2012,Oct,5,0,Thursday,1,Light_rainsnow,0.64,0.5758,0.89,0.1045,2,37,39,88,39,39
15290,2012-10-04,Winter,2012,Oct,6,0,Thursday,1,Light_rainsnow,0.62,0.5455,0.94,0.0896,1,132,133,88,133,133
15291,2012-10-04,Winter,2012,Oct,7,0,Thursday,1,Misty,0.64,0.5758,0.89,0.0896,12,379,391,88,391,391
15292,2012-10-04,Winter,2012,Oct,8,0,Thursday,1,Clear,0.64,0.5758,0.89,0.0,27,711,738,88,738,738
15293,2012-10-04,Winter,2012,Oct,9,0,Thursday,1,Misty,0.64,0.5758,0.89,0.194,40,319,359,88,359,359
15294,2012-10-04,Winter,2012,Oct,10,0,Thursday,1,Misty,0.66,0.6061,0.83,0.1343,27,150,177,88,177,177
15295,2012-10-04,Winter,2012,Oct,11,0,Thursday,1,Misty,0.7,0.6515,0.7,0.1045,38,176,214,88,214,214
15296,2012-10-04,Winter,2012,Oct,12,0,Thursday,1,Misty,0.72,0.6667,0.54,0.194,57,231,288,88,288,288
15297,2012-10-04,Winter,2012,Oct,13,0,Thursday,1,Misty,0.72,0.6667,0.58,0.3284,63,231,294,88,294,294
15298,2012-10-04,Winter,2012,Oct,14,0,Thursday,1,Clear,0.7,0.6515,0.61,0.2537,56,211,267,88,267,267
15299,2012-10-04,Winter,2012,Oct,15,0,Thursday,1,Clear,0.72,0.6667,0.54,0.2836,77,248,325,88,325,325
15300,2012-10-04,Winter,2012,Oct,16,0,Thursday,1,Clear,0.7,0.6515,0.54,0.2836,86,411,497,88,497,497
15301,2012-10-04,Winter,2012,Oct,17,0,Thursday,1,Clear,0.7,0.6515,0.51,0.2239,112,789,901,88,901,901
15302,2012-10-04,Winter,2012,Oct,18,0,Thursday,1,Clear,0.66,0.6212,0.57,0.1045,75,812,887,88,887,887
15303,2012-10-04,Winter,2012,Oct,19,0,Thursday,1,Clear,0.66,0.6212,0.57,0.1045,67,467,534,88,534,534
15304,2012-10-04,Winter,2012,Oct,20,0,Thursday,1,Clear,0.64,0.6061,0.65,0.1045,50,391,441,88,441,441
15305,2012-10-04,Winter,2012,Oct,21,0,Thursday,1,Clear,0.62,0.6061,0.69,0.0,33,288,321,88,321,321
15306,2012-10-04,Winter,2012,Oct,22,0,Thursday,1,Clear,0.64,0.6212,0.47,0.1343,29,203,232,88,232,232
15307,2012-10-04,Winter,2012,Oct,23,0,Thursday,1,Clear,0.6,0.6212,0.56,0.0896,18,137,155,88,155,155
15308,2012-10-05,Winter,2012,Oct,0,0,Friday,1,Clear,0.56,0.5303,0.73,0.0,16,86,102,87,102,102
15309,2012-10-05,Winter,2012,Oct,1,0,Friday,1,Clear,0.54,0.5152,0.68,0.1045,3,43,46,87,46,46
15310,2012-10-05,Winter,2012,Oct,2,0,Friday,1,Clear,0.54,0.5152,0.73,0.0896,1,10,11,87,11,11
15311,2012-10-05,Winter,2012,Oct,3,0,Friday,1,Clear,0.54,0.5152,0.73,0.0,5,11,16,87,16,16
15312,2012-10-05,Winter,2012,Oct,4,0,Friday,1,Clear,0.54,0.5152,0.77,0.0,0,11,11,87,11,11
15313,2012-10-05,Winter,2012,Oct,5,0,Friday,1,Clear,0.52,0.5,0.77,0.0,0,41,41,87,41,41
15314,2012-10-05,Winter,2012,Oct,6,0,Friday,1,Clear,0.52,0.5,0.83,0.0,4,133,137,87,137,137
15315,2012-10-05,Winter,2012,Oct,7,0,Friday,1,Clear,0.52,0.5,0.83,0.1045,11,417,428,87,428,428
15316,2012-10-05,Winter,2012,Oct,8,0,Friday,1,Clear,0.58,0.5455,0.64,0.0,36,749,785,87,785,785
15317,2012-10-05,Winter,2012,Oct,9,0,Friday,1,Clear,0.6,0.6061,0.6,0.0896,58,326,384,87,384,384
15318,2012-10-05,Winter,2012,Oct,10,0,Friday,1,Clear,0.66,0.6212,0.54,0.0,68,192,260,87,260,260
15319,2012-10-05,Winter,2012,Oct,11,0,Friday,1,Clear,0.7,0.6515,0.48,0.194,90,214,304,87,304,304
15320,2012-10-05,Winter,2012,Oct,12,0,Friday,1,Clear,0.72,0.6515,0.42,0.1642,161,307,468,87,468,468
15321,2012-10-05,Winter,2012,Oct,13,0,Friday,1,Clear,0.7,0.6515,0.48,0.0,117,307,424,87,424,424
15322,2012-10-05,Winter,2012,Oct,14,0,Friday,1,Clear,0.74,0.6515,0.37,0.2239,113,287,400,87,400,400
15323,2012-10-05,Winter,2012,Oct,15,0,Friday,1,Clear,0.72,0.6515,0.39,0.2537,150,320,470,87,470,470
15324,2012-10-05,Winter,2012,Oct,16,0,Friday,1,Clear,0.72,0.6515,0.37,0.0,153,481,634,87,634,634
15325,2012-10-05,Winter,2012,Oct,17,0,Friday,1,Clear,0.7,0.6364,0.42,0.1642,158,742,900,87,900,900
15326,2012-10-05,Winter,2012,Oct,18,0,Friday,1,Clear,0.64,0.6212,0.57,0.1343,106,655,761,87,761,761
15327,2012-10-05,Winter,2012,Oct,19,0,Friday,1,Clear,0.62,0.5909,0.73,0.1642,67,433,500,87,500,500
15328,2012-10-05,Winter,2012,Oct,20,0,Friday,1,Clear,0.6,0.5758,0.78,0.1343,66,306,372,87,372,372
15329,2012-10-05,Winter,2012,Oct,21,0,Friday,1,Clear,0.6,0.5909,0.69,0.2239,47,220,267,87,267,267
15330,2012-10-05,Winter,2012,Oct,22,0,Friday,1,Clear,0.6,0.5909,0.73,0.2836,63,201,264,87,264,264
15331,2012-10-05,Winter,2012,Oct,23,0,Friday,1,Clear,0.58,0.5455,0.78,0.2239,23,148,171,87,171,171
15332,2012-10-06,Winter,2012,Oct,0,0,Saturday,0,Clear,0.56,0.5303,0.83,0.1642,37,154,191,86,191,191
15333,2012-10-06,Winter,2012,Oct,1,0,Saturday,0,Clear,0.56,0.5303,0.83,0.2537,25,116,141,86,141,141
15334,2012-10-06,Winter,2012,Oct,2,0,Saturday,0,Clear,0.56,0.5303,0.78,0.194,13,62,75,86,75,75
15335,2012-10-06,Winter,2012,Oct,3,0,Saturday,0,Clear,0.54,0.5152,0.77,0.2239,2,54,56,86,56,56
15336,2012-10-06,Winter,2012,Oct,4,0,Saturday,0,Clear,0.54,0.5152,0.83,0.2537,4,7,11,86,11,11
15337,2012-10-06,Winter,2012,Oct,5,0,Saturday,0,Clear,0.54,0.5152,0.83,0.194,2,8,10,86,10,10
15338,2012-10-06,Winter,2012,Oct,6,0,Saturday,0,Clear,0.54,0.5152,0.88,0.2537,2,28,30,86,30,30
15339,2012-10-06,Winter,2012,Oct,7,0,Saturday,0,Clear,0.54,0.5152,0.83,0.2985,13,71,84,86,84,84
15340,2012-10-06,Winter,2012,Oct,8,0,Saturday,0,Clear,0.56,0.5303,0.83,0.194,22,184,206,86,206,206
15341,2012-10-06,Winter,2012,Oct,9,0,Saturday,0,Clear,0.6,0.5909,0.73,0.194,130,265,395,86,395,395
15342,2012-10-06,Winter,2012,Oct,10,0,Saturday,0,Clear,0.62,0.6061,0.69,0.2836,198,341,539,86,539,539
15343,2012-10-06,Winter,2012,Oct,11,0,Saturday,0,Clear,0.64,0.6061,0.65,0.2537,258,389,647,86,647,647
15344,2012-10-06,Winter,2012,Oct,12,0,Saturday,0,Clear,0.7,0.6515,0.54,0.1045,362,381,743,86,743,743
15345,2012-10-06,Winter,2012,Oct,13,0,Saturday,0,Misty,0.64,0.6212,0.57,0.5224,310,400,710,86,710,710
15346,2012-10-06,Winter,2012,Oct,14,0,Saturday,0,Misty,0.6,0.6212,0.56,0.4179,269,307,576,86,576,576
15347,2012-10-06,Winter,2012,Oct,15,0,Saturday,0,Clear,0.6,0.6212,0.46,0.4179,279,341,620,86,620,620
15348,2012-10-06,Winter,2012,Oct,16,0,Saturday,0,Clear,0.6,0.6212,0.43,0.5224,317,342,659,86,659,659
15349,2012-10-06,Winter,2012,Oct,17,0,Saturday,0,Clear,0.54,0.5152,0.49,0.3881,268,342,610,86,610,610
15350,2012-10-06,Winter,2012,Oct,18,0,Saturday,0,Clear,0.52,0.5,0.48,0.4179,183,312,495,86,495,495
15351,2012-10-06,Winter,2012,Oct,19,0,Saturday,0,Clear,0.48,0.4697,0.55,0.2239,102,239,341,86,341,341
15352,2012-10-06,Winter,2012,Oct,20,0,Saturday,0,Clear,0.48,0.4697,0.55,0.2537,75,172,247,86,247,247
15353,2012-10-06,Winter,2012,Oct,21,0,Saturday,0,Clear,0.46,0.4545,0.59,0.1343,78,137,215,86,215,215
15354,2012-10-06,Winter,2012,Oct,22,0,Saturday,0,Clear,0.44,0.4394,0.62,0.1343,45,140,185,86,185,185
15355,2012-10-06,Winter,2012,Oct,23,0,Saturday,0,Clear,0.44,0.4394,0.62,0.1343,37,142,179,86,179,179
15356,2012-10-07,Winter,2012,Oct,0,0,Sunday,0,Clear,0.44,0.4394,0.62,0.1642,28,99,127,85,127,127
15357,2012-10-07,Winter,2012,Oct,1,0,Sunday,0,Clear,0.44,0.4394,0.54,0.2239,29,80,109,85,109,109
15358,2012-10-07,Winter,2012,Oct,2,0,Sunday,0,Clear,0.42,0.4242,0.62,0.1343,10,64,74,85,74,74
15359,2012-10-07,Winter,2012,Oct,3,0,Sunday,0,Misty,0.44,0.4394,0.62,0.1343,5,17,22,85,22,22
15360,2012-10-07,Winter,2012,Oct,4,0,Sunday,0,Misty,0.44,0.4394,0.54,0.2537,5,6,11,85,11,11
15361,2012-10-07,Winter,2012,Oct,5,0,Sunday,0,Misty,0.44,0.4394,0.54,0.1343,2,8,10,85,10,10
15362,2012-10-07,Winter,2012,Oct,6,0,Sunday,0,Misty,0.44,0.4394,0.54,0.194,4,19,23,85,23,23
15363,2012-10-07,Winter,2012,Oct,7,0,Sunday,0,Light_rainsnow,0.42,0.4242,0.58,0.1642,6,29,35,85,35,35
15364,2012-10-07,Winter,2012,Oct,8,0,Sunday,0,Light_rainsnow,0.42,0.4242,0.67,0.1343,11,51,62,85,62,62
15365,2012-10-07,Winter,2012,Oct,9,0,Sunday,0,Light_rainsnow,0.4,0.4091,0.71,0.1343,16,70,86,85,86,86
15366,2012-10-07,Winter,2012,Oct,10,0,Sunday,0,Misty,0.42,0.4242,0.67,0.194,41,144,185,85,185,185
15367,2012-10-07,Winter,2012,Oct,11,0,Sunday,0,Misty,0.42,0.4242,0.71,0.1045,76,260,336,85,336,336
15368,2012-10-07,Winter,2012,Oct,12,0,Sunday,0,Misty,0.42,0.4242,0.71,0.0,100,292,392,85,392,392
15369,2012-10-07,Winter,2012,Oct,13,0,Sunday,0,Misty,0.44,0.4394,0.72,0.0896,80,240,320,85,320,320
15370,2012-10-07,Winter,2012,Oct,14,0,Sunday,0,Misty,0.44,0.4394,0.67,0.0,71,243,314,85,314,314
15371,2012-10-07,Winter,2012,Oct,15,0,Sunday,0,Light_rainsnow,0.42,0.4242,0.77,0.1343,74,232,306,85,306,306
15372,2012-10-07,Winter,2012,Oct,16,0,Sunday,0,Light_rainsnow,0.4,0.4091,0.82,0.1642,87,246,333,85,333,333
15373,2012-10-07,Winter,2012,Oct,17,0,Sunday,0,Light_rainsnow,0.4,0.4091,0.82,0.2239,35,122,157,85,157,157
15374,2012-10-07,Winter,2012,Oct,18,0,Sunday,0,Light_rainsnow,0.4,0.4091,0.82,0.194,24,82,106,85,106,106
15375,2012-10-07,Winter,2012,Oct,19,0,Sunday,0,Misty,0.4,0.4091,0.82,0.1045,17,97,114,85,114,114
15376,2012-10-07,Winter,2012,Oct,20,0,Sunday,0,Clear,0.4,0.4091,0.82,0.1343,19,97,116,85,116,116
15377,2012-10-07,Winter,2012,Oct,21,0,Sunday,0,Clear,0.38,0.3939,0.87,0.1045,22,91,113,85,113,113
15378,2012-10-07,Winter,2012,Oct,22,0,Sunday,0,Clear,0.38,0.3939,0.87,0.1343,7,72,79,85,79,79
15379,2012-10-07,Winter,2012,Oct,23,0,Sunday,0,Clear,0.36,0.3485,0.93,0.1343,12,68,80,85,80,80
15380,2012-10-08,Winter,2012,Oct,0,1,Monday,0,Clear,0.38,0.3939,0.76,0.2836,7,44,51,84,51,51
15381,2012-10-08,Winter,2012,Oct,1,1,Monday,0,Clear,0.34,0.3333,0.87,0.1642,2,35,37,84,37,37
15382,2012-10-08,Winter,2012,Oct,2,1,Monday,0,Clear,0.34,0.3333,0.81,0.194,3,12,15,84,15,15
15383,2012-10-08,Winter,2012,Oct,3,1,Monday,0,Clear,0.34,0.3485,0.81,0.1045,2,8,10,84,10,10
15384,2012-10-08,Winter,2012,Oct,4,1,Monday,0,Clear,0.32,0.3333,0.87,0.1343,1,6,7,84,7,7
15385,2012-10-08,Winter,2012,Oct,5,1,Monday,0,Clear,0.34,0.3182,0.76,0.2239,2,17,19,84,19,19
15386,2012-10-08,Winter,2012,Oct,6,1,Monday,0,Clear,0.34,0.3485,0.76,0.1045,5,54,59,84,59,59
15387,2012-10-08,Winter,2012,Oct,7,1,Monday,0,Misty,0.34,0.3333,0.76,0.1642,3,151,154,84,154,154
15388,2012-10-08,Winter,2012,Oct,8,1,Monday,0,Misty,0.36,0.3485,0.71,0.2239,23,374,397,84,397,397
15389,2012-10-08,Winter,2012,Oct,9,1,Monday,0,Misty,0.38,0.3939,0.66,0.1642,59,273,332,84,332,332
15390,2012-10-08,Winter,2012,Oct,10,1,Monday,0,Misty,0.38,0.3939,0.68,0.1343,69,229,298,84,298,298
15391,2012-10-08,Winter,2012,Oct,11,1,Monday,0,Misty,0.4,0.4091,0.62,0.0896,72,236,308,84,308,308
15392,2012-10-08,Winter,2012,Oct,12,1,Monday,0,Misty,0.42,0.4242,0.63,0.1642,74,267,341,84,341,341
15393,2012-10-08,Winter,2012,Oct,13,1,Monday,0,Misty,0.42,0.4242,0.62,0.194,82,323,405,84,405,405
15394,2012-10-08,Winter,2012,Oct,14,1,Monday,0,Misty,0.42,0.4242,0.58,0.1045,121,299,420,84,420,420
15395,2012-10-08,Winter,2012,Oct,15,1,Monday,0,Light_rainsnow,0.42,0.4242,0.58,0.194,76,294,370,84,370,370
15396,2012-10-08,Winter,2012,Oct,16,1,Monday,0,Light_rainsnow,0.42,0.4242,0.58,0.194,61,316,377,84,377,377
15397,2012-10-08,Winter,2012,Oct,17,1,Monday,0,Misty,0.42,0.4242,0.66,0.2537,81,416,497,84,497,497
15398,2012-10-08,Winter,2012,Oct,18,1,Monday,0,Misty,0.42,0.4242,0.66,0.2836,41,415,456,84,456,456
15399,2012-10-08,Winter,2012,Oct,19,1,Monday,0,Misty,0.4,0.4091,0.71,0.2537,38,333,371,84,371,371
15400,2012-10-08,Winter,2012,Oct,20,1,Monday,0,Light_rainsnow,0.4,0.4091,0.71,0.2239,20,207,227,84,227,227
15401,2012-10-08,Winter,2012,Oct,21,1,Monday,0,Misty,0.4,0.4091,0.76,0.2239,17,134,151,84,151,151
15402,2012-10-08,Winter,2012,Oct,22,1,Monday,0,Light_rainsnow,0.4,0.4091,0.76,0.2537,6,101,107,84,107,107
15403,2012-10-08,Winter,2012,Oct,23,1,Monday,0,Misty,0.4,0.4091,0.71,0.2239,9,60,69,84,69,69
15404,2012-10-09,Winter,2012,Oct,0,0,Tuesday,1,Misty,0.38,0.3939,0.82,0.2239,9,22,31,83,31,31
15405,2012-10-09,Winter,2012,Oct,1,0,Tuesday,1,Light_rainsnow,0.36,0.3485,0.87,0.2239,0,13,13,83,13,13
15406,2012-10-09,Winter,2012,Oct,2,0,Tuesday,1,Light_rainsnow,0.36,0.3333,0.87,0.2537,2,5,7,83,7,7
15407,2012-10-09,Winter,2012,Oct,3,0,Tuesday,1,Light_rainsnow,0.36,0.3333,0.87,0.2836,0,3,3,83,3,3
15408,2012-10-09,Winter,2012,Oct,4,0,Tuesday,1,Light_rainsnow,0.36,0.3485,0.87,0.1642,1,6,7,83,7,7
15409,2012-10-09,Winter,2012,Oct,5,0,Tuesday,1,Misty,0.38,0.3939,0.82,0.194,0,19,19,83,19,19
15410,2012-10-09,Winter,2012,Oct,6,0,Tuesday,1,Misty,0.38,0.3939,0.82,0.2537,2,141,143,83,143,143
15411,2012-10-09,Winter,2012,Oct,7,0,Tuesday,1,Clear,0.38,0.3939,0.83,0.2537,5,357,362,83,362,362
15412,2012-10-09,Winter,2012,Oct,8,0,Tuesday,1,Misty,0.42,0.4242,0.8,0.194,15,698,713,83,713,713
15413,2012-10-09,Winter,2012,Oct,9,0,Tuesday,1,Misty,0.42,0.4242,0.77,0.2239,37,345,382,83,382,382
15414,2012-10-09,Winter,2012,Oct,10,0,Tuesday,1,Misty,0.44,0.4394,0.75,0.2239,33,131,164,83,164,164
15415,2012-10-09,Winter,2012,Oct,11,0,Tuesday,1,Misty,0.48,0.4697,0.69,0.194,37,156,193,83,193,193
15416,2012-10-09,Winter,2012,Oct,12,0,Tuesday,1,Misty,0.48,0.4697,0.69,0.194,43,217,260,83,260,260
15417,2012-10-09,Winter,2012,Oct,13,0,Tuesday,1,Misty,0.5,0.4848,0.67,0.1343,54,184,238,83,238,238
15418,2012-10-09,Winter,2012,Oct,14,0,Tuesday,1,Misty,0.54,0.5152,0.64,0.194,43,201,244,83,244,244
15419,2012-10-09,Winter,2012,Oct,15,0,Tuesday,1,Misty,0.52,0.5,0.63,0.1642,59,195,254,83,254,254
15420,2012-10-09,Winter,2012,Oct,16,0,Tuesday,1,Misty,0.5,0.4848,0.72,0.1642,70,354,424,83,424,424
15421,2012-10-09,Winter,2012,Oct,17,0,Tuesday,1,Misty,0.52,0.5,0.68,0.1642,73,733,806,83,806,806
15422,2012-10-09,Winter,2012,Oct,18,0,Tuesday,1,Misty,0.5,0.4848,0.72,0.2239,26,758,784,83,784,784
15423,2012-10-09,Winter,2012,Oct,19,0,Tuesday,1,Misty,0.5,0.4848,0.72,0.1642,31,483,514,83,514,514
15424,2012-10-09,Winter,2012,Oct,20,0,Tuesday,1,Misty,0.5,0.4848,0.72,0.1642,30,330,360,83,360,360
15425,2012-10-09,Winter,2012,Oct,21,0,Tuesday,1,Misty,0.48,0.4697,0.77,0.1343,16,209,225,83,225,225
15426,2012-10-09,Winter,2012,Oct,22,0,Tuesday,1,Misty,0.48,0.4697,0.77,0.0896,7,155,162,83,162,162
15427,2012-10-09,Winter,2012,Oct,23,0,Tuesday,1,Misty,0.48,0.4697,0.77,0.0896,8,76,84,83,84,84
15428,2012-10-10,Winter,2012,Oct,0,0,Wednesday,1,Misty,0.46,0.4545,0.88,0.0896,0,33,33,82,33,33
15429,2012-10-10,Winter,2012,Oct,1,0,Wednesday,1,Misty,0.46,0.4545,0.88,0.0,2,6,8,82,8,8
15430,2012-10-10,Winter,2012,Oct,2,0,Wednesday,1,Misty,0.46,0.4545,0.88,0.0,2,6,8,82,8,8
15431,2012-10-10,Winter,2012,Oct,3,0,Wednesday,1,Misty,0.46,0.4545,0.88,0.0,0,6,6,82,6,6
15432,2012-10-10,Winter,2012,Oct,4,0,Wednesday,1,Misty,0.46,0.4545,0.88,0.1045,0,6,6,82,6,6
15433,2012-10-10,Winter,2012,Oct,5,0,Wednesday,1,Misty,0.46,0.4545,0.88,0.0896,2,38,40,82,40,40
15434,2012-10-10,Winter,2012,Oct,6,0,Wednesday,1,Misty,0.46,0.4545,0.88,0.0896,3,172,175,82,175,175
15435,2012-10-10,Winter,2012,Oct,7,0,Wednesday,1,Clear,0.46,0.4545,0.82,0.1045,9,498,507,82,507,507
15436,2012-10-10,Winter,2012,Oct,8,0,Wednesday,1,Clear,0.5,0.4848,0.77,0.1642,33,806,839,82,839,839
15437,2012-10-10,Winter,2012,Oct,9,0,Wednesday,1,Clear,0.54,0.5152,0.6,0.2836,35,331,366,82,366,366
15438,2012-10-10,Winter,2012,Oct,10,0,Wednesday,1,Clear,0.56,0.5303,0.52,0.2985,27,190,217,82,217,217
15439,2012-10-10,Winter,2012,Oct,11,0,Wednesday,1,Clear,0.54,0.5152,0.52,0.194,53,238,291,82,291,291
15440,2012-10-10,Winter,2012,Oct,12,0,Wednesday,1,Clear,0.54,0.5152,0.56,0.2239,78,312,390,82,390,390
15441,2012-10-10,Winter,2012,Oct,13,0,Wednesday,1,Clear,0.56,0.5303,0.49,0.0,60,237,297,82,297,297
15442,2012-10-10,Winter,2012,Oct,14,0,Wednesday,1,Clear,0.6,0.6212,0.4,0.1642,63,208,271,82,271,271
15443,2012-10-10,Winter,2012,Oct,15,0,Wednesday,1,Clear,0.6,0.6212,0.4,0.1642,58,261,319,82,319,319
15444,2012-10-10,Winter,2012,Oct,16,0,Wednesday,1,Clear,0.6,0.6212,0.4,0.2239,92,474,566,82,566,566
15445,2012-10-10,Winter,2012,Oct,17,0,Wednesday,1,Clear,0.58,0.5455,0.43,0.2239,91,857,948,82,948,948
15446,2012-10-10,Winter,2012,Oct,18,0,Wednesday,1,Misty,0.56,0.5303,0.49,0.1642,57,787,844,82,844,844
15447,2012-10-10,Winter,2012,Oct,19,0,Wednesday,1,Misty,0.56,0.5303,0.46,0.5821,32,534,566,82,566,566
15448,2012-10-10,Winter,2012,Oct,20,0,Wednesday,1,Clear,0.52,0.5,0.48,0.4925,21,371,392,82,392,392
15449,2012-10-10,Winter,2012,Oct,21,0,Wednesday,1,Clear,0.5,0.4848,0.51,0.3582,18,251,269,82,269,269
15450,2012-10-10,Winter,2012,Oct,22,0,Wednesday,1,Clear,0.46,0.4545,0.55,0.2985,27,170,197,82,197,197
15451,2012-10-10,Winter,2012,Oct,23,0,Wednesday,1,Clear,0.44,0.4394,0.58,0.194,17,119,136,82,136,136
15452,2012-10-11,Winter,2012,Oct,0,0,Thursday,1,Clear,0.44,0.4394,0.51,0.1343,1,41,42,81,42,42
15453,2012-10-11,Winter,2012,Oct,1,0,Thursday,1,Clear,0.44,0.4394,0.47,0.194,1,10,11,81,11,11
15454,2012-10-11,Winter,2012,Oct,2,0,Thursday,1,Clear,0.42,0.4242,0.5,0.1343,4,7,11,81,11,11
15455,2012-10-11,Winter,2012,Oct,3,0,Thursday,1,Clear,0.42,0.4242,0.47,0.2985,0,3,3,81,3,3
15456,2012-10-11,Winter,2012,Oct,4,0,Thursday,1,Clear,0.4,0.4091,0.5,0.2537,0,10,10,81,10,10
15457,2012-10-11,Winter,2012,Oct,5,0,Thursday,1,Clear,0.36,0.3485,0.5,0.1642,0,42,42,81,42,42
15458,2012-10-11,Winter,2012,Oct,6,0,Thursday,1,Clear,0.36,0.3485,0.5,0.1642,1,158,159,81,159,159
15459,2012-10-11,Winter,2012,Oct,7,0,Thursday,1,Clear,0.36,0.3333,0.5,0.2537,11,467,478,81,478,478
15460,2012-10-11,Winter,2012,Oct,8,0,Thursday,1,Clear,0.38,0.3939,0.46,0.3881,25,773,798,81,798,798
15461,2012-10-11,Winter,2012,Oct,9,0,Thursday,1,Clear,0.4,0.4091,0.43,0.3881,27,328,355,81,355,355
15462,2012-10-11,Winter,2012,Oct,10,0,Thursday,1,Clear,0.44,0.4394,0.41,0.3582,39,165,204,81,204,204
15463,2012-10-11,Winter,2012,Oct,11,0,Thursday,1,Clear,0.46,0.4545,0.36,0.0,76,175,251,81,251,251
15464,2012-10-11,Winter,2012,Oct,12,0,Thursday,1,Clear,0.46,0.4545,0.36,0.0,47,279,326,81,326,326
15465,2012-10-11,Winter,2012,Oct,13,0,Thursday,1,Clear,0.5,0.4848,0.31,0.1045,48,243,291,81,291,291
15466,2012-10-11,Winter,2012,Oct,14,0,Thursday,1,Clear,0.52,0.5,0.32,0.0896,78,270,348,81,348,348
15467,2012-10-11,Winter,2012,Oct,15,0,Thursday,1,Clear,0.52,0.5,0.34,0.1642,102,358,460,81,460,460
15468,2012-10-11,Winter,2012,Oct,16,0,Thursday,1,Clear,0.5,0.4848,0.36,0.1343,68,413,481,81,481,481
15469,2012-10-11,Winter,2012,Oct,17,0,Thursday,1,Clear,0.5,0.4848,0.39,0.2836,90,737,827,81,827,827
15470,2012-10-11,Winter,2012,Oct,18,0,Thursday,1,Clear,0.46,0.4545,0.44,0.1642,64,628,692,81,692,692
15471,2012-10-11,Winter,2012,Oct,19,0,Thursday,1,Clear,0.44,0.4394,0.51,0.1343,81,662,743,81,743,743
15472,2012-10-11,Winter,2012,Oct,20,0,Thursday,1,Clear,0.42,0.4242,0.62,0.1642,27,388,415,81,415,415
15473,2012-10-11,Winter,2012,Oct,21,0,Thursday,1,Clear,0.42,0.4242,0.62,0.1343,24,236,260,81,260,260
15474,2012-10-11,Winter,2012,Oct,22,0,Thursday,1,Clear,0.4,0.4091,0.66,0.1642,10,167,177,81,177,177
15475,2012-10-11,Winter,2012,Oct,23,0,Thursday,1,Clear,0.42,0.4242,0.58,0.0896,10,176,186,81,186,186
15476,2012-10-12,Winter,2012,Oct,0,0,Friday,1,Clear,0.4,0.4091,0.66,0.1045,8,60,68,80,68,68
15477,2012-10-12,Winter,2012,Oct,1,0,Friday,1,Clear,0.4,0.4091,0.66,0.0896,8,29,37,80,37,37
15478,2012-10-12,Winter,2012,Oct,2,0,Friday,1,Clear,0.4,0.4091,0.66,0.0896,0,16,16,80,16,16
15479,2012-10-12,Winter,2012,Oct,3,0,Friday,1,Clear,0.36,0.3636,0.76,0.0896,0,6,6,80,6,6
15480,2012-10-12,Winter,2012,Oct,4,0,Friday,1,Clear,0.36,0.3636,0.76,0.1045,0,8,8,80,8,8
15481,2012-10-12,Winter,2012,Oct,5,0,Friday,1,Clear,0.36,0.3636,0.81,0.0896,2,33,35,80,35,35
15482,2012-10-12,Winter,2012,Oct,6,0,Friday,1,Clear,0.34,0.3485,0.81,0.0896,3,140,143,80,143,143
15483,2012-10-12,Winter,2012,Oct,7,0,Friday,1,Clear,0.36,0.3636,0.81,0.0896,8,384,392,80,392,392
15484,2012-10-12,Winter,2012,Oct,8,0,Friday,1,Clear,0.42,0.4242,0.71,0.0896,34,711,745,80,745,745
15485,2012-10-12,Winter,2012,Oct,9,0,Friday,1,Clear,0.5,0.4848,0.39,0.2985,26,374,400,80,400,400
15486,2012-10-12,Winter,2012,Oct,10,0,Friday,1,Clear,0.52,0.5,0.36,0.2985,75,200,275,80,275,275
15487,2012-10-12,Winter,2012,Oct,11,0,Friday,1,Clear,0.54,0.5152,0.37,0.3582,61,252,313,80,313,313
15488,2012-10-12,Winter,2012,Oct,12,0,Friday,1,Clear,0.54,0.5152,0.39,0.4627,75,312,387,80,387,387
15489,2012-10-12,Winter,2012,Oct,13,0,Friday,1,Clear,0.56,0.5303,0.37,0.3881,81,300,381,80,381,381
15490,2012-10-12,Winter,2012,Oct,14,0,Friday,1,Clear,0.56,0.5303,0.37,0.4627,109,262,371,80,371,371
15491,2012-10-12,Winter,2012,Oct,15,0,Friday,1,Clear,0.52,0.5,0.42,0.4478,138,317,455,80,455,455
15492,2012-10-12,Winter,2012,Oct,16,0,Friday,1,Clear,0.46,0.4545,0.41,0.3582,108,412,520,80,520,520
15493,2012-10-12,Winter,2012,Oct,17,0,Friday,1,Clear,0.46,0.4545,0.38,0.3881,131,706,837,80,837,837
15494,2012-10-12,Winter,2012,Oct,18,0,Friday,1,Clear,0.44,0.4394,0.38,0.2985,76,566,642,80,642,642
15495,2012-10-12,Winter,2012,Oct,19,0,Friday,1,Clear,0.42,0.4242,0.41,0.2239,40,453,493,80,493,493
15496,2012-10-12,Winter,2012,Oct,20,0,Friday,1,Clear,0.42,0.4242,0.47,0.1343,28,280,308,80,308,308
15497,2012-10-12,Winter,2012,Oct,21,0,Friday,1,Clear,0.4,0.4091,0.54,0.194,21,169,190,80,190,190
15498,2012-10-12,Winter,2012,Oct,22,0,Friday,1,Clear,0.4,0.4091,0.47,0.2985,17,143,160,80,160,160
15499,2012-10-12,Winter,2012,Oct,23,0,Friday,1,Clear,0.36,0.3485,0.57,0.194,11,89,100,80,100,100
15500,2012-10-13,Winter,2012,Oct,0,0,Saturday,0,Clear,0.36,0.3636,0.57,0.0896,31,218,249,79,249,249
15501,2012-10-13,Winter,2012,Oct,1,0,Saturday,0,Clear,0.34,0.3333,0.53,0.1343,23,123,146,79,146,146
15502,2012-10-13,Winter,2012,Oct,2,0,Saturday,0,Clear,0.34,0.3333,0.53,0.194,7,60,67,79,67,67
15503,2012-10-13,Winter,2012,Oct,3,0,Saturday,0,Clear,0.32,0.303,0.66,0.2239,2,13,15,79,15,15
15504,2012-10-13,Winter,2012,Oct,4,0,Saturday,0,Clear,0.3,0.303,0.65,0.1642,2,9,11,79,11,11
15505,2012-10-13,Winter,2012,Oct,5,0,Saturday,0,Clear,0.3,0.2879,0.61,0.194,0,11,11,79,11,11
15506,2012-10-13,Winter,2012,Oct,6,0,Saturday,0,Clear,0.3,0.2879,0.61,0.194,5,23,28,79,28,28
15507,2012-10-13,Winter,2012,Oct,7,0,Saturday,0,Clear,0.3,0.303,0.61,0.1642,10,60,70,79,70,70
15508,2012-10-13,Winter,2012,Oct,8,0,Saturday,0,Clear,0.34,0.3485,0.53,0.1045,23,151,174,79,174,174
15509,2012-10-13,Winter,2012,Oct,9,0,Saturday,0,Clear,0.36,0.3636,0.5,0.0896,46,220,266,79,266,266
15510,2012-10-13,Winter,2012,Oct,10,0,Saturday,0,Clear,0.4,0.4091,0.43,0.0,82,265,347,79,347,347
15511,2012-10-13,Winter,2012,Oct,11,0,Saturday,0,Clear,0.42,0.4242,0.35,0.1343,192,335,527,79,527,527
15512,2012-10-13,Winter,2012,Oct,12,0,Saturday,0,Clear,0.44,0.4394,0.35,0.0,202,371,573,79,573,573
15513,2012-10-13,Winter,2012,Oct,13,0,Saturday,0,Clear,0.46,0.4545,0.36,0.194,235,435,670,79,670,670
15514,2012-10-13,Winter,2012,Oct,14,0,Saturday,0,Clear,0.48,0.4697,0.33,0.194,243,354,597,79,597,597
15515,2012-10-13,Winter,2012,Oct,15,0,Saturday,0,Clear,0.5,0.4848,0.36,0.194,251,364,615,79,615,615
15516,2012-10-13,Winter,2012,Oct,16,0,Saturday,0,Clear,0.5,0.4848,0.31,0.194,294,343,637,79,637,637
15517,2012-10-13,Winter,2012,Oct,17,0,Saturday,0,Clear,0.46,0.4545,0.38,0.1642,193,335,528,79,528,528
15518,2012-10-13,Winter,2012,Oct,18,0,Saturday,0,Clear,0.46,0.4545,0.44,0.1343,174,299,473,79,473,473
15519,2012-10-13,Winter,2012,Oct,19,0,Saturday,0,Clear,0.44,0.4394,0.44,0.1642,73,259,332,79,332,332
15520,2012-10-13,Winter,2012,Oct,20,0,Saturday,0,Clear,0.4,0.4091,0.54,0.0896,57,198,255,79,255,255
15521,2012-10-13,Winter,2012,Oct,21,0,Saturday,0,Clear,0.4,0.4091,0.58,0.194,47,157,204,79,204,204
15522,2012-10-13,Winter,2012,Oct,22,0,Saturday,0,Clear,0.4,0.4091,0.62,0.0,33,156,189,79,189,189
15523,2012-10-13,Winter,2012,Oct,23,0,Saturday,0,Clear,0.42,0.4242,0.58,0.2985,27,98,125,79,125,125
15524,2012-10-14,Winter,2012,Oct,0,0,Sunday,0,Clear,0.4,0.4091,0.71,0.2537,8,103,111,78,111,111
15525,2012-10-14,Winter,2012,Oct,1,0,Sunday,0,Clear,0.42,0.4242,0.77,0.2836,16,96,112,78,112,112
15526,2012-10-14,Winter,2012,Oct,2,0,Sunday,0,Clear,0.4,0.4091,0.76,0.0896,8,58,66,78,66,66
15527,2012-10-14,Winter,2012,Oct,3,0,Sunday,0,Clear,0.42,0.4242,0.77,0.2985,3,25,28,78,28,28
15528,2012-10-14,Winter,2012,Oct,4,0,Sunday,0,Clear,0.42,0.4242,0.77,0.2836,2,10,12,78,12,12
15529,2012-10-14,Winter,2012,Oct,5,0,Sunday,0,Clear,0.4,0.4091,0.82,0.194,5,6,11,78,11,11
15530,2012-10-14,Winter,2012,Oct,6,0,Sunday,0,Clear,0.4,0.4091,0.82,0.1642,4,20,24,78,24,24
15531,2012-10-14,Winter,2012,Oct,7,0,Sunday,0,Clear,0.42,0.4242,0.82,0.2239,7,44,51,78,51,51
15532,2012-10-14,Winter,2012,Oct,8,0,Sunday,0,Clear,0.44,0.4394,0.77,0.194,28,104,132,78,132,132
15533,2012-10-14,Winter,2012,Oct,9,0,Sunday,0,Misty,0.48,0.4697,0.67,0.2836,62,161,223,78,223,223
15534,2012-10-14,Winter,2012,Oct,10,0,Sunday,0,Clear,0.54,0.5152,0.56,0.194,150,278,428,78,428,428
15535,2012-10-14,Winter,2012,Oct,11,0,Sunday,0,Clear,0.56,0.5303,0.52,0.2985,156,338,494,78,494,494
15536,2012-10-14,Winter,2012,Oct,12,0,Sunday,0,Clear,0.62,0.6212,0.46,0.3284,200,362,562,78,562,562
15537,2012-10-14,Winter,2012,Oct,13,0,Sunday,0,Clear,0.64,0.6212,0.41,0.4478,218,401,619,78,619,619
15538,2012-10-14,Winter,2012,Oct,14,0,Sunday,0,Clear,0.66,0.6212,0.39,0.4179,249,368,617,78,617,617
15539,2012-10-14,Winter,2012,Oct,15,0,Sunday,0,Clear,0.66,0.6212,0.39,0.4179,213,355,568,78,568,568
15540,2012-10-14,Winter,2012,Oct,16,0,Sunday,0,Clear,0.64,0.6212,0.41,0.2985,203,378,581,78,581,581
15541,2012-10-14,Winter,2012,Oct,17,0,Sunday,0,Clear,0.64,0.6212,0.44,0.194,193,346,539,78,539,539
15542,2012-10-14,Winter,2012,Oct,18,0,Sunday,0,Clear,0.58,0.5455,0.6,0.2537,134,319,453,78,453,453
15543,2012-10-14,Winter,2012,Oct,19,0,Sunday,0,Clear,0.56,0.5303,0.64,0.2239,68,268,336,78,336,336
15544,2012-10-14,Winter,2012,Oct,20,0,Sunday,0,Clear,0.54,0.5152,0.73,0.2239,48,198,246,78,246,246
15545,2012-10-14,Winter,2012,Oct,21,0,Sunday,0,Clear,0.56,0.5303,0.73,0.4478,40,156,196,78,196,196
15546,2012-10-14,Winter,2012,Oct,22,0,Sunday,0,Clear,0.56,0.5303,0.73,0.3881,38,87,125,78,125,125
15547,2012-10-14,Winter,2012,Oct,23,0,Sunday,0,Misty,0.56,0.5303,0.68,0.2836,27,78,105,78,105,105
15548,2012-10-15,Winter,2012,Oct,0,0,Monday,1,Misty,0.56,0.5303,0.73,0.2537,17,31,48,77,48,48
15549,2012-10-15,Winter,2012,Oct,1,0,Monday,1,Misty,0.58,0.5455,0.64,0.3881,5,24,29,77,29,29
15550,2012-10-15,Winter,2012,Oct,2,0,Monday,1,Misty,0.58,0.5455,0.64,0.3582,1,5,6,77,6,6
15551,2012-10-15,Winter,2012,Oct,3,0,Monday,1,Misty,0.56,0.5303,0.73,0.2537,2,2,4,77,4,4
15552,2012-10-15,Winter,2012,Oct,4,0,Monday,1,Misty,0.56,0.5303,0.68,0.2239,1,9,10,77,10,10
15553,2012-10-15,Winter,2012,Oct,5,0,Monday,1,Misty,0.56,0.5303,0.73,0.2836,2,38,40,77,40,40
15554,2012-10-15,Winter,2012,Oct,6,0,Monday,1,Misty,0.56,0.5303,0.73,0.2985,6,141,147,77,147,147
15555,2012-10-15,Winter,2012,Oct,7,0,Monday,1,Misty,0.58,0.5455,0.68,0.3284,15,461,476,77,476,476
15556,2012-10-15,Winter,2012,Oct,8,0,Monday,1,Misty,0.6,0.6061,0.64,0.3881,24,713,737,77,737,737
15557,2012-10-15,Winter,2012,Oct,9,0,Monday,1,Light_rainsnow,0.6,0.5909,0.69,0.3881,31,328,359,77,359,359
15558,2012-10-15,Winter,2012,Oct,10,0,Monday,1,Misty,0.6,0.5909,0.73,0.3881,43,125,168,77,168,168
15559,2012-10-15,Winter,2012,Oct,11,0,Monday,1,Misty,0.6,0.5909,0.73,0.3881,88,175,263,77,263,263
15560,2012-10-15,Winter,2012,Oct,12,0,Monday,1,Light_rainsnow,0.6,0.5758,0.78,0.3284,73,211,284,77,284,284
15561,2012-10-15,Winter,2012,Oct,13,0,Monday,1,Misty,0.56,0.5303,0.88,0.2239,37,109,146,77,146,146
15562,2012-10-15,Winter,2012,Oct,14,0,Monday,1,Misty,0.6,0.5758,0.78,0.2836,57,128,185,77,185,185
15563,2012-10-15,Winter,2012,Oct,15,0,Monday,1,Clear,0.6,0.5758,0.78,0.3284,70,190,260,77,260,260
15564,2012-10-15,Winter,2012,Oct,16,0,Monday,1,Clear,0.56,0.5303,0.64,0.2985,76,371,447,77,447,447
15565,2012-10-15,Winter,2012,Oct,17,0,Monday,1,Clear,0.56,0.5303,0.64,0.2537,96,670,766,77,766,766
15566,2012-10-15,Winter,2012,Oct,18,0,Monday,1,Light_rainsnow,0.54,0.5152,0.77,0.1343,52,540,592,77,592,592
15567,2012-10-15,Winter,2012,Oct,19,0,Monday,1,Light_rainsnow,0.52,0.5,0.83,0.0896,12,227,239,77,239,239
15568,2012-10-15,Winter,2012,Oct,20,0,Monday,1,Misty,0.52,0.5,0.72,0.3881,19,237,256,77,256,256
15569,2012-10-15,Winter,2012,Oct,21,0,Monday,1,Clear,0.52,0.5,0.59,0.3284,16,190,206,77,206,206
15570,2012-10-15,Winter,2012,Oct,22,0,Monday,1,Clear,0.5,0.4848,0.59,0.2836,8,118,126,77,126,126
15571,2012-10-15,Winter,2012,Oct,23,0,Monday,1,Clear,0.46,0.4545,0.63,0.2239,9,72,81,77,81,81
15572,2012-10-16,Winter,2012,Oct,0,0,Tuesday,1,Clear,0.46,0.4545,0.63,0.3881,3,45,48,76,48,48
15573,2012-10-16,Winter,2012,Oct,1,0,Tuesday,1,Clear,0.44,0.4394,0.67,0.194,4,9,13,76,13,13
15574,2012-10-16,Winter,2012,Oct,2,0,Tuesday,1,Clear,0.44,0.4394,0.67,0.1343,2,1,3,76,3,3
15575,2012-10-16,Winter,2012,Oct,3,0,Tuesday,1,Clear,0.42,0.4242,0.67,0.1045,0,2,2,76,2,2
15576,2012-10-16,Winter,2012,Oct,4,0,Tuesday,1,Clear,0.42,0.4242,0.67,0.1642,0,7,7,76,7,7
15577,2012-10-16,Winter,2012,Oct,5,0,Tuesday,1,Clear,0.42,0.4242,0.67,0.2537,5,47,52,76,52,52
15578,2012-10-16,Winter,2012,Oct,6,0,Tuesday,1,Clear,0.42,0.4242,0.67,0.1642,4,168,172,76,172,172
15579,2012-10-16,Winter,2012,Oct,7,0,Tuesday,1,Clear,0.42,0.4242,0.67,0.0896,20,505,525,76,525,525
15580,2012-10-16,Winter,2012,Oct,8,0,Tuesday,1,Clear,0.44,0.4394,0.62,0.0,35,800,835,76,835,835
15581,2012-10-16,Winter,2012,Oct,9,0,Tuesday,1,Clear,0.48,0.4697,0.55,0.2537,32,323,355,76,355,355
15582,2012-10-16,Winter,2012,Oct,10,0,Tuesday,1,Clear,0.5,0.4848,0.48,0.2836,65,157,222,76,222,222
15583,2012-10-16,Winter,2012,Oct,11,0,Tuesday,1,Clear,0.5,0.4848,0.45,0.4179,56,172,228,76,228,228
15584,2012-10-16,Winter,2012,Oct,12,0,Tuesday,1,Misty,0.52,0.5,0.45,0.3284,69,256,325,76,325,325
15585,2012-10-16,Winter,2012,Oct,13,0,Tuesday,1,Clear,0.52,0.5,0.45,0.2836,68,260,328,76,328,328
15586,2012-10-16,Winter,2012,Oct,14,0,Tuesday,1,Clear,0.54,0.5152,0.39,0.2537,94,214,308,76,308,308
15587,2012-10-16,Winter,2012,Oct,15,0,Tuesday,1,Clear,0.54,0.5152,0.41,0.3284,76,270,346,76,346,346
15588,2012-10-16,Winter,2012,Oct,16,0,Tuesday,1,Clear,0.54,0.5152,0.39,0.2836,79,367,446,76,446,446
15589,2012-10-16,Winter,2012,Oct,17,0,Tuesday,1,Clear,0.52,0.5,0.39,0.194,104,839,943,76,943,943
15590,2012-10-16,Winter,2012,Oct,18,0,Tuesday,1,Clear,0.5,0.4848,0.42,0.1642,71,767,838,76,838,838
15591,2012-10-16,Winter,2012,Oct,19,0,Tuesday,1,Clear,0.48,0.4697,0.48,0.0,40,491,531,76,531,531
15592,2012-10-16,Winter,2012,Oct,20,0,Tuesday,1,Clear,0.46,0.4545,0.55,0.0,35,397,432,76,432,432
15593,2012-10-16,Winter,2012,Oct,21,0,Tuesday,1,Clear,0.46,0.4545,0.63,0.0,19,176,195,76,195,195
15594,2012-10-16,Winter,2012,Oct,22,0,Tuesday,1,Clear,0.4,0.4091,0.71,0.0896,18,163,181,76,181,181
15595,2012-10-16,Winter,2012,Oct,23,0,Tuesday,1,Clear,0.4,0.4091,0.71,0.0,23,176,199,76,199,199
15596,2012-10-17,Winter,2012,Oct,0,0,Wednesday,1,Clear,0.38,0.3939,0.76,0.0,1,48,49,75,49,49
15597,2012-10-17,Winter,2012,Oct,1,0,Wednesday,1,Clear,0.38,0.3939,0.76,0.0,3,14,17,75,17,17
15598,2012-10-17,Winter,2012,Oct,2,0,Wednesday,1,Clear,0.38,0.3939,0.76,0.0,4,12,16,75,16,16
15599,2012-10-17,Winter,2012,Oct,3,0,Wednesday,1,Clear,0.36,0.3788,0.87,0.0,0,7,7,75,7,7
15600,2012-10-17,Winter,2012,Oct,4,0,Wednesday,1,Clear,0.36,0.3636,0.81,0.0896,0,4,4,75,4,4
15601,2012-10-17,Winter,2012,Oct,5,0,Wednesday,1,Misty,0.36,0.3788,0.81,0.0,2,39,41,75,41,41
15602,2012-10-17,Winter,2012,Oct,6,0,Wednesday,1,Clear,0.38,0.3939,0.82,0.0,7,171,178,75,178,178
15603,2012-10-17,Winter,2012,Oct,7,0,Wednesday,1,Clear,0.36,0.3636,0.81,0.1045,15,449,464,75,464,464
15604,2012-10-17,Winter,2012,Oct,8,0,Wednesday,1,Misty,0.4,0.4091,0.76,0.0,38,779,817,75,817,817
15605,2012-10-17,Winter,2012,Oct,9,0,Wednesday,1,Misty,0.42,0.4242,0.77,0.0,38,344,382,75,382,382
15606,2012-10-17,Winter,2012,Oct,10,0,Wednesday,1,Misty,0.46,0.4545,0.67,0.0,60,168,228,75,228,228
15607,2012-10-17,Winter,2012,Oct,11,0,Wednesday,1,Misty,0.5,0.4848,0.51,0.0896,78,156,234,75,234,234
15608,2012-10-17,Winter,2012,Oct,12,0,Wednesday,1,Misty,0.52,0.5,0.48,0.1642,71,261,332,75,332,332
15609,2012-10-17,Winter,2012,Oct,13,0,Wednesday,1,Misty,0.54,0.5152,0.49,0.1343,73,237,310,75,310,310
15610,2012-10-17,Winter,2012,Oct,14,0,Wednesday,1,Misty,0.56,0.5303,0.43,0.1642,82,188,270,75,270,270
15611,2012-10-17,Winter,2012,Oct,15,0,Wednesday,1,Misty,0.58,0.5455,0.43,0.2239,62,239,301,75,301,301
15612,2012-10-17,Winter,2012,Oct,16,0,Wednesday,1,Clear,0.56,0.5303,0.52,0.194,70,396,466,75,466,466
15613,2012-10-17,Winter,2012,Oct,17,0,Wednesday,1,Clear,0.54,0.5152,0.56,0.1045,122,766,888,75,888,888
15614,2012-10-17,Winter,2012,Oct,18,0,Wednesday,1,Clear,0.52,0.5,0.59,0.1642,90,794,884,75,884,884
15615,2012-10-17,Winter,2012,Oct,19,0,Wednesday,1,Clear,0.5,0.4848,0.72,0.194,49,467,516,75,516,516
15616,2012-10-17,Winter,2012,Oct,20,0,Wednesday,1,Clear,0.5,0.4848,0.72,0.1343,54,360,414,75,414,414
15617,2012-10-17,Winter,2012,Oct,21,0,Wednesday,1,Clear,0.46,0.4545,0.82,0.194,28,301,329,75,329,329
15618,2012-10-17,Winter,2012,Oct,22,0,Wednesday,1,Clear,0.46,0.4545,0.88,0.2537,17,198,215,75,215,215
15619,2012-10-17,Winter,2012,Oct,23,0,Wednesday,1,Clear,0.46,0.4545,0.88,0.2239,15,84,99,75,99,99
15620,2012-10-18,Winter,2012,Oct,0,0,Thursday,1,Clear,0.46,0.4545,0.88,0.194,4,53,57,74,57,57
15621,2012-10-18,Winter,2012,Oct,1,0,Thursday,1,Clear,0.46,0.4545,0.82,0.2239,0,14,14,74,14,14
15622,2012-10-18,Winter,2012,Oct,2,0,Thursday,1,Clear,0.46,0.4545,0.82,0.194,1,13,14,74,14,14
15623,2012-10-18,Winter,2012,Oct,3,0,Thursday,1,Clear,0.44,0.4394,0.88,0.2239,0,5,5,74,5,5
15624,2012-10-18,Winter,2012,Oct,4,0,Thursday,1,Clear,0.44,0.4394,0.88,0.2239,0,5,5,74,5,5
15625,2012-10-18,Winter,2012,Oct,5,0,Thursday,1,Clear,0.44,0.4394,0.82,0.2239,1,41,42,74,42,42
15626,2012-10-18,Winter,2012,Oct,6,0,Thursday,1,Clear,0.44,0.4394,0.88,0.2985,3,150,153,74,153,153
15627,2012-10-18,Winter,2012,Oct,7,0,Thursday,1,Clear,0.44,0.4394,0.88,0.2537,20,488,508,74,508,508
15628,2012-10-18,Winter,2012,Oct,8,0,Thursday,1,Clear,0.46,0.4545,0.82,0.2537,31,803,834,74,834,834
15629,2012-10-18,Winter,2012,Oct,9,0,Thursday,1,Misty,0.5,0.4848,0.77,0.1642,41,346,387,74,387,387
15630,2012-10-18,Winter,2012,Oct,10,0,Thursday,1,Misty,0.52,0.5,0.68,0.2239,60,158,218,74,218,218
15631,2012-10-18,Winter,2012,Oct,11,0,Thursday,1,Misty,0.56,0.5303,0.56,0.2239,79,189,268,74,268,268
15632,2012-10-18,Winter,2012,Oct,12,0,Thursday,1,Misty,0.6,0.6212,0.53,0.2537,93,284,377,74,377,377
15633,2012-10-18,Winter,2012,Oct,13,0,Thursday,1,Clear,0.62,0.6212,0.53,0.3582,96,236,332,74,332,332
15634,2012-10-18,Winter,2012,Oct,14,0,Thursday,1,Misty,0.62,0.6212,0.5,0.2985,94,191,285,74,285,285
15635,2012-10-18,Winter,2012,Oct,15,0,Thursday,1,Misty,0.6,0.6061,0.6,0.194,69,284,353,74,353,353
15636,2012-10-18,Winter,2012,Oct,16,0,Thursday,1,Clear,0.6,0.6212,0.56,0.2836,94,356,450,74,450,450
15637,2012-10-18,Winter,2012,Oct,17,0,Thursday,1,Misty,0.58,0.5455,0.64,0.3284,102,788,890,74,890,890
15638,2012-10-18,Winter,2012,Oct,18,0,Thursday,1,Misty,0.56,0.5303,0.64,0.3284,68,720,788,74,788,788
15639,2012-10-18,Winter,2012,Oct,19,0,Thursday,1,Misty,0.56,0.5303,0.68,0.2985,42,471,513,74,513,513
15640,2012-10-18,Winter,2012,Oct,20,0,Thursday,1,Misty,0.56,0.5303,0.68,0.2537,39,348,387,74,387,387
15641,2012-10-18,Winter,2012,Oct,21,0,Thursday,1,Misty,0.54,0.5152,0.77,0.194,38,245,283,74,283,283
15642,2012-10-18,Winter,2012,Oct,22,0,Thursday,1,Misty,0.54,0.5152,0.83,0.194,27,202,229,74,229,229
15643,2012-10-18,Winter,2012,Oct,23,0,Thursday,1,Misty,0.54,0.5152,0.83,0.0,6,111,117,74,117,117
15644,2012-10-19,Winter,2012,Oct,0,0,Friday,1,Misty,0.56,0.5303,0.83,0.1045,5,51,56,73,56,56
15645,2012-10-19,Winter,2012,Oct,1,0,Friday,1,Light_rainsnow,0.54,0.5152,0.88,0.0,4,12,16,73,16,16
15646,2012-10-19,Winter,2012,Oct,2,0,Friday,1,Misty,0.54,0.5152,0.88,0.0,1,9,10,73,10,10
15647,2012-10-19,Winter,2012,Oct,3,0,Friday,1,Misty,0.56,0.5303,0.83,0.0,0,5,5,73,5,5
15648,2012-10-19,Winter,2012,Oct,4,0,Friday,1,Misty,0.56,0.5303,0.83,0.0,1,5,6,73,6,6
15649,2012-10-19,Winter,2012,Oct,5,0,Friday,1,Misty,0.54,0.5152,0.88,0.0,1,35,36,73,36,36
15650,2012-10-19,Winter,2012,Oct,6,0,Friday,1,Light_rainsnow,0.54,0.5152,0.94,0.1642,5,126,131,73,131,131
15651,2012-10-19,Winter,2012,Oct,7,0,Friday,1,Light_rainsnow,0.54,0.5152,0.94,0.0,5,149,154,73,154,154
15652,2012-10-19,Winter,2012,Oct,8,0,Friday,1,Misty,0.54,0.5152,0.94,0.1045,20,447,467,73,467,467
15653,2012-10-19,Winter,2012,Oct,9,0,Friday,1,Misty,0.54,0.5152,0.94,0.1045,26,363,389,73,389,389
15654,2012-10-19,Winter,2012,Oct,10,0,Friday,1,Misty,0.58,0.5455,0.88,0.194,26,198,224,73,224,224
15655,2012-10-19,Winter,2012,Oct,11,0,Friday,1,Clear,0.6,0.5606,0.83,0.194,41,211,252,73,252,252
15656,2012-10-19,Winter,2012,Oct,12,0,Friday,1,Clear,0.64,0.6061,0.69,0.2239,74,258,332,73,332,332
15657,2012-10-19,Winter,2012,Oct,13,0,Friday,1,Clear,0.62,0.5909,0.73,0.2239,87,288,375,73,375,375
15658,2012-10-19,Winter,2012,Oct,14,0,Friday,1,Clear,0.66,0.6212,0.61,0.2537,88,277,365,73,365,365
15659,2012-10-19,Winter,2012,Oct,15,0,Friday,1,Clear,0.64,0.6061,0.65,0.2985,93,302,395,73,395,395
15660,2012-10-19,Winter,2012,Oct,16,0,Friday,1,Light_rainsnow,0.62,0.6061,0.69,0.3582,131,434,565,73,565,565
15661,2012-10-19,Winter,2012,Oct,17,0,Friday,1,Light_rainsnow,0.62,0.6061,0.69,0.3582,48,377,425,73,425,425
15662,2012-10-19,Winter,2012,Oct,18,0,Friday,1,Clear,0.56,0.5303,0.83,0.1045,21,212,233,73,233,233
15663,2012-10-19,Winter,2012,Oct,19,0,Friday,1,Clear,0.54,0.5152,0.88,0.1642,19,213,232,73,232,232
15664,2012-10-19,Winter,2012,Oct,20,0,Friday,1,Clear,0.52,0.5,0.77,0.194,13,216,229,73,229,229
15665,2012-10-19,Winter,2012,Oct,21,0,Friday,1,Clear,0.5,0.4848,0.77,0.0,17,189,206,73,206,206
15666,2012-10-19,Winter,2012,Oct,22,0,Friday,1,Clear,0.5,0.4848,0.77,0.0896,14,176,190,73,190,190
15667,2012-10-19,Winter,2012,Oct,23,0,Friday,1,Clear,0.46,0.4545,0.88,0.1045,13,118,131,73,131,131
15668,2012-10-20,Winter,2012,Oct,0,0,Saturday,0,Clear,0.46,0.4545,0.82,0.1343,13,110,123,72,123,123
15669,2012-10-20,Winter,2012,Oct,1,0,Saturday,0,Clear,0.46,0.4545,0.72,0.1343,2,93,95,72,95,95
15670,2012-10-20,Winter,2012,Oct,2,0,Saturday,0,Clear,0.44,0.4394,0.77,0.1045,9,69,78,72,78,78
15671,2012-10-20,Winter,2012,Oct,3,0,Saturday,0,Clear,0.42,0.4242,0.77,0.1343,2,27,29,72,29,29
15672,2012-10-20,Winter,2012,Oct,4,0,Saturday,0,Clear,0.44,0.4394,0.72,0.0,9,9,18,72,18,18
15673,2012-10-20,Winter,2012,Oct,5,0,Saturday,0,Clear,0.4,0.4091,0.82,0.0,6,7,13,72,13,13
15674,2012-10-20,Winter,2012,Oct,6,0,Saturday,0,Clear,0.42,0.4242,0.71,0.0,5,26,31,72,31,31
15675,2012-10-20,Winter,2012,Oct,7,0,Saturday,0,Clear,0.4,0.4091,0.82,0.0,6,59,65,72,65,65
15676,2012-10-20,Winter,2012,Oct,8,0,Saturday,0,Clear,0.46,0.4545,0.67,0.1343,29,164,193,72,193,193
15677,2012-10-20,Winter,2012,Oct,9,0,Saturday,0,Clear,0.5,0.4848,0.59,0.1343,106,257,363,72,363,363
15678,2012-10-20,Winter,2012,Oct,10,0,Saturday,0,Clear,0.52,0.5,0.52,0.1343,111,312,423,72,423,423
15679,2012-10-20,Winter,2012,Oct,11,0,Saturday,0,Clear,0.54,0.5152,0.52,0.2239,204,408,612,72,612,612
15680,2012-10-20,Winter,2012,Oct,12,0,Saturday,0,Clear,0.56,0.5303,0.46,0.1045,267,436,703,72,703,703
15681,2012-10-20,Winter,2012,Oct,13,0,Saturday,0,Clear,0.56,0.5303,0.43,0.1642,273,441,714,72,714,714
15682,2012-10-20,Winter,2012,Oct,14,0,Saturday,0,Clear,0.56,0.5303,0.4,0.0,335,376,711,72,711,711
15683,2012-10-20,Winter,2012,Oct,15,0,Saturday,0,Clear,0.56,0.5303,0.43,0.0,308,403,711,72,711,711
15684,2012-10-20,Winter,2012,Oct,16,0,Saturday,0,Clear,0.54,0.5152,0.42,0.2836,325,366,691,72,691,691
15685,2012-10-20,Winter,2012,Oct,17,0,Saturday,0,Clear,0.54,0.5152,0.37,0.2239,347,384,731,72,731,731
15686,2012-10-20,Winter,2012,Oct,18,0,Saturday,0,Clear,0.52,0.5,0.39,0.2239,165,356,521,72,521,521
15687,2012-10-20,Winter,2012,Oct,19,0,Saturday,0,Clear,0.5,0.4848,0.45,0.1343,77,268,345,72,345,345
15688,2012-10-20,Winter,2012,Oct,20,0,Saturday,0,Clear,0.5,0.4848,0.39,0.2239,61,198,259,72,259,259
15689,2012-10-20,Winter,2012,Oct,21,0,Saturday,0,Clear,0.46,0.4545,0.47,0.2239,72,224,296,72,296,296
15690,2012-10-20,Winter,2012,Oct,22,0,Saturday,0,Clear,0.44,0.4394,0.51,0.1045,47,155,202,72,202,202
15691,2012-10-20,Winter,2012,Oct,23,0,Saturday,0,Clear,0.42,0.4242,0.58,0.0,27,136,163,72,163,163
15692,2012-10-21,Winter,2012,Oct,0,0,Sunday,0,Clear,0.44,0.4394,0.54,0.1642,35,119,154,71,154,154
15693,2012-10-21,Winter,2012,Oct,1,0,Sunday,0,Clear,0.42,0.4242,0.58,0.2239,20,97,117,71,117,117
15694,2012-10-21,Winter,2012,Oct,2,0,Sunday,0,Clear,0.4,0.4091,0.62,0.1642,44,88,132,71,132,132
15695,2012-10-21,Winter,2012,Oct,3,0,Sunday,0,Clear,0.38,0.3939,0.66,0.0896,12,29,41,71,41,41
15696,2012-10-21,Winter,2012,Oct,4,0,Sunday,0,Clear,0.36,0.3485,0.71,0.1642,8,13,21,71,21,21
15697,2012-10-21,Winter,2012,Oct,5,0,Sunday,0,Clear,0.38,0.3939,0.66,0.0896,6,4,10,71,10,10
15698,2012-10-21,Winter,2012,Oct,6,0,Sunday,0,Clear,0.4,0.4091,0.62,0.0,8,18,26,71,26,26
15699,2012-10-21,Winter,2012,Oct,7,0,Sunday,0,Clear,0.4,0.4091,0.62,0.0,13,43,56,71,56,56
15700,2012-10-21,Winter,2012,Oct,8,0,Sunday,0,Clear,0.42,0.4242,0.67,0.0,39,104,143,71,143,143
15701,2012-10-21,Winter,2012,Oct,9,0,Sunday,0,Clear,0.46,0.4545,0.55,0.1642,77,192,269,71,269,269
15702,2012-10-21,Winter,2012,Oct,10,0,Sunday,0,Clear,0.5,0.4848,0.48,0.2985,167,276,443,71,443,443
15703,2012-10-21,Winter,2012,Oct,11,0,Sunday,0,Clear,0.52,0.5,0.44,0.3284,191,356,547,71,547,547
15704,2012-10-21,Winter,2012,Oct,12,0,Sunday,0,Clear,0.54,0.5152,0.39,0.3284,236,439,675,71,675,675
15705,2012-10-21,Winter,2012,Oct,13,0,Sunday,0,Clear,0.56,0.5303,0.37,0.2537,243,383,626,71,626,626
15706,2012-10-21,Winter,2012,Oct,14,0,Sunday,0,Clear,0.56,0.5303,0.35,0.194,235,405,640,71,640,640
15707,2012-10-21,Winter,2012,Oct,15,0,Sunday,0,Clear,0.56,0.5303,0.35,0.3284,240,383,623,71,623,623
15708,2012-10-21,Winter,2012,Oct,16,0,Sunday,0,Clear,0.54,0.5152,0.37,0.2239,182,409,591,71,591,591
15709,2012-10-21,Winter,2012,Oct,17,0,Sunday,0,Clear,0.52,0.5,0.39,0.2537,153,338,491,71,491,491
15710,2012-10-21,Winter,2012,Oct,18,0,Sunday,0,Clear,0.52,0.5,0.39,0.194,71,342,413,71,413,413
15711,2012-10-21,Winter,2012,Oct,19,0,Sunday,0,Clear,0.5,0.4848,0.42,0.1642,50,216,266,71,266,266
15712,2012-10-21,Winter,2012,Oct,20,0,Sunday,0,Clear,0.48,0.4697,0.44,0.194,35,160,195,71,195,195
15713,2012-10-21,Winter,2012,Oct,21,0,Sunday,0,Clear,0.42,0.4242,0.54,0.1642,42,124,166,71,166,166
15714,2012-10-21,Winter,2012,Oct,22,0,Sunday,0,Clear,0.42,0.4242,0.54,0.0,18,95,113,71,113,113
15715,2012-10-21,Winter,2012,Oct,23,0,Sunday,0,Clear,0.44,0.4394,0.54,0.0,7,59,66,71,66,66
15716,2012-10-22,Winter,2012,Oct,0,0,Monday,1,Clear,0.4,0.4091,0.62,0.0,3,28,31,70,31,31
15717,2012-10-22,Winter,2012,Oct,1,0,Monday,1,Clear,0.4,0.4091,0.71,0.0,0,11,11,70,11,11
15718,2012-10-22,Winter,2012,Oct,2,0,Monday,1,Clear,0.38,0.3939,0.71,0.0,1,4,5,70,5,5
15719,2012-10-22,Winter,2012,Oct,3,0,Monday,1,Clear,0.4,0.4091,0.62,0.0,1,5,6,70,6,6
15720,2012-10-22,Winter,2012,Oct,4,0,Monday,1,Clear,0.38,0.3939,0.66,0.0,1,6,7,70,7,7
15721,2012-10-22,Winter,2012,Oct,5,0,Monday,1,Clear,0.38,0.3939,0.76,0.0896,2,44,46,70,46,46
15722,2012-10-22,Winter,2012,Oct,6,0,Monday,1,Clear,0.36,0.3636,0.76,0.0896,4,140,144,70,144,144
15723,2012-10-22,Winter,2012,Oct,7,0,Monday,1,Clear,0.38,0.3939,0.66,0.0896,15,437,452,70,452,452
15724,2012-10-22,Winter,2012,Oct,8,0,Monday,1,Clear,0.44,0.4394,0.67,0.0,32,696,728,70,728,728
15725,2012-10-22,Winter,2012,Oct,9,0,Monday,1,Clear,0.46,0.4545,0.63,0.0896,25,335,360,70,360,360
15726,2012-10-22,Winter,2012,Oct,10,0,Monday,1,Clear,0.5,0.4848,0.55,0.0,51,161,212,70,212,212
15727,2012-10-22,Winter,2012,Oct,11,0,Monday,1,Clear,0.56,0.5303,0.37,0.1642,63,148,211,70,211,211
15728,2012-10-22,Winter,2012,Oct,12,0,Monday,1,Clear,0.58,0.5455,0.35,0.0,52,231,283,70,283,283
15729,2012-10-22,Winter,2012,Oct,13,0,Monday,1,Clear,0.62,0.6212,0.29,0.1642,88,227,315,70,315,315
15730,2012-10-22,Winter,2012,Oct,14,0,Monday,1,Clear,0.62,0.6061,0.27,0.194,73,209,282,70,282,282
15731,2012-10-22,Winter,2012,Oct,15,0,Monday,1,Clear,0.64,0.6212,0.29,0.1642,74,222,296,70,296,296
15732,2012-10-22,Winter,2012,Oct,16,0,Monday,1,Clear,0.62,0.6212,0.33,0.1642,80,444,524,70,524,524
15733,2012-10-22,Winter,2012,Oct,17,0,Monday,1,Clear,0.62,0.6212,0.33,0.1045,84,838,922,70,922,922
15734,2012-10-22,Winter,2012,Oct,18,0,Monday,1,Clear,0.54,0.5152,0.64,0.1045,60,726,786,70,786,786
15735,2012-10-22,Winter,2012,Oct,19,0,Monday,1,Clear,0.52,0.5,0.52,0.1045,36,478,514,70,514,514
15736,2012-10-22,Winter,2012,Oct,20,0,Monday,1,Clear,0.5,0.4848,0.59,0.1045,21,382,403,70,403,403
15737,2012-10-22,Winter,2012,Oct,21,0,Monday,1,Clear,0.48,0.4697,0.67,0.0896,19,155,174,70,174,174
15738,2012-10-22,Winter,2012,Oct,22,0,Monday,1,Clear,0.46,0.4545,0.82,0.1343,25,158,183,70,183,183
15739,2012-10-22,Winter,2012,Oct,23,0,Monday,1,Clear,0.46,0.4545,0.82,0.1045,20,143,163,70,163,163
15740,2012-10-23,Winter,2012,Oct,0,0,Tuesday,1,Clear,0.46,0.4545,0.88,0.1642,5,32,37,69,37,37
15741,2012-10-23,Winter,2012,Oct,1,0,Tuesday,1,Clear,0.46,0.4545,0.77,0.1642,1,16,17,69,17,17
15742,2012-10-23,Winter,2012,Oct,2,0,Tuesday,1,Clear,0.44,0.4394,0.88,0.1343,1,6,7,69,7,7
15743,2012-10-23,Winter,2012,Oct,3,0,Tuesday,1,Clear,0.44,0.4394,0.77,0.1343,0,1,1,69,1,1
15744,2012-10-23,Winter,2012,Oct,4,0,Tuesday,1,Clear,0.42,0.4242,0.77,0.1045,1,6,7,69,7,7
15745,2012-10-23,Winter,2012,Oct,5,0,Tuesday,1,Clear,0.44,0.4394,0.77,0.0896,1,49,50,69,50,50
15746,2012-10-23,Winter,2012,Oct,6,0,Tuesday,1,Clear,0.4,0.4091,0.82,0.0896,6,152,158,69,158,158
15747,2012-10-23,Winter,2012,Oct,7,0,Tuesday,1,Misty,0.44,0.4394,0.77,0.1045,12,519,531,69,531,531
15748,2012-10-23,Winter,2012,Oct,8,0,Tuesday,1,Misty,0.46,0.4545,0.72,0.0896,28,733,761,69,761,761
15749,2012-10-23,Winter,2012,Oct,9,0,Tuesday,1,Misty,0.5,0.4848,0.72,0.1045,29,305,334,69,334,334
15750,2012-10-23,Winter,2012,Oct,10,0,Tuesday,1,Clear,0.54,0.5152,0.6,0.0,50,171,221,69,221,221
15751,2012-10-23,Winter,2012,Oct,11,0,Tuesday,1,Clear,0.6,0.6212,0.53,0.0,52,201,253,69,253,253
15752,2012-10-23,Winter,2012,Oct,12,0,Tuesday,1,Misty,0.62,0.6212,0.46,0.0896,80,298,378,69,378,378
15753,2012-10-23,Winter,2012,Oct,13,0,Tuesday,1,Misty,0.64,0.6212,0.44,0.0,59,244,303,69,303,303
15754,2012-10-23,Winter,2012,Oct,14,0,Tuesday,1,Clear,0.68,0.6364,0.41,0.1642,67,229,296,69,296,296
15755,2012-10-23,Winter,2012,Oct,15,0,Tuesday,1,Clear,0.68,0.6364,0.41,0.2239,76,270,346,69,346,346
15756,2012-10-23,Winter,2012,Oct,16,0,Tuesday,1,Clear,0.68,0.6364,0.44,0.0896,108,433,541,69,541,541
15757,2012-10-23,Winter,2012,Oct,17,0,Tuesday,1,Clear,0.68,0.6364,0.41,0.0,67,871,938,69,938,938
15758,2012-10-23,Winter,2012,Oct,18,0,Tuesday,1,Clear,0.62,0.6212,0.53,0.0896,64,762,826,69,826,826
15759,2012-10-23,Winter,2012,Oct,19,0,Tuesday,1,Clear,0.62,0.6212,0.57,0.0896,25,457,482,69,482,482
15760,2012-10-23,Winter,2012,Oct,20,0,Tuesday,1,Clear,0.58,0.5455,0.64,0.1343,45,334,379,69,379,379
15761,2012-10-23,Winter,2012,Oct,21,0,Tuesday,1,Clear,0.56,0.5303,0.68,0.0,35,260,295,69,295,295
15762,2012-10-23,Winter,2012,Oct,22,0,Tuesday,1,Clear,0.56,0.5303,0.68,0.1045,20,174,194,69,194,194
15763,2012-10-23,Winter,2012,Oct,23,0,Tuesday,1,Clear,0.54,0.5152,0.73,0.1045,9,102,111,69,111,111
15764,2012-10-24,Winter,2012,Oct,0,0,Wednesday,1,Clear,0.54,0.5152,0.73,0.0896,7,39,46,68,46,46
15765,2012-10-24,Winter,2012,Oct,1,0,Wednesday,1,Clear,0.54,0.5152,0.68,0.0,4,23,27,68,27,27
15766,2012-10-24,Winter,2012,Oct,2,0,Wednesday,1,Clear,0.54,0.5152,0.68,0.0,0,6,6,68,6,6
15767,2012-10-24,Winter,2012,Oct,3,0,Wednesday,1,Clear,0.5,0.4848,0.77,0.0896,0,4,4,68,4,4
15768,2012-10-24,Winter,2012,Oct,4,0,Wednesday,1,Clear,0.5,0.4848,0.77,0.0896,1,5,6,68,6,6
15769,2012-10-24,Winter,2012,Oct,5,0,Wednesday,1,Clear,0.5,0.4848,0.82,0.0,1,52,53,68,53,53
15770,2012-10-24,Winter,2012,Oct,6,0,Wednesday,1,Clear,0.48,0.4697,0.82,0.1045,11,162,173,68,173,173
15771,2012-10-24,Winter,2012,Oct,7,0,Wednesday,1,Clear,0.5,0.4848,0.88,0.0896,20,506,526,68,526,526
15772,2012-10-24,Winter,2012,Oct,8,0,Wednesday,1,Misty,0.52,0.5,0.83,0.1045,24,777,801,68,801,801
15773,2012-10-24,Winter,2012,Oct,9,0,Wednesday,1,Misty,0.52,0.5,0.77,0.0896,24,349,373,68,373,373
15774,2012-10-24,Winter,2012,Oct,10,0,Wednesday,1,Misty,0.54,0.5152,0.73,0.0,29,142,171,68,171,171
15775,2012-10-24,Winter,2012,Oct,11,0,Wednesday,1,Clear,0.58,0.5455,0.64,0.0,47,189,236,68,236,236
15776,2012-10-24,Winter,2012,Oct,12,0,Wednesday,1,Clear,0.62,0.6061,0.61,0.0896,48,268,316,68,316,316
15777,2012-10-24,Winter,2012,Oct,13,0,Wednesday,1,Clear,0.66,0.6212,0.54,0.0,65,241,306,68,306,306
15778,2012-10-24,Winter,2012,Oct,14,0,Wednesday,1,Clear,0.74,0.6515,0.3,0.2537,64,237,301,68,301,301
15779,2012-10-24,Winter,2012,Oct,15,0,Wednesday,1,Clear,0.7,0.6364,0.39,0.1045,63,245,308,68,308,308
15780,2012-10-24,Winter,2012,Oct,16,0,Wednesday,1,Clear,0.74,0.6515,0.33,0.1343,67,465,532,68,532,532
15781,2012-10-24,Winter,2012,Oct,17,0,Wednesday,1,Clear,0.66,0.6212,0.47,0.0,87,876,963,68,963,963
15782,2012-10-24,Winter,2012,Oct,18,0,Wednesday,1,Clear,0.66,0.6212,0.44,0.0,63,795,858,68,858,858
15783,2012-10-24,Winter,2012,Oct,19,0,Wednesday,1,Misty,0.64,0.6212,0.53,0.0896,50,522,572,68,572,572
15784,2012-10-24,Winter,2012,Oct,20,0,Wednesday,1,Misty,0.62,0.6061,0.61,0.0896,45,396,441,68,441,441
15785,2012-10-24,Winter,2012,Oct,21,0,Wednesday,1,Misty,0.62,0.6061,0.61,0.1045,33,280,313,68,313,313
15786,2012-10-24,Winter,2012,Oct,22,0,Wednesday,1,Misty,0.6,0.6061,0.64,0.1343,30,208,238,68,238,238
15787,2012-10-24,Winter,2012,Oct,23,0,Wednesday,1,Misty,0.58,0.5455,0.68,0.0896,12,111,123,68,123,123
15788,2012-10-25,Winter,2012,Oct,0,0,Thursday,1,Misty,0.6,0.6061,0.64,0.1045,19,57,76,67,76,76
15789,2012-10-25,Winter,2012,Oct,1,0,Thursday,1,Clear,0.58,0.5455,0.68,0.0,6,22,28,67,28,28
15790,2012-10-25,Winter,2012,Oct,2,0,Thursday,1,Clear,0.54,0.5152,0.77,0.0,3,15,18,67,18,18
15791,2012-10-25,Winter,2012,Oct,3,0,Thursday,1,Misty,0.52,0.5,0.88,0.1343,0,8,8,67,8,8
15792,2012-10-25,Winter,2012,Oct,4,0,Thursday,1,Misty,0.52,0.5,0.88,0.1045,1,4,5,67,5,5
15793,2012-10-25,Winter,2012,Oct,5,0,Thursday,1,Misty,0.52,0.5,0.88,0.1642,2,53,55,67,55,55
15794,2012-10-25,Winter,2012,Oct,6,0,Thursday,1,Misty,0.52,0.5,0.88,0.194,3,168,171,67,171,171
15795,2012-10-25,Winter,2012,Oct,7,0,Thursday,1,Misty,0.52,0.5,0.88,0.194,18,477,495,67,495,495
15796,2012-10-25,Winter,2012,Oct,8,0,Thursday,1,Misty,0.52,0.5,0.83,0.1642,33,746,779,67,779,779
15797,2012-10-25,Winter,2012,Oct,9,0,Thursday,1,Misty,0.52,0.5,0.83,0.194,23,320,343,67,343,343
15798,2012-10-25,Winter,2012,Oct,10,0,Thursday,1,Misty,0.54,0.5152,0.83,0.1343,53,172,225,67,225,225
15799,2012-10-25,Winter,2012,Oct,11,0,Thursday,1,Misty,0.54,0.5152,0.83,0.1045,57,181,238,67,238,238
15800,2012-10-25,Winter,2012,Oct,12,0,Thursday,1,Misty,0.56,0.5303,0.78,0.1045,61,258,319,67,319,319
15801,2012-10-25,Winter,2012,Oct,13,0,Thursday,1,Misty,0.56,0.5303,0.78,0.0,49,264,313,67,313,313
15802,2012-10-25,Winter,2012,Oct,14,0,Thursday,1,Clear,0.6,0.5909,0.73,0.1343,71,214,285,67,285,285
15803,2012-10-25,Winter,2012,Oct,15,0,Thursday,1,Clear,0.62,0.6061,0.65,0.1343,63,242,305,67,305,305
15804,2012-10-25,Winter,2012,Oct,16,0,Thursday,1,Clear,0.6,0.5909,0.69,0.1642,92,407,499,67,499,499
15805,2012-10-25,Winter,2012,Oct,17,0,Thursday,1,Clear,0.6,0.5909,0.69,0.1642,112,774,886,67,886,886
15806,2012-10-25,Winter,2012,Oct,18,0,Thursday,1,Clear,0.56,0.5303,0.83,0.1045,77,732,809,67,809,809
15807,2012-10-25,Winter,2012,Oct,19,0,Thursday,1,Clear,0.54,0.5152,0.83,0.194,45,497,542,67,542,542
15808,2012-10-25,Winter,2012,Oct,20,0,Thursday,1,Misty,0.52,0.5,0.88,0.1343,28,319,347,67,347,347
15809,2012-10-25,Winter,2012,Oct,21,0,Thursday,1,Misty,0.52,0.5,0.88,0.1343,24,247,271,67,271,271
15810,2012-10-25,Winter,2012,Oct,22,0,Thursday,1,Misty,0.54,0.5152,0.83,0.0896,22,185,207,67,207,207
15811,2012-10-25,Winter,2012,Oct,23,0,Thursday,1,Misty,0.54,0.5152,0.83,0.1343,13,122,135,67,135,135
15812,2012-10-26,Winter,2012,Oct,0,0,Friday,1,Misty,0.54,0.5152,0.77,0.0,6,65,71,66,71,71
15813,2012-10-26,Winter,2012,Oct,1,0,Friday,1,Misty,0.52,0.5,0.88,0.0896,4,32,36,66,36,36
15814,2012-10-26,Winter,2012,Oct,2,0,Friday,1,Misty,0.52,0.5,0.88,0.1045,4,15,19,66,19,19
15815,2012-10-26,Winter,2012,Oct,3,0,Friday,1,Misty,0.52,0.5,0.88,0.1642,5,8,13,66,13,13
15816,2012-10-26,Winter,2012,Oct,4,0,Friday,1,Misty,0.52,0.5,0.88,0.1642,1,4,5,66,5,5
15817,2012-10-26,Winter,2012,Oct,5,0,Friday,1,Misty,0.52,0.5,0.88,0.1045,3,47,50,66,50,50
15818,2012-10-26,Winter,2012,Oct,6,0,Friday,1,Misty,0.52,0.5,0.88,0.0896,2,142,144,66,144,144
15819,2012-10-26,Winter,2012,Oct,7,0,Friday,1,Misty,0.52,0.5,0.88,0.1045,13,408,421,66,421,421
15820,2012-10-26,Winter,2012,Oct,8,0,Friday,1,Misty,0.54,0.5152,0.88,0.1343,20,714,734,66,734,734
15821,2012-10-26,Winter,2012,Oct,9,0,Friday,1,Misty,0.54,0.5152,0.88,0.1343,56,347,403,66,403,403
15822,2012-10-26,Winter,2012,Oct,10,0,Friday,1,Misty,0.54,0.5152,0.88,0.1045,41,156,197,66,197,197
15823,2012-10-26,Winter,2012,Oct,11,0,Friday,1,Misty,0.56,0.5303,0.78,0.1642,68,222,290,66,290,290
15824,2012-10-26,Winter,2012,Oct,12,0,Friday,1,Misty,0.58,0.5455,0.73,0.194,90,302,392,66,392,392
15825,2012-10-26,Winter,2012,Oct,13,0,Friday,1,Misty,0.58,0.5455,0.68,0.1343,77,260,337,66,337,337
15826,2012-10-26,Winter,2012,Oct,14,0,Friday,1,Misty,0.6,0.6061,0.64,0.1343,99,252,351,66,351,351
15827,2012-10-26,Winter,2012,Oct,15,0,Friday,1,Misty,0.62,0.6061,0.61,0.1045,142,306,448,66,448,448
15828,2012-10-26,Winter,2012,Oct,16,0,Friday,1,Misty,0.58,0.5455,0.73,0.1642,137,445,582,66,582,582
15829,2012-10-26,Winter,2012,Oct,17,0,Friday,1,Misty,0.56,0.5303,0.76,0.194,125,692,817,66,817,817
15830,2012-10-26,Winter,2012,Oct,18,0,Friday,1,Misty,0.56,0.5303,0.78,0.1343,81,584,665,66,665,665
15831,2012-10-26,Winter,2012,Oct,19,0,Friday,1,Misty,0.54,0.5152,0.83,0.1642,72,399,471,66,471,471
15832,2012-10-26,Winter,2012,Oct,20,0,Friday,1,Misty,0.54,0.5152,0.83,0.1642,40,271,311,66,311,311
15833,2012-10-26,Winter,2012,Oct,21,0,Friday,1,Misty,0.54,0.5152,0.77,0.1343,40,252,292,66,292,292
15834,2012-10-26,Winter,2012,Oct,22,0,Friday,1,Misty,0.52,0.5,0.83,0.1343,37,180,217,66,217,217
15835,2012-10-26,Winter,2012,Oct,23,0,Friday,1,Clear,0.52,0.5,0.83,0.1642,19,159,178,66,178,178
15836,2012-10-27,Winter,2012,Oct,0,0,Saturday,0,Clear,0.5,0.4848,0.88,0.1343,10,132,142,65,142,142
15837,2012-10-27,Winter,2012,Oct,1,0,Saturday,0,Misty,0.5,0.4848,0.88,0.1343,23,123,146,65,146,146
15838,2012-10-27,Winter,2012,Oct,2,0,Saturday,0,Misty,0.5,0.4848,0.88,0.194,19,71,90,65,90,90
15839,2012-10-27,Winter,2012,Oct,3,0,Saturday,0,Clear,0.5,0.4848,0.88,0.1642,5,21,26,65,26,26
15840,2012-10-27,Winter,2012,Oct,4,0,Saturday,0,Misty,0.5,0.4848,0.88,0.1642,1,12,13,65,13,13
15841,2012-10-27,Winter,2012,Oct,5,0,Saturday,0,Misty,0.5,0.4848,0.82,0.194,2,7,9,65,9,9
15842,2012-10-27,Winter,2012,Oct,6,0,Saturday,0,Misty,0.5,0.4848,0.82,0.194,2,29,31,65,31,31
15843,2012-10-27,Winter,2012,Oct,7,0,Saturday,0,Clear,0.48,0.4697,0.83,0.194,7,79,86,65,86,86
15844,2012-10-27,Winter,2012,Oct,8,0,Saturday,0,Clear,0.5,0.4848,0.77,0.2537,26,187,213,65,213,213
15845,2012-10-27,Winter,2012,Oct,9,0,Saturday,0,Clear,0.5,0.4848,0.77,0.2537,88,240,328,65,328,328
15846,2012-10-27,Winter,2012,Oct,10,0,Saturday,0,Clear,0.54,0.5152,0.73,0.2836,165,314,479,65,479,479
15847,2012-10-27,Winter,2012,Oct,11,0,Saturday,0,Clear,0.56,0.5303,0.64,0.2836,197,388,585,65,585,585
15848,2012-10-27,Winter,2012,Oct,12,0,Saturday,0,Clear,0.6,0.6212,0.53,0.2537,264,404,668,65,668,668
15849,2012-10-27,Winter,2012,Oct,13,0,Saturday,0,Clear,0.6,0.6212,0.43,0.2537,310,450,760,65,760,760
15850,2012-10-27,Winter,2012,Oct,14,0,Saturday,0,Clear,0.6,0.6212,0.46,0.2537,325,425,750,65,750,750
15851,2012-10-27,Winter,2012,Oct,15,0,Saturday,0,Misty,0.56,0.5303,0.6,0.2836,310,401,711,65,711,711
15852,2012-10-27,Winter,2012,Oct,16,0,Saturday,0,Misty,0.56,0.5303,0.64,0.2836,257,355,612,65,612,612
15853,2012-10-27,Winter,2012,Oct,17,0,Saturday,0,Misty,0.56,0.5303,0.64,0.2836,248,370,618,65,618,618
15854,2012-10-27,Winter,2012,Oct,18,0,Saturday,0,Misty,0.56,0.5303,0.64,0.2836,138,318,456,65,456,456
15855,2012-10-27,Winter,2012,Oct,19,0,Saturday,0,Misty,0.52,0.5,0.72,0.2239,67,233,300,65,300,300
15856,2012-10-27,Winter,2012,Oct,20,0,Saturday,0,Misty,0.52,0.5,0.72,0.2239,58,238,296,65,296,296
15857,2012-10-27,Winter,2012,Oct,21,0,Saturday,0,Misty,0.52,0.5,0.72,0.2239,49,160,209,65,209,209
15858,2012-10-27,Winter,2012,Oct,22,0,Saturday,0,Misty,0.52,0.5,0.72,0.2537,41,116,157,65,157,157
15859,2012-10-27,Winter,2012,Oct,23,0,Saturday,0,Misty,0.52,0.5,0.68,0.3881,31,136,167,65,167,167
15860,2012-10-28,Winter,2012,Oct,0,0,Sunday,0,Light_rainsnow,0.52,0.5,0.68,0.2985,20,97,117,64,117,117
15861,2012-10-28,Winter,2012,Oct,1,0,Sunday,0,Misty,0.5,0.4848,0.72,0.2836,22,111,133,64,133,133
15862,2012-10-28,Winter,2012,Oct,2,0,Sunday,0,Misty,0.5,0.4848,0.68,0.2985,17,99,116,64,116,116
15863,2012-10-28,Winter,2012,Oct,3,0,Sunday,0,Misty,0.5,0.4848,0.63,0.3284,18,61,79,64,79,79
15864,2012-10-28,Winter,2012,Oct,4,0,Sunday,0,Misty,0.5,0.4848,0.63,0.3582,1,19,20,64,20,20
15865,2012-10-28,Winter,2012,Oct,5,0,Sunday,0,Misty,0.5,0.4848,0.63,0.2985,6,22,28,64,28,28
15866,2012-10-28,Winter,2012,Oct,6,0,Sunday,0,Misty,0.5,0.4848,0.59,0.3284,7,32,39,64,39,39
15867,2012-10-28,Winter,2012,Oct,7,0,Sunday,0,Misty,0.5,0.4848,0.59,0.2985,17,48,65,64,65,65
15868,2012-10-28,Winter,2012,Oct,8,0,Sunday,0,Misty,0.5,0.4848,0.59,0.5522,55,118,173,64,173,173
15869,2012-10-28,Winter,2012,Oct,9,0,Sunday,0,Misty,0.5,0.4848,0.55,0.4179,124,206,330,64,330,330
15870,2012-10-28,Winter,2012,Oct,10,0,Sunday,0,Misty,0.48,0.4697,0.51,0.4179,120,314,434,64,434,434
15871,2012-10-28,Winter,2012,Oct,11,0,Sunday,0,Misty,0.5,0.4848,0.51,0.3881,110,352,462,64,462,462
15872,2012-10-28,Winter,2012,Oct,12,0,Sunday,0,Misty,0.48,0.4697,0.59,0.4925,118,373,491,64,491,491
15873,2012-10-28,Winter,2012,Oct,13,0,Sunday,0,Misty,0.48,0.4697,0.59,0.4179,75,316,391,64,391,391
15874,2012-10-28,Winter,2012,Oct,14,0,Sunday,0,Misty,0.5,0.4848,0.59,0.4478,98,304,402,64,402,402
15875,2012-10-28,Winter,2012,Oct,15,0,Sunday,0,Misty,0.5,0.4848,0.63,0.4925,76,225,301,64,301,301
15876,2012-10-28,Winter,2012,Oct,16,0,Sunday,0,Light_rainsnow,0.48,0.4697,0.67,0.4627,42,251,293,64,293,293
15877,2012-10-28,Winter,2012,Oct,17,0,Sunday,0,Light_rainsnow,0.46,0.4545,0.77,0.5224,37,188,225,64,225,225
15878,2012-10-28,Winter,2012,Oct,18,0,Sunday,0,Light_rainsnow,0.42,0.4242,0.94,0.4925,18,136,154,64,154,154
15879,2012-10-28,Winter,2012,Oct,19,0,Sunday,0,Light_rainsnow,0.42,0.4242,0.94,0.3582,7,47,54,64,54,54
15880,2012-10-28,Winter,2012,Oct,20,0,Sunday,0,Light_rainsnow,0.42,0.4242,0.94,0.4627,4,51,55,64,55,55
15881,2012-10-28,Winter,2012,Oct,21,0,Sunday,0,Light_rainsnow,0.44,0.4394,0.88,0.4179,2,44,46,64,46,46
15882,2012-10-28,Winter,2012,Oct,22,0,Sunday,0,Light_rainsnow,0.44,0.4394,0.88,0.3582,2,35,37,64,37,37
15883,2012-10-28,Winter,2012,Oct,23,0,Sunday,0,Light_rainsnow,0.42,0.4242,0.94,0.3582,2,12,14,64,14,14
15884,2012-10-29,Winter,2012,Oct,0,0,Monday,1,Light_rainsnow,0.44,0.4394,0.88,0.3582,2,20,22,63,22,22
15885,2012-10-30,Winter,2012,Oct,13,0,Tuesday,1,Light_rainsnow,0.3,0.2727,0.81,0.3582,11,105,116,62,116,116
15886,2012-10-30,Winter,2012,Oct,14,0,Tuesday,1,Light_rainsnow,0.3,0.2727,0.81,0.3582,8,118,126,62,126,126
15887,2012-10-30,Winter,2012,Oct,15,0,Tuesday,1,Light_rainsnow,0.3,0.2879,0.87,0.2537,10,114,124,62,124,124
15888,2012-10-30,Winter,2012,Oct,16,0,Tuesday,1,Light_rainsnow,0.3,0.2879,0.87,0.2537,15,83,98,62,98,98
15889,2012-10-30,Winter,2012,Oct,17,0,Tuesday,1,Light_rainsnow,0.3,0.2879,0.87,0.2239,19,105,124,62,124,124
15890,2012-10-30,Winter,2012,Oct,18,0,Tuesday,1,Light_rainsnow,0.3,0.303,0.87,0.1343,4,139,143,62,143,143
15891,2012-10-30,Winter,2012,Oct,19,0,Tuesday,1,Misty,0.5,0.4848,0.68,0.194,6,109,115,62,115,115
15892,2012-10-30,Winter,2012,Oct,20,0,Tuesday,1,Misty,0.3,0.2879,0.81,0.194,5,76,81,62,81,81
15893,2012-10-30,Winter,2012,Oct,21,0,Tuesday,1,Misty,0.3,0.3182,0.87,0.1045,4,60,64,62,64,64
15894,2012-10-30,Winter,2012,Oct,22,0,Tuesday,1,Clear,0.3,0.303,0.81,0.1343,2,64,66,62,66,66
15895,2012-10-30,Winter,2012,Oct,23,0,Tuesday,1,Clear,0.3,0.303,0.81,0.1343,3,36,39,62,39,39
15896,2012-10-31,Winter,2012,Oct,0,0,Wednesday,1,Misty,0.3,0.3182,0.81,0.1045,0,16,16,61,16,16
15897,2012-10-31,Winter,2012,Oct,1,0,Wednesday,1,Misty,0.3,0.3182,0.81,0.0896,0,8,8,61,8,8
15898,2012-10-31,Winter,2012,Oct,2,0,Wednesday,1,Misty,0.3,0.303,0.81,0.1343,0,7,7,61,7,7
15899,2012-10-31,Winter,2012,Oct,3,0,Wednesday,1,Misty,0.3,0.3182,0.81,0.1045,0,3,3,61,3,3
15900,2012-10-31,Winter,2012,Oct,4,0,Wednesday,1,Misty,0.3,0.2879,0.87,0.194,0,5,5,61,5,5
15901,2012-10-31,Winter,2012,Oct,5,0,Wednesday,1,Misty,0.3,0.303,0.81,0.1343,0,24,24,61,24,24
15902,2012-10-31,Winter,2012,Oct,6,0,Wednesday,1,Clear,0.3,0.303,0.81,0.1642,0,116,116,61,116,116
15903,2012-10-31,Winter,2012,Oct,7,0,Wednesday,1,Misty,0.3,0.303,0.87,0.1343,3,334,337,61,337,337
15904,2012-10-31,Winter,2012,Oct,8,0,Wednesday,1,Clear,0.32,0.3333,0.81,0.1343,6,615,621,61,621,621
15905,2012-10-31,Winter,2012,Oct,9,0,Wednesday,1,Clear,0.34,0.3333,0.76,0.1343,17,280,297,61,297,297
15906,2012-10-31,Winter,2012,Oct,10,0,Wednesday,1,Clear,0.36,0.3333,0.71,0.2836,21,147,168,61,168,168
15907,2012-10-31,Winter,2012,Oct,11,0,Wednesday,1,Misty,0.36,0.3485,0.66,0.2239,37,152,189,61,189,189
15908,2012-10-31,Winter,2012,Oct,12,0,Wednesday,1,Clear,0.4,0.4091,0.58,0.194,44,197,241,61,241,241
15909,2012-10-31,Winter,2012,Oct,13,0,Wednesday,1,Clear,0.42,0.4242,0.5,0.2239,22,191,213,61,213,213
15910,2012-10-31,Winter,2012,Oct,14,0,Wednesday,1,Misty,0.42,0.4242,0.5,0.2239,45,179,224,61,224,224
15911,2012-10-31,Winter,2012,Oct,15,0,Wednesday,1,Clear,0.42,0.4242,0.54,0.1642,33,197,230,61,230,230
15912,2012-10-31,Winter,2012,Oct,16,0,Wednesday,1,Misty,0.42,0.4242,0.54,0.2239,51,373,424,61,424,424
15913,2012-10-31,Winter,2012,Oct,17,0,Wednesday,1,Misty,0.4,0.4091,0.58,0.1642,39,684,723,61,723,723
15914,2012-10-31,Winter,2012,Oct,18,0,Wednesday,1,Misty,0.4,0.4091,0.58,0.1642,28,556,584,61,584,584
15915,2012-10-31,Winter,2012,Oct,19,0,Wednesday,1,Misty,0.4,0.4091,0.5,0.194,27,383,410,61,410,410
15916,2012-10-31,Winter,2012,Oct,20,0,Wednesday,1,Misty,0.4,0.4091,0.5,0.194,9,259,268,61,268,268
15917,2012-10-31,Winter,2012,Oct,21,0,Wednesday,1,Misty,0.4,0.4091,0.5,0.194,12,180,192,61,192,192
15918,2012-10-31,Winter,2012,Oct,22,0,Wednesday,1,Clear,0.36,0.3485,0.57,0.1343,18,147,165,61,165,165
15919,2012-10-31,Winter,2012,Oct,23,0,Wednesday,1,Clear,0.36,0.3636,0.57,0.0896,7,94,101,61,101,101
15920,2012-11-01,Winter,2012,Nov,0,0,Thursday,1,Clear,0.36,0.3636,0.57,0.0896,8,52,60,60,60,60
15921,2012-11-01,Winter,2012,Nov,1,0,Thursday,1,Clear,0.3,0.3182,0.75,0.1045,8,22,30,60,30,30
15922,2012-11-01,Winter,2012,Nov,2,0,Thursday,1,Clear,0.32,0.3333,0.66,0.1343,10,10,20,60,20,20
15923,2012-11-01,Winter,2012,Nov,3,0,Thursday,1,Clear,0.34,0.3333,0.61,0.1343,5,10,15,60,15,15
15924,2012-11-01,Winter,2012,Nov,4,0,Thursday,1,Misty,0.34,0.3485,0.66,0.1045,2,8,10,60,10,10
15925,2012-11-01,Winter,2012,Nov,5,0,Thursday,1,Clear,0.34,0.3333,0.66,0.1343,1,39,40,60,40,40
15926,2012-11-01,Winter,2012,Nov,6,0,Thursday,1,Clear,0.34,0.3333,0.61,0.1642,2,146,148,60,148,148
15927,2012-11-01,Winter,2012,Nov,7,0,Thursday,1,Misty,0.36,0.3485,0.57,0.1642,6,414,420,60,420,420
15928,2012-11-01,Winter,2012,Nov,8,0,Thursday,1,Misty,0.36,0.3788,0.56,0.1045,12,668,680,60,680,680
15929,2012-11-01,Winter,2012,Nov,9,0,Thursday,1,Light_rainsnow,0.36,0.3636,0.57,0.1045,21,310,331,60,331,331
15930,2012-11-01,Winter,2012,Nov,10,0,Thursday,1,Light_rainsnow,0.36,0.3485,0.62,0.194,13,133,146,60,146,146
15931,2012-11-01,Winter,2012,Nov,11,0,Thursday,1,Light_rainsnow,0.36,0.3485,0.62,0.194,14,156,170,60,170,170
15932,2012-11-01,Winter,2012,Nov,12,0,Thursday,1,Light_rainsnow,0.38,0.3939,0.62,0.1642,23,198,221,60,221,221
15933,2012-11-01,Winter,2012,Nov,13,0,Thursday,1,Misty,0.4,0.4091,0.58,0.1642,49,199,248,60,248,248
15934,2012-11-01,Winter,2012,Nov,14,0,Thursday,1,Misty,0.4,0.4091,0.5,0.2239,31,154,185,60,185,185
15935,2012-11-01,Winter,2012,Nov,15,0,Thursday,1,Misty,0.4,0.4091,0.54,0.1642,35,179,214,60,214,214
15936,2012-11-01,Winter,2012,Nov,16,0,Thursday,1,Misty,0.4,0.4091,0.54,0.1642,31,313,344,60,344,344
15937,2012-11-01,Winter,2012,Nov,17,0,Thursday,1,Light_rainsnow,0.4,0.4091,0.5,0.2239,37,652,689,60,689,689
15938,2012-11-01,Winter,2012,Nov,18,0,Thursday,1,Misty,0.4,0.4091,0.5,0.1642,50,628,678,60,678,678
15939,2012-11-01,Winter,2012,Nov,19,0,Thursday,1,Misty,0.4,0.4091,0.5,0.1642,28,424,452,60,452,452
15940,2012-11-01,Winter,2012,Nov,20,0,Thursday,1,Misty,0.38,0.3939,0.54,0.2537,16,280,296,60,296,296
15941,2012-11-01,Winter,2012,Nov,21,0,Thursday,1,Misty,0.38,0.3939,0.54,0.1343,29,238,267,60,267,267
15942,2012-11-01,Winter,2012,Nov,22,0,Thursday,1,Clear,0.36,0.3485,0.57,0.1642,27,175,202,60,202,202
15943,2012-11-01,Winter,2012,Nov,23,0,Thursday,1,Clear,0.34,0.3333,0.57,0.1642,8,112,120,60,120,120
15944,2012-11-02,Winter,2012,Nov,0,0,Friday,1,Clear,0.34,0.3333,0.57,0.1642,10,40,50,59,50,50
15945,2012-11-02,Winter,2012,Nov,1,0,Friday,1,Clear,0.32,0.3182,0.66,0.1642,5,19,24,59,24,24
15946,2012-11-02,Winter,2012,Nov,2,0,Friday,1,Clear,0.32,0.3182,0.66,0.1642,3,7,10,59,10,10
15947,2012-11-02,Winter,2012,Nov,3,0,Friday,1,Clear,0.3,0.303,0.7,0.1642,0,3,3,59,3,3
15948,2012-11-02,Winter,2012,Nov,4,0,Friday,1,Clear,0.3,0.3182,0.7,0.1045,1,6,7,59,7,7
15949,2012-11-02,Winter,2012,Nov,5,0,Friday,1,Misty,0.32,0.3182,0.66,0.1642,1,25,26,59,26,26
15950,2012-11-02,Winter,2012,Nov,6,0,Friday,1,Clear,0.3,0.303,0.7,0.1642,2,120,122,59,122,122
15951,2012-11-02,Winter,2012,Nov,7,0,Friday,1,Misty,0.3,0.303,0.7,0.1343,8,349,357,59,357,357
15952,2012-11-02,Winter,2012,Nov,8,0,Friday,1,Clear,0.32,0.3333,0.57,0.1045,31,656,687,59,687,687
15953,2012-11-02,Winter,2012,Nov,9,0,Friday,1,Clear,0.34,0.3485,0.53,0.1045,27,355,382,59,382,382
15954,2012-11-02,Winter,2012,Nov,10,0,Friday,1,Clear,0.38,0.3939,0.46,0.2985,21,183,204,59,204,204
15955,2012-11-02,Winter,2012,Nov,11,0,Friday,1,Clear,0.42,0.4242,0.41,0.4179,42,179,221,59,221,221
15956,2012-11-02,Winter,2012,Nov,12,0,Friday,1,Clear,0.42,0.4242,0.41,0.3582,52,240,292,59,292,292
15957,2012-11-02,Winter,2012,Nov,13,0,Friday,1,Clear,0.4,0.4091,0.43,0.3582,64,230,294,59,294,294
15958,2012-11-02,Winter,2012,Nov,14,0,Friday,1,Misty,0.4,0.4091,0.4,0.4925,63,199,262,59,262,262
15959,2012-11-02,Winter,2012,Nov,15,0,Friday,1,Misty,0.4,0.4091,0.4,0.4179,51,255,306,59,306,306
15960,2012-11-02,Winter,2012,Nov,16,0,Friday,1,Clear,0.38,0.3939,0.4,0.3284,48,373,421,59,421,421
15961,2012-11-02,Winter,2012,Nov,17,0,Friday,1,Clear,0.38,0.3939,0.4,0.3284,57,581,638,59,638,638
15962,2012-11-02,Winter,2012,Nov,18,0,Friday,1,Misty,0.38,0.3939,0.43,0.3284,32,490,522,59,522,522
15963,2012-11-02,Winter,2012,Nov,19,0,Friday,1,Misty,0.38,0.3939,0.43,0.2985,38,336,374,59,374,374
15964,2012-11-02,Winter,2012,Nov,20,0,Friday,1,Misty,0.36,0.3333,0.46,0.4179,14,207,221,59,221,221
15965,2012-11-02,Winter,2012,Nov,21,0,Friday,1,Misty,0.36,0.3333,0.46,0.3582,23,133,156,59,156,156
15966,2012-11-02,Winter,2012,Nov,22,0,Friday,1,Clear,0.36,0.3333,0.46,0.2537,14,135,149,59,149,149
15967,2012-11-02,Winter,2012,Nov,23,0,Friday,1,Clear,0.34,0.303,0.53,0.2985,11,108,119,59,119,119
15968,2012-11-03,Winter,2012,Nov,0,0,Saturday,0,Clear,0.34,0.3333,0.53,0.1642,9,99,108,58,108,108
15969,2012-11-03,Winter,2012,Nov,1,0,Saturday,0,Misty,0.34,0.303,0.49,0.3284,6,83,89,58,89,89
15970,2012-11-03,Winter,2012,Nov,2,0,Saturday,0,Misty,0.34,0.3182,0.49,0.2537,10,36,46,58,46,46
15971,2012-11-03,Winter,2012,Nov,3,0,Saturday,0,Misty,0.34,0.3182,0.49,0.2537,6,22,28,58,28,28
15972,2012-11-03,Winter,2012,Nov,4,0,Saturday,0,Misty,0.32,0.303,0.49,0.2985,8,8,16,58,16,16
15973,2012-11-03,Winter,2012,Nov,5,0,Saturday,0,Misty,0.32,0.303,0.49,0.2537,1,8,9,58,9,9
15974,2012-11-03,Winter,2012,Nov,6,0,Saturday,0,Misty,0.32,0.3182,0.49,0.194,4,17,21,58,21,21
15975,2012-11-03,Winter,2012,Nov,7,0,Saturday,0,Misty,0.32,0.303,0.49,0.2537,1,58,59,58,59,59
15976,2012-11-03,Winter,2012,Nov,8,0,Saturday,0,Misty,0.34,0.303,0.46,0.2985,10,132,142,58,142,142
15977,2012-11-03,Winter,2012,Nov,9,0,Saturday,0,Misty,0.34,0.303,0.49,0.2985,31,188,219,58,219,219
15978,2012-11-03,Winter,2012,Nov,10,0,Saturday,0,Clear,0.36,0.3333,0.46,0.3881,68,260,328,58,328,328
15979,2012-11-03,Winter,2012,Nov,11,0,Saturday,0,Misty,0.36,0.3333,0.46,0.3881,56,284,340,58,340,340
15980,2012-11-03,Winter,2012,Nov,12,0,Saturday,0,Misty,0.36,0.3182,0.46,0.4627,74,320,394,58,394,394
15981,2012-11-03,Winter,2012,Nov,13,0,Saturday,0,Misty,0.36,0.3333,0.46,0.3582,110,339,449,58,449,449
15982,2012-11-03,Winter,2012,Nov,14,0,Saturday,0,Misty,0.36,0.3333,0.5,0.3284,136,319,455,58,455,455
15983,2012-11-03,Winter,2012,Nov,15,0,Saturday,0,Misty,0.36,0.3182,0.46,0.4478,117,331,448,58,448,448
15984,2012-11-03,Winter,2012,Nov,16,0,Saturday,0,Misty,0.36,0.3333,0.46,0.3284,108,292,400,58,400,400
15985,2012-11-03,Winter,2012,Nov,17,0,Saturday,0,Misty,0.36,0.3333,0.46,0.2985,112,298,410,58,410,410
15986,2012-11-03,Winter,2012,Nov,18,0,Saturday,0,Misty,0.36,0.3333,0.46,0.2836,58,239,297,58,297,297
15987,2012-11-03,Winter,2012,Nov,19,0,Saturday,0,Clear,0.36,0.3485,0.5,0.1642,22,217,239,58,239,239
15988,2012-11-03,Winter,2012,Nov,20,0,Saturday,0,Clear,0.34,0.3333,0.53,0.1343,23,158,181,58,181,181
15989,2012-11-03,Winter,2012,Nov,21,0,Saturday,0,Clear,0.34,0.3485,0.53,0.1045,31,135,166,58,166,166
15990,2012-11-03,Winter,2012,Nov,22,0,Saturday,0,Clear,0.32,0.3333,0.57,0.1045,13,133,146,58,146,146
15991,2012-11-03,Winter,2012,Nov,23,0,Saturday,0,Clear,0.32,0.3333,0.57,0.1045,15,133,148,58,148,148
15992,2012-11-04,Winter,2012,Nov,0,0,Sunday,0,Clear,0.3,0.3182,0.61,0.1045,5,97,102,57,102,102
15993,2012-11-04,Winter,2012,Nov,1,0,Sunday,0,Clear,0.26,0.2879,0.81,0.0896,26,139,165,57,165,165
15994,2012-11-04,Winter,2012,Nov,2,0,Sunday,0,Clear,0.3,0.3333,0.65,0.0,6,31,37,57,37,37
15995,2012-11-04,Winter,2012,Nov,3,0,Sunday,0,Clear,0.28,0.2879,0.61,0.1045,1,10,11,57,11,11
15996,2012-11-04,Winter,2012,Nov,4,0,Sunday,0,Clear,0.26,0.2727,0.65,0.1343,2,7,9,57,9,9
15997,2012-11-04,Winter,2012,Nov,5,0,Sunday,0,Clear,0.26,0.2727,0.65,0.1045,0,5,5,57,5,5
15998,2012-11-04,Winter,2012,Nov,6,0,Sunday,0,Clear,0.28,0.2879,0.61,0.1343,2,14,16,57,16,16
15999,2012-11-04,Winter,2012,Nov,7,0,Sunday,0,Clear,0.26,0.2727,0.65,0.1045,11,39,50,57,50,50
16000,2012-11-04,Winter,2012,Nov,8,0,Sunday,0,Clear,0.3,0.303,0.56,0.1343,34,115,149,57,149,149
16001,2012-11-04,Winter,2012,Nov,9,0,Sunday,0,Clear,0.32,0.3333,0.53,0.0,56,161,217,57,217,217
16002,2012-11-04,Winter,2012,Nov,10,0,Sunday,0,Clear,0.34,0.3333,0.49,0.194,73,287,360,57,360,360
16003,2012-11-04,Winter,2012,Nov,11,0,Sunday,0,Clear,0.38,0.3939,0.46,0.2239,134,311,445,57,445,445
16004,2012-11-04,Winter,2012,Nov,12,0,Sunday,0,Clear,0.38,0.3939,0.46,0.2239,150,354,504,57,504,504
16005,2012-11-04,Winter,2012,Nov,13,0,Sunday,0,Clear,0.4,0.4091,0.43,0.2239,122,371,493,57,493,493
16006,2012-11-04,Winter,2012,Nov,14,0,Sunday,0,Clear,0.4,0.4091,0.4,0.194,149,360,509,57,509,509
16007,2012-11-04,Winter,2012,Nov,15,0,Sunday,0,Clear,0.4,0.4091,0.4,0.2239,149,300,449,57,449,449
16008,2012-11-04,Winter,2012,Nov,16,0,Sunday,0,Clear,0.4,0.4091,0.4,0.3284,119,316,435,57,435,435
16009,2012-11-04,Winter,2012,Nov,17,0,Sunday,0,Clear,0.36,0.3485,0.43,0.194,57,270,327,57,327,327
16010,2012-11-04,Winter,2012,Nov,18,0,Sunday,0,Clear,0.36,0.3485,0.43,0.2239,31,206,237,57,237,237
16011,2012-11-04,Winter,2012,Nov,19,0,Sunday,0,Clear,0.36,0.3333,0.43,0.2537,24,203,227,57,227,227
16012,2012-11-04,Winter,2012,Nov,20,0,Sunday,0,Clear,0.32,0.2879,0.53,0.3582,7,134,141,57,141,141
16013,2012-11-04,Winter,2012,Nov,21,0,Sunday,0,Clear,0.3,0.2727,0.52,0.2985,16,71,87,57,87,87
16014,2012-11-04,Winter,2012,Nov,22,0,Sunday,0,Clear,0.3,0.2879,0.52,0.2836,15,64,79,57,79,79
16015,2012-11-04,Winter,2012,Nov,23,0,Sunday,0,Misty,0.3,0.303,0.56,0.1642,12,41,53,57,53,53
16016,2012-11-05,Winter,2012,Nov,0,0,Monday,1,Misty,0.3,0.2879,0.56,0.194,3,20,23,56,23,23
16017,2012-11-05,Winter,2012,Nov,1,0,Monday,1,Misty,0.3,0.303,0.56,0.1642,0,8,8,56,8,8
16018,2012-11-05,Winter,2012,Nov,2,0,Monday,1,Misty,0.3,0.303,0.56,0.1642,2,4,6,56,6,6
16019,2012-11-05,Winter,2012,Nov,3,0,Monday,1,Misty,0.3,0.2879,0.56,0.2239,1,3,4,56,4,4
16020,2012-11-05,Winter,2012,Nov,4,0,Monday,1,Misty,0.3,0.2879,0.52,0.2537,5,11,16,56,16,16
16021,2012-11-05,Winter,2012,Nov,5,0,Monday,1,Misty,0.3,0.2727,0.52,0.3284,1,38,39,56,39,39
16022,2012-11-05,Winter,2012,Nov,6,0,Monday,1,Misty,0.3,0.2879,0.49,0.2836,4,135,139,56,139,139
16023,2012-11-05,Winter,2012,Nov,7,0,Monday,1,Misty,0.3,0.2879,0.49,0.2537,8,453,461,56,461,461
16024,2012-11-05,Winter,2012,Nov,8,0,Monday,1,Misty,0.3,0.2879,0.49,0.2239,19,629,648,56,648,648
16025,2012-11-05,Winter,2012,Nov,9,0,Monday,1,Misty,0.3,0.2879,0.52,0.2836,18,239,257,56,257,257
16026,2012-11-05,Winter,2012,Nov,10,0,Monday,1,Clear,0.32,0.303,0.49,0.2836,30,112,142,56,142,142
16027,2012-11-05,Winter,2012,Nov,11,0,Monday,1,Clear,0.34,0.3182,0.46,0.2239,31,119,150,56,150,150
16028,2012-11-05,Winter,2012,Nov,12,0,Monday,1,Clear,0.36,0.3333,0.43,0.3284,38,206,244,56,244,244
16029,2012-11-05,Winter,2012,Nov,13,0,Monday,1,Clear,0.36,0.3333,0.4,0.2537,39,183,222,56,222,222
16030,2012-11-05,Winter,2012,Nov,14,0,Monday,1,Clear,0.38,0.3939,0.4,0.1642,31,165,196,56,196,196
16031,2012-11-05,Winter,2012,Nov,15,0,Monday,1,Clear,0.38,0.3939,0.4,0.2836,24,207,231,56,231,231
16032,2012-11-05,Winter,2012,Nov,16,0,Monday,1,Clear,0.36,0.3333,0.43,0.2836,35,325,360,56,360,360
16033,2012-11-05,Winter,2012,Nov,17,0,Monday,1,Clear,0.34,0.3182,0.46,0.2239,34,604,638,56,638,638
16034,2012-11-05,Winter,2012,Nov,18,0,Monday,1,Clear,0.34,0.3182,0.46,0.2239,19,523,542,56,542,542
16035,2012-11-05,Winter,2012,Nov,19,0,Monday,1,Clear,0.32,0.3182,0.49,0.1642,11,361,372,56,372,372
16036,2012-11-05,Winter,2012,Nov,20,0,Monday,1,Clear,0.32,0.303,0.49,0.2537,13,228,241,56,241,241
16037,2012-11-05,Winter,2012,Nov,21,0,Monday,1,Clear,0.3,0.2879,0.52,0.2836,8,144,152,56,152,152
16038,2012-11-05,Winter,2012,Nov,22,0,Monday,1,Clear,0.28,0.2727,0.56,0.194,4,111,115,56,115,115
16039,2012-11-05,Winter,2012,Nov,23,0,Monday,1,Clear,0.26,0.2727,0.6,0.1343,0,53,53,56,53,53
16040,2012-11-06,Winter,2012,Nov,0,0,Tuesday,1,Clear,0.24,0.2576,0.6,0.1045,1,18,19,55,19,19
16041,2012-11-06,Winter,2012,Nov,1,0,Tuesday,1,Clear,0.24,0.2424,0.6,0.1642,0,8,8,55,8,8
16042,2012-11-06,Winter,2012,Nov,2,0,Tuesday,1,Clear,0.24,0.2576,0.65,0.0896,0,2,2,55,2,2
16043,2012-11-06,Winter,2012,Nov,3,0,Tuesday,1,Clear,0.22,0.2424,0.64,0.1045,0,4,4,55,4,4
16044,2012-11-06,Winter,2012,Nov,4,0,Tuesday,1,Clear,0.22,0.2576,0.69,0.0896,0,7,7,55,7,7
16045,2012-11-06,Winter,2012,Nov,5,0,Tuesday,1,Misty,0.22,0.2273,0.64,0.194,1,40,41,55,41,41
16046,2012-11-06,Winter,2012,Nov,6,0,Tuesday,1,Clear,0.22,0.2273,0.69,0.1343,6,143,149,55,149,149
16047,2012-11-06,Winter,2012,Nov,7,0,Tuesday,1,Clear,0.2,0.2121,0.69,0.1642,9,378,387,55,387,387
16048,2012-11-06,Winter,2012,Nov,8,0,Tuesday,1,Clear,0.22,0.2273,0.69,0.1642,20,568,588,55,588,588
16049,2012-11-06,Winter,2012,Nov,9,0,Tuesday,1,Clear,0.26,0.2576,0.6,0.1642,25,338,363,55,363,363
16050,2012-11-06,Winter,2012,Nov,10,0,Tuesday,1,Clear,0.3,0.2879,0.49,0.194,41,189,230,55,230,230
16051,2012-11-06,Winter,2012,Nov,11,0,Tuesday,1,Clear,0.32,0.3333,0.45,0.1343,39,177,216,55,216,216
16052,2012-11-06,Winter,2012,Nov,12,0,Tuesday,1,Clear,0.32,0.3333,0.45,0.1343,31,217,248,55,248,248
16053,2012-11-06,Winter,2012,Nov,13,0,Tuesday,1,Clear,0.34,0.3333,0.46,0.1343,46,232,278,55,278,278
16054,2012-11-06,Winter,2012,Nov,14,0,Tuesday,1,Clear,0.36,0.3636,0.4,0.1045,44,196,240,55,240,240
16055,2012-11-06,Winter,2012,Nov,15,0,Tuesday,1,Clear,0.34,0.3182,0.46,0.2537,45,227,272,55,272,272
16056,2012-11-06,Winter,2012,Nov,16,0,Tuesday,1,Clear,0.34,0.3333,0.46,0.1642,33,369,402,55,402,402
16057,2012-11-06,Winter,2012,Nov,17,0,Tuesday,1,Clear,0.32,0.303,0.53,0.2239,30,597,627,55,627,627
16058,2012-11-06,Winter,2012,Nov,18,0,Tuesday,1,Clear,0.32,0.303,0.57,0.2985,20,477,497,55,497,497
16059,2012-11-06,Winter,2012,Nov,19,0,Tuesday,1,Clear,0.3,0.2879,0.56,0.2239,15,356,371,55,371,371
16060,2012-11-06,Winter,2012,Nov,20,0,Tuesday,1,Clear,0.3,0.2879,0.61,0.2239,10,218,228,55,228,228
16061,2012-11-06,Winter,2012,Nov,21,0,Tuesday,1,Misty,0.3,0.2879,0.56,0.2537,14,137,151,55,151,151
16062,2012-11-06,Winter,2012,Nov,22,0,Tuesday,1,Misty,0.3,0.2879,0.56,0.2239,17,136,153,55,153,153
16063,2012-11-06,Winter,2012,Nov,23,0,Tuesday,1,Clear,0.3,0.2879,0.56,0.2239,19,186,205,55,205,205
16064,2012-11-07,Winter,2012,Nov,0,0,Wednesday,1,Misty,0.3,0.2879,0.56,0.2836,49,234,283,54,283,283
16065,2012-11-07,Winter,2012,Nov,1,0,Wednesday,1,Misty,0.28,0.2727,0.61,0.2537,6,86,92,54,92,92
16066,2012-11-07,Winter,2012,Nov,2,0,Wednesday,1,Misty,0.28,0.2576,0.56,0.2985,6,68,74,54,74,74
16067,2012-11-07,Winter,2012,Nov,3,0,Wednesday,1,Misty,0.28,0.2576,0.52,0.3284,2,9,11,54,11,11
16068,2012-11-07,Winter,2012,Nov,4,0,Wednesday,1,Misty,0.28,0.2576,0.52,0.2985,0,9,9,54,9,9
16069,2012-11-07,Winter,2012,Nov,5,0,Wednesday,1,Misty,0.28,0.2576,0.52,0.3284,0,27,27,54,27,27
16070,2012-11-07,Winter,2012,Nov,6,0,Wednesday,1,Misty,0.26,0.2424,0.56,0.2836,3,115,118,54,118,118
16071,2012-11-07,Winter,2012,Nov,7,0,Wednesday,1,Misty,0.26,0.2273,0.56,0.2985,5,314,319,54,319,319
16072,2012-11-07,Winter,2012,Nov,8,0,Wednesday,1,Misty,0.26,0.2424,0.6,0.2836,18,583,601,54,601,601
16073,2012-11-07,Winter,2012,Nov,9,0,Wednesday,1,Misty,0.26,0.2424,0.6,0.2836,17,351,368,54,368,368
16074,2012-11-07,Winter,2012,Nov,10,0,Wednesday,1,Misty,0.28,0.2576,0.56,0.2985,27,151,178,54,178,178
16075,2012-11-07,Winter,2012,Nov,11,0,Wednesday,1,Misty,0.32,0.2879,0.51,0.3582,15,132,147,54,147,147
16076,2012-11-07,Winter,2012,Nov,12,0,Wednesday,1,Misty,0.32,0.303,0.53,0.2836,24,188,212,54,212,212
16077,2012-11-07,Winter,2012,Nov,13,0,Wednesday,1,Misty,0.32,0.303,0.53,0.2537,23,158,181,54,181,181
16078,2012-11-07,Winter,2012,Nov,14,0,Wednesday,1,Misty,0.32,0.2879,0.53,0.3582,19,142,161,54,161,161
16079,2012-11-07,Winter,2012,Nov,15,0,Wednesday,1,Misty,0.32,0.303,0.53,0.2985,20,178,198,54,198,198
16080,2012-11-07,Winter,2012,Nov,16,0,Wednesday,1,Misty,0.32,0.2879,0.53,0.3582,23,250,273,54,273,273
16081,2012-11-07,Winter,2012,Nov,17,0,Wednesday,1,Misty,0.32,0.2879,0.53,0.3881,16,501,517,54,517,517
16082,2012-11-07,Winter,2012,Nov,18,0,Wednesday,1,Misty,0.32,0.2879,0.53,0.3582,17,448,465,54,465,465
16083,2012-11-07,Winter,2012,Nov,19,0,Wednesday,1,Misty,0.3,0.2727,0.56,0.2985,17,302,319,54,319,319
16084,2012-11-07,Winter,2012,Nov,20,0,Wednesday,1,Misty,0.32,0.303,0.49,0.3284,7,249,256,54,256,256
16085,2012-11-07,Winter,2012,Nov,21,0,Wednesday,1,Misty,0.32,0.303,0.49,0.2985,5,121,126,54,126,126
16086,2012-11-07,Winter,2012,Nov,22,0,Wednesday,1,Light_rainsnow,0.3,0.2879,0.56,0.2537,4,56,60,54,60,60
16087,2012-11-07,Winter,2012,Nov,23,0,Wednesday,1,Light_rainsnow,0.28,0.2727,0.65,0.2239,3,37,40,54,40,40
16088,2012-11-08,Winter,2012,Nov,0,0,Thursday,1,Light_rainsnow,0.28,0.2727,0.61,0.2239,1,14,15,53,15,15
16089,2012-11-08,Winter,2012,Nov,1,0,Thursday,1,Light_rainsnow,0.3,0.2727,0.52,0.3582,1,11,12,53,12,12
16090,2012-11-08,Winter,2012,Nov,2,0,Thursday,1,Misty,0.3,0.2879,0.49,0.2239,1,5,6,53,6,6
16091,2012-11-08,Winter,2012,Nov,4,0,Thursday,1,Misty,0.3,0.2879,0.45,0.2836,1,9,10,53,10,10
16092,2012-11-08,Winter,2012,Nov,5,0,Thursday,1,Misty,0.3,0.2879,0.42,0.2239,0,35,35,53,35,35
16093,2012-11-08,Winter,2012,Nov,6,0,Thursday,1,Clear,0.3,0.2879,0.39,0.2239,2,122,124,53,124,124
16094,2012-11-08,Winter,2012,Nov,7,0,Thursday,1,Clear,0.28,0.2576,0.36,0.3881,12,411,423,53,423,423
16095,2012-11-08,Winter,2012,Nov,8,0,Thursday,1,Clear,0.3,0.2879,0.33,0.2836,16,652,668,53,668,668
16096,2012-11-08,Winter,2012,Nov,9,0,Thursday,1,Clear,0.32,0.2879,0.31,0.3582,22,253,275,53,275,275
16097,2012-11-08,Winter,2012,Nov,10,0,Thursday,1,Clear,0.32,0.303,0.31,0.3284,13,148,161,53,161,161
16098,2012-11-08,Winter,2012,Nov,11,0,Thursday,1,Clear,0.36,0.3333,0.29,0.3881,16,155,171,53,171,171
16099,2012-11-08,Winter,2012,Nov,12,0,Thursday,1,Clear,0.4,0.4091,0.24,0.4925,33,202,235,53,235,235
16100,2012-11-08,Winter,2012,Nov,13,0,Thursday,1,Clear,0.44,0.4394,0.18,0.4179,33,195,228,53,228,228
16101,2012-11-08,Winter,2012,Nov,14,0,Thursday,1,Clear,0.44,0.4394,0.18,0.4179,33,149,182,53,182,182
16102,2012-11-08,Winter,2012,Nov,15,0,Thursday,1,Clear,0.44,0.4394,0.18,0.4179,32,201,233,53,233,233
16103,2012-11-08,Winter,2012,Nov,16,0,Thursday,1,Clear,0.42,0.4242,0.16,0.3881,18,321,339,53,339,339
16104,2012-11-08,Winter,2012,Nov,17,0,Thursday,1,Clear,0.4,0.4091,0.2,0.2985,36,556,592,53,592,592
16105,2012-11-08,Winter,2012,Nov,18,0,Thursday,1,Clear,0.4,0.4091,0.24,0.4179,16,491,507,53,507,507
16106,2012-11-08,Winter,2012,Nov,19,0,Thursday,1,Clear,0.38,0.3939,0.27,0.3582,14,359,373,53,373,373
16107,2012-11-08,Winter,2012,Nov,20,0,Thursday,1,Clear,0.38,0.3939,0.29,0.4627,10,235,245,53,245,245
16108,2012-11-08,Winter,2012,Nov,21,0,Thursday,1,Clear,0.36,0.3333,0.37,0.3881,11,222,233,53,233,233
16109,2012-11-08,Winter,2012,Nov,22,0,Thursday,1,Clear,0.34,0.303,0.42,0.2985,14,147,161,53,161,161
16110,2012-11-08,Winter,2012,Nov,23,0,Thursday,1,Clear,0.34,0.303,0.46,0.3582,5,82,87,53,87,87
16111,2012-11-09,Winter,2012,Nov,0,0,Friday,1,Clear,0.34,0.303,0.49,0.3284,9,46,55,52,55,55
16112,2012-11-09,Winter,2012,Nov,1,0,Friday,1,Clear,0.32,0.303,0.53,0.2836,3,17,20,52,20,20
16113,2012-11-09,Winter,2012,Nov,2,0,Friday,1,Clear,0.32,0.303,0.53,0.2537,1,11,12,52,12,12
16114,2012-11-09,Winter,2012,Nov,3,0,Friday,1,Clear,0.32,0.2879,0.53,0.4179,3,6,9,52,9,9
16115,2012-11-09,Winter,2012,Nov,4,0,Friday,1,Clear,0.32,0.2879,0.53,0.3582,0,14,14,52,14,14
16116,2012-11-09,Winter,2012,Nov,5,0,Friday,1,Clear,0.3,0.2879,0.56,0.194,2,25,27,52,27,27
16117,2012-11-09,Winter,2012,Nov,6,0,Friday,1,Clear,0.26,0.2727,0.65,0.1045,5,126,131,52,131,131
16118,2012-11-09,Winter,2012,Nov,7,0,Friday,1,Clear,0.26,0.2727,0.65,0.1343,9,332,341,52,341,341
16119,2012-11-09,Winter,2012,Nov,8,0,Friday,1,Clear,0.32,0.3182,0.57,0.1642,25,668,693,52,693,693
16120,2012-11-09,Winter,2012,Nov,9,0,Friday,1,Clear,0.34,0.303,0.53,0.4179,23,304,327,52,327,327
16121,2012-11-09,Winter,2012,Nov,10,0,Friday,1,Clear,0.36,0.3333,0.5,0.3284,34,163,197,52,197,197
16122,2012-11-09,Winter,2012,Nov,11,0,Friday,1,Clear,0.4,0.4091,0.47,0.2985,66,185,251,52,251,251
16123,2012-11-09,Winter,2012,Nov,12,0,Friday,1,Clear,0.44,0.4394,0.41,0.3284,48,214,262,52,262,262
16124,2012-11-09,Winter,2012,Nov,13,0,Friday,1,Clear,0.46,0.4545,0.38,0.2985,62,237,299,52,299,299
16125,2012-11-09,Winter,2012,Nov,14,0,Friday,1,Clear,0.46,0.4545,0.38,0.194,67,207,274,52,274,274
16126,2012-11-09,Winter,2012,Nov,15,0,Friday,1,Clear,0.46,0.4545,0.36,0.2239,78,278,356,52,356,356
16127,2012-11-09,Winter,2012,Nov,16,0,Friday,1,Clear,0.46,0.4545,0.38,0.1642,57,377,434,52,434,434
16128,2012-11-09,Winter,2012,Nov,17,0,Friday,1,Clear,0.42,0.4242,0.44,0.1343,61,593,654,52,654,654
16129,2012-11-09,Winter,2012,Nov,18,0,Friday,1,Clear,0.42,0.4242,0.44,0.1045,46,450,496,52,496,496
16130,2012-11-09,Winter,2012,Nov,19,0,Friday,1,Clear,0.34,0.3485,0.71,0.0896,30,331,361,52,361,361
16131,2012-11-09,Winter,2012,Nov,20,0,Friday,1,Clear,0.36,0.3485,0.66,0.1343,20,235,255,52,255,255
16132,2012-11-09,Winter,2012,Nov,21,0,Friday,1,Clear,0.34,0.3636,0.76,0.0,23,176,199,52,199,199
16133,2012-11-09,Winter,2012,Nov,22,0,Friday,1,Clear,0.34,0.3485,0.71,0.1045,17,146,163,52,163,163
16134,2012-11-09,Winter,2012,Nov,23,0,Friday,1,Clear,0.32,0.3333,0.81,0.0896,20,142,162,52,162,162
16135,2012-11-10,Winter,2012,Nov,0,0,Saturday,0,Clear,0.32,0.3333,0.76,0.0896,16,106,122,51,122,122
16136,2012-11-10,Winter,2012,Nov,1,0,Saturday,0,Clear,0.3,0.3182,0.81,0.0896,8,68,76,51,76,76
16137,2012-11-10,Winter,2012,Nov,2,0,Saturday,0,Clear,0.32,0.3485,0.81,0.0,2,42,44,51,44,44
16138,2012-11-10,Winter,2012,Nov,3,0,Saturday,0,Clear,0.3,0.3333,0.81,0.0,9,11,20,51,20,20
16139,2012-11-10,Winter,2012,Nov,4,0,Saturday,0,Clear,0.26,0.2727,0.87,0.1045,2,4,6,51,6,6
16140,2012-11-10,Winter,2012,Nov,5,0,Saturday,0,Clear,0.28,0.3182,0.87,0.0,1,9,10,51,10,10
16141,2012-11-10,Winter,2012,Nov,6,0,Saturday,0,Clear,0.24,0.2576,0.93,0.0896,5,11,16,51,16,16
16142,2012-11-10,Winter,2012,Nov,7,0,Saturday,0,Clear,0.26,0.2727,0.87,0.1045,14,57,71,51,71,71
16143,2012-11-10,Winter,2012,Nov,8,0,Saturday,0,Clear,0.32,0.3485,0.76,0.0,16,130,146,51,146,146
16144,2012-11-10,Winter,2012,Nov,9,0,Saturday,0,Clear,0.36,0.3485,0.66,0.194,43,216,259,51,259,259
16145,2012-11-10,Winter,2012,Nov,10,0,Saturday,0,Clear,0.4,0.4091,0.58,0.0,86,264,350,51,350,350
16146,2012-11-10,Winter,2012,Nov,11,0,Saturday,0,Clear,0.4,0.4091,0.58,0.1045,143,323,466,51,466,466
16147,2012-11-10,Winter,2012,Nov,12,0,Saturday,0,Clear,0.48,0.4697,0.48,0.0,258,348,606,51,606,606
16148,2012-11-10,Winter,2012,Nov,13,0,Saturday,0,Clear,0.52,0.5,0.39,0.0,268,383,651,51,651,651
16149,2012-11-10,Winter,2012,Nov,14,0,Saturday,0,Clear,0.54,0.5152,0.37,0.0,280,347,627,51,627,627
16150,2012-11-10,Winter,2012,Nov,15,0,Saturday,0,Clear,0.52,0.5,0.45,0.0,216,351,567,51,567,567
16151,2012-11-10,Winter,2012,Nov,16,0,Saturday,0,Clear,0.54,0.5152,0.37,0.0,227,378,605,51,605,605
16152,2012-11-10,Winter,2012,Nov,17,0,Saturday,0,Clear,0.5,0.4848,0.45,0.194,183,318,501,51,501,501
16153,2012-11-10,Winter,2012,Nov,18,0,Saturday,0,Clear,0.44,0.4394,0.54,0.1343,103,256,359,51,359,359
16154,2012-11-10,Winter,2012,Nov,19,0,Saturday,0,Clear,0.46,0.4545,0.51,0.0896,55,228,283,51,283,283
16155,2012-11-10,Winter,2012,Nov,20,0,Saturday,0,Clear,0.44,0.4394,0.54,0.0,39,153,192,51,192,192
16156,2012-11-10,Winter,2012,Nov,21,0,Saturday,0,Clear,0.4,0.4091,0.66,0.0,51,169,220,51,220,220
16157,2012-11-10,Winter,2012,Nov,22,0,Saturday,0,Clear,0.38,0.3939,0.71,0.0896,39,154,193,51,193,193
16158,2012-11-10,Winter,2012,Nov,23,0,Saturday,0,Clear,0.36,0.3636,0.71,0.1045,26,120,146,51,146,146
16159,2012-11-11,Winter,2012,Nov,0,0,Sunday,0,Clear,0.34,0.3485,0.81,0.0896,14,110,124,50,124,124
16160,2012-11-11,Winter,2012,Nov,1,0,Sunday,0,Clear,0.34,0.3485,0.76,0.0896,26,82,108,50,108,108
16161,2012-11-11,Winter,2012,Nov,2,0,Sunday,0,Clear,0.32,0.3333,0.87,0.1045,12,58,70,50,70,70
16162,2012-11-11,Winter,2012,Nov,3,0,Sunday,0,Clear,0.34,0.3636,0.81,0.0,9,39,48,50,48,48
16163,2012-11-11,Winter,2012,Nov,4,0,Sunday,0,Clear,0.32,0.3333,0.81,0.1045,5,6,11,50,11,11
16164,2012-11-11,Winter,2012,Nov,5,0,Sunday,0,Clear,0.3,0.303,0.87,0.1343,0,12,12,50,12,12
16165,2012-11-11,Winter,2012,Nov,6,0,Sunday,0,Clear,0.3,0.3182,0.87,0.0896,3,16,19,50,19,19
16166,2012-11-11,Winter,2012,Nov,7,0,Sunday,0,Clear,0.3,0.3182,0.89,0.0896,12,56,68,50,68,68
16167,2012-11-11,Winter,2012,Nov,8,0,Sunday,0,Clear,0.32,0.3333,0.87,0.1045,32,87,119,50,119,119
16168,2012-11-11,Winter,2012,Nov,9,0,Sunday,0,Clear,0.36,0.3788,0.77,0.0,94,179,273,50,273,273
16169,2012-11-11,Winter,2012,Nov,10,0,Sunday,0,Clear,0.4,0.4091,0.69,0.1045,133,272,405,50,405,405
16170,2012-11-11,Winter,2012,Nov,11,0,Sunday,0,Clear,0.46,0.4545,0.59,0.1343,180,324,504,50,504,504
16171,2012-11-11,Winter,2012,Nov,12,0,Sunday,0,Clear,0.5,0.4848,0.48,0.0896,195,390,585,50,585,585
16172,2012-11-11,Winter,2012,Nov,13,0,Sunday,0,Clear,0.54,0.5152,0.45,0.1045,262,424,686,50,686,686
16173,2012-11-11,Winter,2012,Nov,14,0,Sunday,0,Clear,0.6,0.6212,0.33,0.1642,292,362,654,50,654,654
16174,2012-11-11,Winter,2012,Nov,15,0,Sunday,0,Clear,0.56,0.5303,0.37,0.2239,304,420,724,50,724,724
16175,2012-11-11,Winter,2012,Nov,16,0,Sunday,0,Clear,0.54,0.5152,0.42,0.2239,260,393,653,50,653,653
16176,2012-11-11,Winter,2012,Nov,17,0,Sunday,0,Clear,0.54,0.5152,0.45,0.1642,151,342,493,50,493,493
16177,2012-11-11,Winter,2012,Nov,18,0,Sunday,0,Clear,0.52,0.5,0.45,0.1343,102,303,405,50,405,405
16178,2012-11-11,Winter,2012,Nov,19,0,Sunday,0,Clear,0.48,0.4697,0.55,0.1343,69,208,277,50,277,277
16179,2012-11-11,Winter,2012,Nov,20,0,Sunday,0,Clear,0.44,0.4394,0.62,0.1642,54,146,200,50,200,200
16180,2012-11-11,Winter,2012,Nov,21,0,Sunday,0,Clear,0.44,0.4394,0.67,0.2239,44,127,171,50,171,171
16181,2012-11-11,Winter,2012,Nov,22,0,Sunday,0,Clear,0.42,0.4242,0.71,0.194,21,113,134,50,134,134
16182,2012-11-11,Winter,2012,Nov,23,0,Sunday,0,Clear,0.42,0.4242,0.71,0.194,16,93,109,50,109,109
16183,2012-11-12,Winter,2012,Nov,0,1,Monday,0,Clear,0.42,0.4242,0.71,0.1045,6,43,49,49,49,49
16184,2012-11-12,Winter,2012,Nov,1,1,Monday,0,Clear,0.4,0.4091,0.76,0.1642,4,26,30,49,30,30
16185,2012-11-12,Winter,2012,Nov,2,1,Monday,0,Clear,0.4,0.4091,0.76,0.1343,6,14,20,49,20,20
16186,2012-11-12,Winter,2012,Nov,3,1,Monday,0,Clear,0.4,0.4091,0.76,0.1343,1,3,4,49,4,4
16187,2012-11-12,Winter,2012,Nov,4,1,Monday,0,Clear,0.4,0.4091,0.76,0.0896,1,3,4,49,4,4
16188,2012-11-12,Winter,2012,Nov,5,1,Monday,0,Clear,0.38,0.3939,0.87,0.0,1,23,24,49,24,24
16189,2012-11-12,Winter,2012,Nov,6,1,Monday,0,Clear,0.38,0.3939,0.87,0.1045,7,64,71,49,71,71
16190,2012-11-12,Winter,2012,Nov,7,1,Monday,0,Clear,0.4,0.4091,0.87,0.0,16,248,264,49,264,264
16191,2012-11-12,Winter,2012,Nov,8,1,Monday,0,Clear,0.42,0.4242,0.82,0.1642,50,490,540,49,540,540
16192,2012-11-12,Winter,2012,Nov,9,1,Monday,0,Clear,0.44,0.4394,0.88,0.1045,60,337,397,49,397,397
16193,2012-11-12,Winter,2012,Nov,10,1,Monday,0,Clear,0.48,0.4697,0.77,0.1642,82,184,266,49,266,266
16194,2012-11-12,Winter,2012,Nov,11,1,Monday,0,Clear,0.52,0.5,0.72,0.1642,112,255,367,49,367,367
16195,2012-11-12,Winter,2012,Nov,12,1,Monday,0,Clear,0.56,0.5303,0.64,0.2239,105,314,419,49,419,419
16196,2012-11-12,Winter,2012,Nov,13,1,Monday,0,Clear,0.6,0.6061,0.6,0.2239,108,312,420,49,420,420
16197,2012-11-12,Winter,2012,Nov,14,1,Monday,0,Clear,0.58,0.5455,0.6,0.2836,134,310,444,49,444,444
16198,2012-11-12,Winter,2012,Nov,15,1,Monday,0,Clear,0.56,0.5303,0.64,0.2537,102,280,382,49,382,382
16199,2012-11-12,Winter,2012,Nov,16,1,Monday,0,Clear,0.56,0.5303,0.64,0.1642,87,347,434,49,434,434
16200,2012-11-12,Winter,2012,Nov,17,1,Monday,0,Clear,0.56,0.5303,0.64,0.2836,66,530,596,49,596,596
16201,2012-11-12,Winter,2012,Nov,18,1,Monday,0,Clear,0.52,0.5,0.72,0.1343,65,486,551,49,551,551
16202,2012-11-12,Winter,2012,Nov,19,1,Monday,0,Clear,0.54,0.5152,0.73,0.2836,30,323,353,49,353,353
16203,2012-11-12,Winter,2012,Nov,20,1,Monday,0,Misty,0.52,0.5,0.77,0.2836,31,273,304,49,304,304
16204,2012-11-12,Winter,2012,Nov,21,1,Monday,0,Light_rainsnow,0.54,0.5152,0.73,0.2239,10,145,155,49,155,155
16205,2012-11-12,Winter,2012,Nov,22,1,Monday,0,Clear,0.52,0.5,0.77,0.2537,12,100,112,49,112,112
16206,2012-11-12,Winter,2012,Nov,23,1,Monday,0,Misty,0.54,0.5152,0.77,0.2239,1,62,63,49,63,63
16207,2012-11-13,Winter,2012,Nov,0,0,Tuesday,1,Misty,0.52,0.5,0.83,0.2836,5,18,23,48,23,23
16208,2012-11-13,Winter,2012,Nov,1,0,Tuesday,1,Light_rainsnow,0.44,0.4394,0.88,0.6418,0,5,5,48,5,5
16209,2012-11-13,Winter,2012,Nov,2,0,Tuesday,1,Light_rainsnow,0.36,0.3182,0.87,0.4478,7,4,11,48,11,11
16210,2012-11-13,Winter,2012,Nov,3,0,Tuesday,1,Light_rainsnow,0.36,0.3333,0.87,0.3582,2,3,5,48,5,5
16211,2012-11-13,Winter,2012,Nov,4,0,Tuesday,1,Misty,0.36,0.3333,0.81,0.3881,0,9,9,48,9,9
16212,2012-11-13,Winter,2012,Nov,5,0,Tuesday,1,Misty,0.34,0.3182,0.87,0.2836,0,18,18,48,18,18
16213,2012-11-13,Winter,2012,Nov,6,0,Tuesday,1,Light_rainsnow,0.32,0.2879,0.81,0.4627,2,48,50,48,50,50
16214,2012-11-13,Winter,2012,Nov,7,0,Tuesday,1,Light_rainsnow,0.32,0.303,0.87,0.2537,1,106,107,48,107,107
16215,2012-11-13,Winter,2012,Nov,8,0,Tuesday,1,Light_rainsnow,0.32,0.303,0.87,0.2537,4,207,211,48,211,211
16216,2012-11-13,Winter,2012,Nov,9,0,Tuesday,1,Light_rainsnow,0.32,0.303,0.81,0.3284,1,109,110,48,110,110
16217,2012-11-13,Winter,2012,Nov,10,0,Tuesday,1,Light_rainsnow,0.3,0.2727,0.75,0.3881,10,84,94,48,94,94
16218,2012-11-13,Winter,2012,Nov,11,0,Tuesday,1,Clear,0.32,0.303,0.7,0.2537,22,133,155,48,155,155
16219,2012-11-13,Winter,2012,Nov,12,0,Tuesday,1,Clear,0.34,0.3182,0.61,0.2836,16,180,196,48,196,196
16220,2012-11-13,Winter,2012,Nov,13,0,Tuesday,1,Clear,0.34,0.3182,0.53,0.2537,30,188,218,48,218,218
16221,2012-11-13,Winter,2012,Nov,14,0,Tuesday,1,Clear,0.38,0.3939,0.46,0.3881,34,169,203,48,203,203
16222,2012-11-13,Winter,2012,Nov,15,0,Tuesday,1,Clear,0.4,0.4091,0.4,0.2985,33,184,217,48,217,217
16223,2012-11-13,Winter,2012,Nov,16,0,Tuesday,1,Clear,0.38,0.3939,0.4,0.2985,28,282,310,48,310,310
16224,2012-11-13,Winter,2012,Nov,17,0,Tuesday,1,Clear,0.34,0.303,0.49,0.3582,33,575,608,48,608,608
16225,2012-11-13,Winter,2012,Nov,18,0,Tuesday,1,Clear,0.34,0.3182,0.49,0.2836,45,514,559,48,559,559
16226,2012-11-13,Winter,2012,Nov,19,0,Tuesday,1,Clear,0.32,0.2879,0.49,0.3582,12,344,356,48,356,356
16227,2012-11-13,Winter,2012,Nov,20,0,Tuesday,1,Clear,0.3,0.2727,0.49,0.3582,12,211,223,48,223,223
16228,2012-11-13,Winter,2012,Nov,21,0,Tuesday,1,Clear,0.3,0.2727,0.49,0.3582,9,178,187,48,187,187
16229,2012-11-13,Winter,2012,Nov,22,0,Tuesday,1,Clear,0.26,0.2273,0.56,0.3284,15,120,135,48,135,135
16230,2012-11-13,Winter,2012,Nov,23,0,Tuesday,1,Clear,0.26,0.2273,0.56,0.2985,6,78,84,48,84,84
16231,2012-11-14,Winter,2012,Nov,0,0,Wednesday,1,Clear,0.26,0.2424,0.56,0.2836,4,20,24,47,24,24
16232,2012-11-14,Winter,2012,Nov,1,0,Wednesday,1,Clear,0.24,0.2121,0.6,0.2985,2,10,12,47,12,12
16233,2012-11-14,Winter,2012,Nov,2,0,Wednesday,1,Clear,0.24,0.2121,0.6,0.2985,0,1,1,47,1,1
16234,2012-11-14,Winter,2012,Nov,3,0,Wednesday,1,Clear,0.24,0.2273,0.65,0.2239,0,5,5,47,5,5
16235,2012-11-14,Winter,2012,Nov,4,0,Wednesday,1,Clear,0.22,0.2273,0.69,0.194,0,6,6,47,6,6
16236,2012-11-14,Winter,2012,Nov,5,0,Wednesday,1,Clear,0.22,0.2273,0.69,0.194,0,39,39,47,39,39
16237,2012-11-14,Winter,2012,Nov,6,0,Wednesday,1,Clear,0.24,0.2273,0.65,0.194,4,142,146,47,146,146
16238,2012-11-14,Winter,2012,Nov,7,0,Wednesday,1,Clear,0.24,0.2121,0.65,0.2836,10,405,415,47,415,415
16239,2012-11-14,Winter,2012,Nov,8,0,Wednesday,1,Clear,0.28,0.2576,0.56,0.2985,27,664,691,47,691,691
16240,2012-11-14,Winter,2012,Nov,9,0,Wednesday,1,Clear,0.3,0.2727,0.52,0.3881,22,310,332,47,332,332
16241,2012-11-14,Winter,2012,Nov,10,0,Wednesday,1,Clear,0.32,0.2879,0.45,0.3582,18,153,171,47,171,171
16242,2012-11-14,Winter,2012,Nov,11,0,Wednesday,1,Clear,0.32,0.303,0.49,0.2537,25,126,151,47,151,151
16243,2012-11-14,Winter,2012,Nov,12,0,Wednesday,1,Clear,0.34,0.3333,0.46,0.0,40,200,240,47,240,240
16244,2012-11-14,Winter,2012,Nov,13,0,Wednesday,1,Clear,0.36,0.3333,0.43,0.2537,32,182,214,47,214,214
16245,2012-11-14,Winter,2012,Nov,14,0,Wednesday,1,Clear,0.36,0.3485,0.43,0.1343,20,161,181,47,181,181
16246,2012-11-14,Winter,2012,Nov,15,0,Wednesday,1,Clear,0.36,0.3333,0.43,0.2836,32,228,260,47,260,260
16247,2012-11-14,Winter,2012,Nov,16,0,Wednesday,1,Clear,0.34,0.3485,0.46,0.1045,31,290,321,47,321,321
16248,2012-11-14,Winter,2012,Nov,17,0,Wednesday,1,Clear,0.32,0.3182,0.49,0.194,19,564,583,47,583,583
16249,2012-11-14,Winter,2012,Nov,18,0,Wednesday,1,Clear,0.32,0.3182,0.53,0.1642,24,543,567,47,567,567
16250,2012-11-14,Winter,2012,Nov,19,0,Wednesday,1,Clear,0.3,0.303,0.52,0.1642,28,368,396,47,396,396
16251,2012-11-14,Winter,2012,Nov,20,0,Wednesday,1,Clear,0.3,0.3182,0.52,0.0896,15,252,267,47,267,267
16252,2012-11-14,Winter,2012,Nov,21,0,Wednesday,1,Clear,0.3,0.3333,0.56,0.0,5,208,213,47,213,213
16253,2012-11-14,Winter,2012,Nov,22,0,Wednesday,1,Clear,0.28,0.3182,0.61,0.0,6,167,173,47,173,173
16254,2012-11-14,Winter,2012,Nov,23,0,Wednesday,1,Clear,0.24,0.2424,0.7,0.1343,9,78,87,47,87,87
16255,2012-11-15,Winter,2012,Nov,0,0,Thursday,1,Misty,0.26,0.303,0.65,0.0,1,33,34,46,34,34
16256,2012-11-15,Winter,2012,Nov,1,0,Thursday,1,Misty,0.26,0.2727,0.65,0.1045,2,14,16,46,16,16
16257,2012-11-15,Winter,2012,Nov,2,0,Thursday,1,Misty,0.26,0.2576,0.7,0.1642,0,7,7,46,7,7
16258,2012-11-15,Winter,2012,Nov,3,0,Thursday,1,Misty,0.26,0.2879,0.7,0.0896,0,2,2,46,2,2
16259,2012-11-15,Winter,2012,Nov,4,0,Thursday,1,Misty,0.28,0.2879,0.65,0.1343,0,5,5,46,5,5
16260,2012-11-15,Winter,2012,Nov,5,0,Thursday,1,Misty,0.3,0.2879,0.61,0.2239,3,34,37,46,37,37
16261,2012-11-15,Winter,2012,Nov,6,0,Thursday,1,Misty,0.3,0.2879,0.65,0.2537,1,146,147,46,147,147
16262,2012-11-15,Winter,2012,Nov,7,0,Thursday,1,Misty,0.3,0.2879,0.65,0.194,7,403,410,46,410,410
16263,2012-11-15,Winter,2012,Nov,8,0,Thursday,1,Misty,0.3,0.2879,0.61,0.2239,21,625,646,46,646,646
16264,2012-11-15,Winter,2012,Nov,9,0,Thursday,1,Misty,0.32,0.3182,0.61,0.194,17,306,323,46,323,323
16265,2012-11-15,Winter,2012,Nov,10,0,Thursday,1,Misty,0.32,0.3333,0.66,0.1343,11,142,153,46,153,153
16266,2012-11-15,Winter,2012,Nov,11,0,Thursday,1,Misty,0.34,0.3333,0.61,0.1343,28,138,166,46,166,166
16267,2012-11-15,Winter,2012,Nov,12,0,Thursday,1,Misty,0.36,0.3636,0.62,0.1045,29,184,213,46,213,213
16268,2012-11-15,Winter,2012,Nov,13,0,Thursday,1,Misty,0.38,0.3939,0.54,0.1045,20,197,217,46,217,217
16269,2012-11-15,Winter,2012,Nov,14,0,Thursday,1,Misty,0.38,0.3939,0.54,0.1642,27,174,201,46,201,201
16270,2012-11-15,Winter,2012,Nov,15,0,Thursday,1,Misty,0.38,0.3939,0.58,0.1642,26,191,217,46,217,217
16271,2012-11-15,Winter,2012,Nov,16,0,Thursday,1,Misty,0.36,0.3485,0.57,0.194,24,318,342,46,342,342
16272,2012-11-15,Winter,2012,Nov,17,0,Thursday,1,Misty,0.36,0.3485,0.57,0.2239,22,541,563,46,563,563
16273,2012-11-15,Winter,2012,Nov,18,0,Thursday,1,Misty,0.36,0.3485,0.57,0.194,10,563,573,46,573,573
16274,2012-11-15,Winter,2012,Nov,19,0,Thursday,1,Misty,0.34,0.3333,0.61,0.1343,11,375,386,46,386,386
16275,2012-11-15,Winter,2012,Nov,20,0,Thursday,1,Clear,0.34,0.3485,0.61,0.1045,23,262,285,46,285,285
16276,2012-11-15,Winter,2012,Nov,21,0,Thursday,1,Misty,0.32,0.3333,0.66,0.1045,20,204,224,46,224,224
16277,2012-11-15,Winter,2012,Nov,22,0,Thursday,1,Misty,0.32,0.3182,0.66,0.1642,10,143,153,46,153,153
16278,2012-11-15,Winter,2012,Nov,23,0,Thursday,1,Misty,0.32,0.3182,0.61,0.1642,7,118,125,46,125,125
16279,2012-11-16,Winter,2012,Nov,0,0,Friday,1,Misty,0.32,0.3333,0.66,0.1045,7,58,65,45,65,65
16280,2012-11-16,Winter,2012,Nov,1,0,Friday,1,Misty,0.3,0.3182,0.65,0.0896,5,16,21,45,21,21
16281,2012-11-16,Winter,2012,Nov,2,0,Friday,1,Misty,0.3,0.303,0.7,0.1642,0,9,9,45,9,9
16282,2012-11-16,Winter,2012,Nov,3,0,Friday,1,Misty,0.3,0.303,0.65,0.1343,0,6,6,45,6,6
16283,2012-11-16,Winter,2012,Nov,4,0,Friday,1,Misty,0.3,0.3182,0.65,0.1045,0,5,5,45,5,5
16284,2012-11-16,Winter,2012,Nov,5,0,Friday,1,Misty,0.3,0.3182,0.65,0.0896,2,34,36,45,36,36
16285,2012-11-16,Winter,2012,Nov,6,0,Friday,1,Misty,0.3,0.3182,0.61,0.0896,4,126,130,45,130,130
16286,2012-11-16,Winter,2012,Nov,7,0,Friday,1,Misty,0.3,0.303,0.61,0.1642,5,362,367,45,367,367
16287,2012-11-16,Winter,2012,Nov,8,0,Friday,1,Misty,0.32,0.3333,0.57,0.1343,17,694,711,45,711,711
16288,2012-11-16,Winter,2012,Nov,9,0,Friday,1,Clear,0.34,0.3485,0.53,0.1045,21,330,351,45,351,351
16289,2012-11-16,Winter,2012,Nov,10,0,Friday,1,Clear,0.34,0.3333,0.53,0.194,33,165,198,45,198,198
16290,2012-11-16,Winter,2012,Nov,11,0,Friday,1,Clear,0.38,0.3939,0.43,0.2239,33,185,218,45,218,218
16291,2012-11-16,Winter,2012,Nov,12,0,Friday,1,Clear,0.4,0.4091,0.43,0.2836,28,262,290,45,290,290
16292,2012-11-16,Winter,2012,Nov,13,0,Friday,1,Clear,0.42,0.4242,0.38,0.194,52,226,278,45,278,278
16293,2012-11-16,Winter,2012,Nov,14,0,Friday,1,Clear,0.42,0.4242,0.35,0.1045,47,204,251,45,251,251
16294,2012-11-16,Winter,2012,Nov,15,0,Friday,1,Clear,0.42,0.4242,0.38,0.1343,30,237,267,45,267,267
16295,2012-11-16,Winter,2012,Nov,16,0,Friday,1,Clear,0.42,0.4242,0.35,0.2836,33,350,383,45,383,383
16296,2012-11-16,Winter,2012,Nov,17,0,Friday,1,Clear,0.36,0.3485,0.46,0.194,41,539,580,45,580,580
16297,2012-11-16,Winter,2012,Nov,18,0,Friday,1,Clear,0.34,0.3333,0.53,0.1642,22,483,505,45,505,505
16298,2012-11-16,Winter,2012,Nov,19,0,Friday,1,Clear,0.36,0.3485,0.46,0.2239,26,306,332,45,332,332
16299,2012-11-16,Winter,2012,Nov,20,0,Friday,1,Clear,0.36,0.3333,0.46,0.2537,20,207,227,45,227,227
16300,2012-11-16,Winter,2012,Nov,21,0,Friday,1,Clear,0.34,0.3333,0.49,0.194,21,157,178,45,178,178
16301,2012-11-16,Winter,2012,Nov,22,0,Friday,1,Clear,0.32,0.303,0.53,0.2537,23,139,162,45,162,162
16302,2012-11-16,Winter,2012,Nov,23,0,Friday,1,Clear,0.32,0.303,0.53,0.2239,14,114,128,45,128,128
16303,2012-11-17,Winter,2012,Nov,0,0,Saturday,0,Clear,0.3,0.303,0.52,0.1642,11,95,106,44,106,106
16304,2012-11-17,Winter,2012,Nov,1,0,Saturday,0,Clear,0.26,0.2576,0.6,0.194,13,74,87,44,87,87
16305,2012-11-17,Winter,2012,Nov,2,0,Saturday,0,Clear,0.26,0.2576,0.65,0.194,8,41,49,44,49,49
16306,2012-11-17,Winter,2012,Nov,3,0,Saturday,0,Clear,0.26,0.2576,0.65,0.194,2,19,21,44,21,21
16307,2012-11-17,Winter,2012,Nov,4,0,Saturday,0,Clear,0.24,0.2273,0.7,0.194,1,6,7,44,7,7
16308,2012-11-17,Winter,2012,Nov,5,0,Saturday,0,Clear,0.24,0.2424,0.7,0.1642,1,10,11,44,11,11
16309,2012-11-17,Winter,2012,Nov,6,0,Saturday,0,Clear,0.24,0.2273,0.7,0.2239,0,21,21,44,21,21
16310,2012-11-17,Winter,2012,Nov,7,0,Saturday,0,Clear,0.24,0.2273,0.7,0.194,8,70,78,44,78,78
16311,2012-11-17,Winter,2012,Nov,8,0,Saturday,0,Clear,0.26,0.2576,0.65,0.2239,30,138,168,44,168,168
16312,2012-11-17,Winter,2012,Nov,9,0,Saturday,0,Clear,0.34,0.3182,0.49,0.2239,48,200,248,44,248,248
16313,2012-11-17,Winter,2012,Nov,10,0,Saturday,0,Clear,0.36,0.3333,0.46,0.2537,62,258,320,44,320,320
16314,2012-11-17,Winter,2012,Nov,11,0,Saturday,0,Clear,0.38,0.3939,0.43,0.194,80,343,423,44,423,423
16315,2012-11-17,Winter,2012,Nov,12,0,Saturday,0,Clear,0.4,0.4091,0.4,0.1642,117,359,476,44,476,476
16316,2012-11-17,Winter,2012,Nov,13,0,Saturday,0,Clear,0.42,0.4242,0.38,0.2537,179,346,525,44,525,525
16317,2012-11-17,Winter,2012,Nov,14,0,Saturday,0,Clear,0.42,0.4242,0.38,0.194,175,380,555,44,555,555
16318,2012-11-17,Winter,2012,Nov,15,0,Saturday,0,Clear,0.42,0.4242,0.35,0.2985,175,374,549,44,549,549
16319,2012-11-17,Winter,2012,Nov,16,0,Saturday,0,Clear,0.4,0.4091,0.4,0.2239,144,325,469,44,469,469
16320,2012-11-17,Winter,2012,Nov,17,0,Saturday,0,Clear,0.38,0.3939,0.4,0.1642,101,302,403,44,403,403
16321,2012-11-17,Winter,2012,Nov,18,0,Saturday,0,Clear,0.36,0.3636,0.5,0.1045,34,237,271,44,271,271
16322,2012-11-17,Winter,2012,Nov,19,0,Saturday,0,Clear,0.34,0.3485,0.53,0.0896,45,208,253,44,253,253
16323,2012-11-17,Winter,2012,Nov,20,0,Saturday,0,Misty,0.34,0.3485,0.66,0.0896,30,142,172,44,172,172
16324,2012-11-17,Winter,2012,Nov,21,0,Saturday,0,Misty,0.32,0.3333,0.57,0.1045,15,124,139,44,139,139
16325,2012-11-17,Winter,2012,Nov,22,0,Saturday,0,Misty,0.32,0.3333,0.57,0.1045,15,130,145,44,145,145
16326,2012-11-17,Winter,2012,Nov,23,0,Saturday,0,Misty,0.3,0.3182,0.7,0.1045,19,114,133,44,133,133
16327,2012-11-18,Winter,2012,Nov,0,0,Sunday,0,Misty,0.3,0.303,0.7,0.1642,11,118,129,43,129,129
16328,2012-11-18,Winter,2012,Nov,1,0,Sunday,0,Clear,0.3,0.2879,0.7,0.194,14,81,95,43,95,95
16329,2012-11-18,Winter,2012,Nov,2,0,Sunday,0,Clear,0.28,0.2879,0.81,0.1045,8,65,73,43,73,73
16330,2012-11-18,Winter,2012,Nov,3,0,Sunday,0,Misty,0.3,0.303,0.81,0.1642,9,37,46,43,46,46
16331,2012-11-18,Winter,2012,Nov,4,0,Sunday,0,Misty,0.3,0.2879,0.81,0.194,4,8,12,43,12,12
16332,2012-11-18,Winter,2012,Nov,5,0,Sunday,0,Clear,0.28,0.2879,0.81,0.1343,5,7,12,43,12,12
16333,2012-11-18,Winter,2012,Nov,6,0,Sunday,0,Clear,0.28,0.2727,0.81,0.1642,2,13,15,43,15,15
16334,2012-11-18,Winter,2012,Nov,7,0,Sunday,0,Clear,0.28,0.2727,0.81,0.194,3,39,42,43,42,42
16335,2012-11-18,Winter,2012,Nov,8,0,Sunday,0,Clear,0.3,0.2879,0.75,0.2537,19,100,119,43,119,119
16336,2012-11-18,Winter,2012,Nov,9,0,Sunday,0,Clear,0.32,0.303,0.7,0.2537,49,155,204,43,204,204
16337,2012-11-18,Winter,2012,Nov,10,0,Sunday,0,Clear,0.34,0.303,0.66,0.2985,79,250,329,43,329,329
16338,2012-11-18,Winter,2012,Nov,11,0,Sunday,0,Clear,0.38,0.3939,0.62,0.2836,92,267,359,43,359,359
16339,2012-11-18,Winter,2012,Nov,12,0,Sunday,0,Clear,0.4,0.4091,0.62,0.2836,101,341,442,43,442,442
16340,2012-11-18,Winter,2012,Nov,13,0,Sunday,0,Clear,0.4,0.4091,0.62,0.3284,113,334,447,43,447,447
16341,2012-11-18,Winter,2012,Nov,14,0,Sunday,0,Clear,0.4,0.4091,0.62,0.2985,125,303,428,43,428,428
16342,2012-11-18,Winter,2012,Nov,15,0,Sunday,0,Clear,0.42,0.4242,0.54,0.2836,89,318,407,43,407,407
16343,2012-11-18,Winter,2012,Nov,16,0,Sunday,0,Misty,0.4,0.4091,0.62,0.3284,59,313,372,43,372,372
16344,2012-11-18,Winter,2012,Nov,17,0,Sunday,0,Misty,0.38,0.3939,0.66,0.2537,48,232,280,43,280,280
16345,2012-11-18,Winter,2012,Nov,18,0,Sunday,0,Clear,0.36,0.3485,0.66,0.2239,36,240,276,43,276,276
16346,2012-11-18,Winter,2012,Nov,19,0,Sunday,0,Clear,0.36,0.3485,0.66,0.1642,16,194,210,43,210,210
16347,2012-11-18,Winter,2012,Nov,20,0,Sunday,0,Clear,0.36,0.3485,0.66,0.1642,9,120,129,43,129,129
16348,2012-11-18,Winter,2012,Nov,21,0,Sunday,0,Clear,0.36,0.3333,0.66,0.2537,17,93,110,43,110,110
16349,2012-11-18,Winter,2012,Nov,22,0,Sunday,0,Misty,0.36,0.3333,0.66,0.2537,8,66,74,43,74,74
16350,2012-11-18,Winter,2012,Nov,23,0,Sunday,0,Clear,0.36,0.3485,0.66,0.2239,6,53,59,43,59,59
16351,2012-11-19,Winter,2012,Nov,0,0,Monday,1,Clear,0.36,0.3485,0.66,0.2239,5,22,27,42,27,27
16352,2012-11-19,Winter,2012,Nov,1,0,Monday,1,Misty,0.36,0.3485,0.66,0.2239,0,19,19,42,19,19
16353,2012-11-19,Winter,2012,Nov,2,0,Monday,1,Misty,0.36,0.3333,0.66,0.2537,0,5,5,42,5,5
16354,2012-11-19,Winter,2012,Nov,3,0,Monday,1,Misty,0.36,0.3485,0.66,0.2239,0,2,2,42,2,2
16355,2012-11-19,Winter,2012,Nov,4,0,Monday,1,Misty,0.36,0.3485,0.66,0.2239,1,11,12,42,12,12
16356,2012-11-19,Winter,2012,Nov,5,0,Monday,1,Misty,0.36,0.3485,0.66,0.2239,1,38,39,42,39,39
16357,2012-11-19,Winter,2012,Nov,6,0,Monday,1,Misty,0.36,0.3333,0.66,0.2537,3,128,131,42,131,131
16358,2012-11-19,Winter,2012,Nov,7,0,Monday,1,Misty,0.36,0.3333,0.66,0.2985,5,381,386,42,386,386
16359,2012-11-19,Winter,2012,Nov,8,0,Monday,1,Misty,0.36,0.3333,0.66,0.2985,13,650,663,42,663,663
16360,2012-11-19,Winter,2012,Nov,9,0,Monday,1,Misty,0.36,0.3333,0.66,0.2537,18,260,278,42,278,278
16361,2012-11-19,Winter,2012,Nov,10,0,Monday,1,Misty,0.36,0.3333,0.66,0.2537,33,106,139,42,139,139
16362,2012-11-19,Winter,2012,Nov,11,0,Monday,1,Misty,0.38,0.3939,0.66,0.2537,33,164,197,42,197,197
16363,2012-11-19,Winter,2012,Nov,12,0,Monday,1,Misty,0.4,0.4091,0.62,0.2836,35,207,242,42,242,242
16364,2012-11-19,Winter,2012,Nov,13,0,Monday,1,Clear,0.44,0.4394,0.54,0.2537,46,205,251,42,251,251
16365,2012-11-19,Winter,2012,Nov,14,0,Monday,1,Clear,0.44,0.4394,0.54,0.2537,47,170,217,42,217,217
16366,2012-11-19,Winter,2012,Nov,15,0,Monday,1,Clear,0.44,0.4394,0.54,0.194,44,213,257,42,257,257
16367,2012-11-19,Winter,2012,Nov,16,0,Monday,1,Clear,0.42,0.4242,0.58,0.2537,55,325,380,42,380,380
16368,2012-11-19,Winter,2012,Nov,17,0,Monday,1,Misty,0.42,0.4242,0.58,0.194,33,586,619,42,619,619
16369,2012-11-19,Winter,2012,Nov,18,0,Monday,1,Misty,0.4,0.4091,0.58,0.2537,21,559,580,42,580,580
16370,2012-11-19,Winter,2012,Nov,19,0,Monday,1,Misty,0.4,0.4091,0.58,0.2836,25,381,406,42,406,406
16371,2012-11-19,Winter,2012,Nov,20,0,Monday,1,Misty,0.38,0.3939,0.62,0.2537,7,252,259,42,259,259
16372,2012-11-19,Winter,2012,Nov,21,0,Monday,1,Misty,0.38,0.3939,0.54,0.2239,15,188,203,42,203,203
16373,2012-11-19,Winter,2012,Nov,22,0,Monday,1,Clear,0.34,0.3485,0.66,0.1045,7,106,113,42,113,113
16374,2012-11-19,Winter,2012,Nov,23,0,Monday,1,Clear,0.34,0.3485,0.66,0.1045,2,72,74,42,74,74
16375,2012-11-20,Winter,2012,Nov,0,0,Tuesday,1,Clear,0.32,0.3333,0.7,0.1343,3,26,29,41,29,29
16376,2012-11-20,Winter,2012,Nov,1,0,Tuesday,1,Clear,0.34,0.3485,0.66,0.1045,3,10,13,41,13,13
16377,2012-11-20,Winter,2012,Nov,2,0,Tuesday,1,Misty,0.32,0.3333,0.76,0.0896,0,5,5,41,5,5
16378,2012-11-20,Winter,2012,Nov,3,0,Tuesday,1,Misty,0.34,0.3485,0.71,0.1045,0,2,2,41,2,2
16379,2012-11-20,Winter,2012,Nov,4,0,Tuesday,1,Misty,0.34,0.3333,0.66,0.194,0,6,6,41,6,6
16380,2012-11-20,Winter,2012,Nov,5,0,Tuesday,1,Misty,0.34,0.3333,0.66,0.1343,2,32,34,41,34,34
16381,2012-11-20,Winter,2012,Nov,6,0,Tuesday,1,Misty,0.34,0.3333,0.71,0.1642,2,146,148,41,148,148
16382,2012-11-20,Winter,2012,Nov,7,0,Tuesday,1,Clear,0.32,0.3333,0.76,0.0896,7,411,418,41,418,418
16383,2012-11-20,Winter,2012,Nov,8,0,Tuesday,1,Clear,0.34,0.3333,0.71,0.1343,16,649,665,41,665,665
16384,2012-11-20,Winter,2012,Nov,9,0,Tuesday,1,Misty,0.36,0.3788,0.71,0.0,28,298,326,41,326,326
16385,2012-11-20,Winter,2012,Nov,10,0,Tuesday,1,Misty,0.4,0.4091,0.66,0.0896,32,144,176,41,176,176
16386,2012-11-20,Winter,2012,Nov,11,0,Tuesday,1,Misty,0.42,0.4242,0.67,0.0896,45,160,205,41,205,205
16387,2012-11-20,Winter,2012,Nov,12,0,Tuesday,1,Misty,0.42,0.4242,0.67,0.0,70,243,313,41,313,313
16388,2012-11-20,Winter,2012,Nov,13,0,Tuesday,1,Misty,0.44,0.4394,0.58,0.0,49,218,267,41,267,267
16389,2012-11-20,Winter,2012,Nov,14,0,Tuesday,1,Misty,0.44,0.4394,0.58,0.1045,47,177,224,41,224,224
16390,2012-11-20,Winter,2012,Nov,15,0,Tuesday,1,Misty,0.46,0.4545,0.55,0.1045,61,226,287,41,287,287
16391,2012-11-20,Winter,2012,Nov,16,0,Tuesday,1,Misty,0.42,0.4242,0.62,0.0896,60,335,395,41,395,395
16392,2012-11-20,Winter,2012,Nov,17,0,Tuesday,1,Misty,0.4,0.4091,0.71,0.1642,37,553,590,41,590,590
16393,2012-11-20,Winter,2012,Nov,18,0,Tuesday,1,Misty,0.4,0.4091,0.66,0.0896,16,534,550,41,550,550
16394,2012-11-20,Winter,2012,Nov,19,0,Tuesday,1,Misty,0.4,0.4091,0.71,0.0,23,361,384,41,384,384
16395,2012-11-20,Winter,2012,Nov,20,0,Tuesday,1,Misty,0.38,0.3939,0.76,0.0,11,224,235,41,235,235
16396,2012-11-20,Winter,2012,Nov,21,0,Tuesday,1,Clear,0.36,0.3788,0.71,0.0,14,143,157,41,157,157
16397,2012-11-20,Winter,2012,Nov,22,0,Tuesday,1,Clear,0.36,0.3788,0.71,0.0,7,115,122,41,122,122
16398,2012-11-20,Winter,2012,Nov,23,0,Tuesday,1,Clear,0.32,0.3333,0.81,0.1045,1,82,83,41,83,83
16399,2012-11-21,Winter,2012,Nov,0,0,Wednesday,1,Clear,0.34,0.3636,0.81,0.0,1,25,26,40,26,26
16400,2012-11-21,Winter,2012,Nov,1,0,Wednesday,1,Clear,0.32,0.3333,0.81,0.1045,1,13,14,40,14,14
16401,2012-11-21,Winter,2012,Nov,2,0,Wednesday,1,Clear,0.28,0.2879,0.87,0.1045,2,6,8,40,8,8
16402,2012-11-21,Winter,2012,Nov,3,0,Wednesday,1,Clear,0.28,0.2879,0.87,0.1045,0,2,2,40,2,2
16403,2012-11-21,Winter,2012,Nov,4,0,Wednesday,1,Clear,0.28,0.2879,0.87,0.1045,0,10,10,40,10,10
16404,2012-11-21,Winter,2012,Nov,5,0,Wednesday,1,Clear,0.28,0.2879,0.87,0.1045,1,28,29,40,29,29
16405,2012-11-21,Winter,2012,Nov,6,0,Wednesday,1,Clear,0.28,0.303,0.87,0.0896,2,99,101,40,101,101
16406,2012-11-21,Winter,2012,Nov,7,0,Wednesday,1,Clear,0.26,0.2879,0.87,0.0896,11,262,273,40,273,273
16407,2012-11-21,Winter,2012,Nov,8,0,Wednesday,1,Misty,0.28,0.303,0.81,0.0896,12,539,551,40,551,551
16408,2012-11-21,Winter,2012,Nov,9,0,Wednesday,1,Clear,0.32,0.3333,0.76,0.0896,45,320,365,40,365,365
16409,2012-11-21,Winter,2012,Nov,10,0,Wednesday,1,Clear,0.36,0.3788,0.62,0.0,22,150,172,40,172,172
16410,2012-11-21,Winter,2012,Nov,11,0,Wednesday,1,Clear,0.4,0.4091,0.5,0.194,43,198,241,40,241,241
16411,2012-11-21,Winter,2012,Nov,12,0,Wednesday,1,Clear,0.44,0.4394,0.41,0.194,74,270,344,40,344,344
16412,2012-11-21,Winter,2012,Nov,13,0,Wednesday,1,Clear,0.44,0.4394,0.35,0.2239,70,295,365,40,365,365
16413,2012-11-21,Winter,2012,Nov,14,0,Wednesday,1,Clear,0.46,0.4545,0.33,0.194,84,329,413,40,413,413
16414,2012-11-21,Winter,2012,Nov,15,0,Wednesday,1,Clear,0.46,0.4545,0.36,0.0896,68,381,449,40,449,449
16415,2012-11-21,Winter,2012,Nov,16,0,Wednesday,1,Clear,0.44,0.4394,0.33,0.1343,59,410,469,40,469,469
16416,2012-11-21,Winter,2012,Nov,17,0,Wednesday,1,Clear,0.4,0.4091,0.4,0.1642,41,333,374,40,374,374
16417,2012-11-21,Winter,2012,Nov,18,0,Wednesday,1,Clear,0.42,0.4242,0.38,0.1045,24,287,311,40,311,311
16418,2012-11-21,Winter,2012,Nov,19,0,Wednesday,1,Clear,0.38,0.3939,0.43,0.194,23,220,243,40,243,243
16419,2012-11-21,Winter,2012,Nov,20,0,Wednesday,1,Clear,0.34,0.3485,0.61,0.1045,11,125,136,40,136,136
16420,2012-11-21,Winter,2012,Nov,21,0,Wednesday,1,Clear,0.36,0.3788,0.5,0.0,8,97,105,40,105,105
16421,2012-11-21,Winter,2012,Nov,22,0,Wednesday,1,Clear,0.34,0.3636,0.49,0.0,6,82,88,40,88,88
16422,2012-11-21,Winter,2012,Nov,23,0,Wednesday,1,Clear,0.32,0.3485,0.61,0.0,7,50,57,40,57,57
16423,2012-11-22,Winter,2012,Nov,0,1,Thursday,0,Clear,0.32,0.3333,0.66,0.0896,3,43,46,39,46,46
16424,2012-11-22,Winter,2012,Nov,1,1,Thursday,0,Clear,0.28,0.303,0.65,0.0896,5,37,42,39,42,42
16425,2012-11-22,Winter,2012,Nov,2,1,Thursday,0,Clear,0.24,0.2576,0.75,0.0896,3,15,18,39,18,18
16426,2012-11-22,Winter,2012,Nov,3,1,Thursday,0,Clear,0.24,0.2576,0.75,0.1045,0,6,6,39,6,6
16427,2012-11-22,Winter,2012,Nov,4,1,Thursday,0,Clear,0.22,0.2273,0.8,0.1343,1,2,3,39,3,3
16428,2012-11-22,Winter,2012,Nov,5,1,Thursday,0,Clear,0.24,0.2576,0.75,0.1045,2,6,8,39,8,8
16429,2012-11-22,Winter,2012,Nov,6,1,Thursday,0,Clear,0.26,0.2727,0.7,0.1045,2,15,17,39,17,17
16430,2012-11-22,Winter,2012,Nov,7,1,Thursday,0,Clear,0.22,0.2273,0.75,0.1343,7,49,56,39,56,56
16431,2012-11-22,Winter,2012,Nov,8,1,Thursday,0,Clear,0.24,0.2424,0.75,0.1343,20,77,97,39,97,97
16432,2012-11-22,Winter,2012,Nov,9,1,Thursday,0,Clear,0.3,0.3333,0.65,0.0,25,94,119,39,119,119
16433,2012-11-22,Winter,2012,Nov,10,1,Thursday,0,Clear,0.36,0.3636,0.57,0.1045,65,154,219,39,219,219
16434,2012-11-22,Winter,2012,Nov,11,1,Thursday,0,Clear,0.42,0.4242,0.41,0.0896,89,143,232,39,232,232
16435,2012-11-22,Winter,2012,Nov,12,1,Thursday,0,Clear,0.44,0.4394,0.35,0.0,117,145,262,39,262,262
16436,2012-11-22,Winter,2012,Nov,13,1,Thursday,0,Clear,0.46,0.4545,0.31,0.0,125,144,269,39,269,269
16437,2012-11-22,Winter,2012,Nov,14,1,Thursday,0,Clear,0.48,0.4697,0.29,0.0,125,95,220,39,220,220
16438,2012-11-22,Winter,2012,Nov,15,1,Thursday,0,Clear,0.48,0.4697,0.29,0.0,132,96,228,39,228,228
16439,2012-11-22,Winter,2012,Nov,16,1,Thursday,0,Clear,0.46,0.4545,0.33,0.0,101,81,182,39,182,182
16440,2012-11-22,Winter,2012,Nov,17,1,Thursday,0,Clear,0.44,0.4394,0.35,0.0,66,43,109,39,109,109
16441,2012-11-22,Winter,2012,Nov,18,1,Thursday,0,Clear,0.4,0.4091,0.43,0.0,16,54,70,39,70,70
16442,2012-11-22,Winter,2012,Nov,19,1,Thursday,0,Clear,0.36,0.3788,0.76,0.0,13,31,44,39,44,44
16443,2012-11-22,Winter,2012,Nov,20,1,Thursday,0,Clear,0.34,0.3636,0.71,0.0,15,37,52,39,52,52
16444,2012-11-22,Winter,2012,Nov,21,1,Thursday,0,Clear,0.34,0.3485,0.61,0.0896,7,39,46,39,46,46
16445,2012-11-22,Winter,2012,Nov,22,1,Thursday,0,Clear,0.32,0.3485,0.61,0.0,8,36,44,39,44,44
16446,2012-11-22,Winter,2012,Nov,23,1,Thursday,0,Clear,0.3,0.3333,0.7,0.0,8,28,36,39,36,36
16447,2012-11-23,Winter,2012,Nov,0,0,Friday,1,Clear,0.28,0.3182,0.65,0.0,0,32,32,38,32,32
16448,2012-11-23,Winter,2012,Nov,1,0,Friday,1,Clear,0.28,0.303,0.81,0.0896,2,11,13,38,13,13
16449,2012-11-23,Winter,2012,Nov,2,0,Friday,1,Clear,0.26,0.2879,0.75,0.0896,1,4,5,38,5,5
16450,2012-11-23,Winter,2012,Nov,3,0,Friday,1,Clear,0.26,0.303,0.7,0.0,1,0,1,38,1,1
16451,2012-11-23,Winter,2012,Nov,4,0,Friday,1,Clear,0.24,0.2576,0.75,0.1045,1,3,4,38,4,4
16452,2012-11-23,Winter,2012,Nov,5,0,Friday,1,Clear,0.24,0.2879,0.81,0.0,0,10,10,38,10,10
16453,2012-11-23,Winter,2012,Nov,6,0,Friday,1,Clear,0.24,0.2879,0.81,0.0,0,20,20,38,20,20
16454,2012-11-23,Winter,2012,Nov,7,0,Friday,1,Clear,0.24,0.2879,0.81,0.0,5,72,77,38,77,77
16455,2012-11-23,Winter,2012,Nov,8,0,Friday,1,Clear,0.24,0.2576,0.87,0.0896,11,83,94,38,94,94
16456,2012-11-23,Winter,2012,Nov,9,0,Friday,1,Clear,0.28,0.2879,0.75,0.1045,32,80,112,38,112,112
16457,2012-11-23,Winter,2012,Nov,10,0,Friday,1,Clear,0.34,0.3333,0.61,0.1642,87,114,201,38,201,201
16458,2012-11-23,Winter,2012,Nov,11,0,Friday,1,Clear,0.4,0.4091,0.5,0.194,121,130,251,38,251,251
16459,2012-11-23,Winter,2012,Nov,12,0,Friday,1,Clear,0.44,0.4394,0.38,0.2537,186,193,379,38,379,379
16460,2012-11-23,Winter,2012,Nov,13,0,Friday,1,Clear,0.46,0.4545,0.38,0.2836,224,200,424,38,424,424
16461,2012-11-23,Winter,2012,Nov,14,0,Friday,1,Clear,0.5,0.4848,0.36,0.2537,240,195,435,38,435,435
16462,2012-11-23,Winter,2012,Nov,15,0,Friday,1,Clear,0.48,0.4697,0.41,0.2537,233,214,447,38,447,447
16463,2012-11-23,Winter,2012,Nov,16,0,Friday,1,Misty,0.48,0.4697,0.41,0.1045,158,199,357,38,357,357
16464,2012-11-23,Winter,2012,Nov,17,0,Friday,1,Misty,0.48,0.4697,0.39,0.0896,117,183,300,38,300,300
16465,2012-11-23,Winter,2012,Nov,18,0,Friday,1,Misty,0.46,0.4545,0.44,0.0,50,158,208,38,208,208
16466,2012-11-23,Winter,2012,Nov,19,0,Friday,1,Misty,0.46,0.4545,0.47,0.1642,33,121,154,38,154,154
16467,2012-11-23,Winter,2012,Nov,20,0,Friday,1,Clear,0.46,0.4545,0.41,0.0896,42,100,142,38,142,142
16468,2012-11-23,Winter,2012,Nov,21,0,Friday,1,Clear,0.46,0.4545,0.47,0.2537,23,75,98,38,98,98
16469,2012-11-23,Winter,2012,Nov,22,0,Friday,1,Clear,0.44,0.4394,0.33,0.5224,16,63,79,38,79,79
16470,2012-11-23,Winter,2012,Nov,23,0,Friday,1,Clear,0.42,0.4242,0.38,0.4478,20,47,67,38,67,67
16471,2012-11-24,Winter,2012,Nov,0,0,Saturday,0,Clear,0.4,0.4091,0.37,0.4179,9,33,42,37,42,42
16472,2012-11-24,Winter,2012,Nov,1,0,Saturday,0,Clear,0.34,0.2879,0.42,0.4925,1,19,20,37,20,20
16473,2012-11-24,Winter,2012,Nov,2,0,Saturday,0,Clear,0.32,0.2727,0.39,0.6119,10,22,32,37,32,32
16474,2012-11-24,Winter,2012,Nov,3,0,Saturday,0,Clear,0.28,0.2576,0.41,0.3582,6,5,11,37,11,11
16475,2012-11-24,Winter,2012,Nov,4,0,Saturday,0,Clear,0.26,0.2121,0.41,0.4478,1,2,3,37,3,3
16476,2012-11-24,Winter,2012,Nov,5,0,Saturday,0,Clear,0.26,0.2273,0.41,0.3284,1,2,3,37,3,3
16477,2012-11-24,Winter,2012,Nov,6,0,Saturday,0,Clear,0.24,0.2121,0.44,0.2836,1,9,10,37,10,10
16478,2012-11-24,Winter,2012,Nov,7,0,Saturday,0,Misty,0.26,0.2273,0.41,0.3284,4,21,25,37,25,25
16479,2012-11-24,Winter,2012,Nov,8,0,Saturday,0,Misty,0.26,0.2121,0.44,0.4627,7,55,62,37,62,62
16480,2012-11-24,Winter,2012,Nov,9,0,Saturday,0,Misty,0.26,0.2121,0.41,0.4478,26,96,122,37,122,122
16481,2012-11-24,Winter,2012,Nov,10,0,Saturday,0,Misty,0.26,0.2273,0.44,0.2985,46,96,142,37,142,142
16482,2012-11-24,Winter,2012,Nov,11,0,Saturday,0,Misty,0.28,0.2576,0.41,0.2985,55,131,186,37,186,186
16483,2012-11-24,Winter,2012,Nov,12,0,Saturday,0,Misty,0.3,0.2576,0.36,0.6119,53,146,199,37,199,199
16484,2012-11-24,Winter,2012,Nov,13,0,Saturday,0,Clear,0.32,0.303,0.36,0.3284,64,161,225,37,225,225
16485,2012-11-24,Winter,2012,Nov,14,0,Saturday,0,Clear,0.32,0.2879,0.33,0.4627,58,149,207,37,207,207
16486,2012-11-24,Winter,2012,Nov,15,0,Saturday,0,Clear,0.3,0.2727,0.36,0.4627,59,139,198,37,198,198
16487,2012-11-24,Winter,2012,Nov,16,0,Saturday,0,Clear,0.28,0.2424,0.38,0.4478,43,127,170,37,170,170
16488,2012-11-24,Winter,2012,Nov,17,0,Saturday,0,Clear,0.26,0.2273,0.41,0.3881,29,97,126,37,126,126
16489,2012-11-24,Winter,2012,Nov,18,0,Saturday,0,Clear,0.26,0.2273,0.38,0.3881,22,123,145,37,145,145
16490,2012-11-24,Winter,2012,Nov,19,0,Saturday,0,Clear,0.26,0.2424,0.41,0.2537,9,74,83,37,83,83
16491,2012-11-24,Winter,2012,Nov,20,0,Saturday,0,Clear,0.24,0.2121,0.44,0.2836,3,55,58,37,58,58
16492,2012-11-24,Winter,2012,Nov,21,0,Saturday,0,Clear,0.24,0.2273,0.44,0.194,9,66,75,37,75,75
16493,2012-11-24,Winter,2012,Nov,22,0,Saturday,0,Clear,0.24,0.2273,0.44,0.2537,7,69,76,37,76,76
16494,2012-11-24,Winter,2012,Nov,23,0,Saturday,0,Clear,0.24,0.2273,0.44,0.194,9,48,57,37,57,57
16495,2012-11-25,Winter,2012,Nov,0,0,Sunday,0,Clear,0.22,0.2121,0.47,0.2537,3,31,34,36,34,34
16496,2012-11-25,Winter,2012,Nov,1,0,Sunday,0,Clear,0.22,0.2273,0.44,0.194,4,32,36,36,36,36
16497,2012-11-25,Winter,2012,Nov,2,0,Sunday,0,Clear,0.22,0.197,0.44,0.3582,1,27,28,36,28,28
16498,2012-11-25,Winter,2012,Nov,3,0,Sunday,0,Clear,0.22,0.2727,0.44,0.0,0,8,8,36,8,8
16499,2012-11-25,Winter,2012,Nov,4,0,Sunday,0,Clear,0.22,0.2727,0.44,0.0,1,1,2,36,2,2
16500,2012-11-25,Winter,2012,Nov,5,0,Sunday,0,Misty,0.22,0.2273,0.47,0.1642,0,3,3,36,3,3
16501,2012-11-25,Winter,2012,Nov,6,0,Sunday,0,Misty,0.22,0.2424,0.47,0.1045,1,10,11,36,11,11
16502,2012-11-25,Winter,2012,Nov,7,0,Sunday,0,Misty,0.22,0.2424,0.51,0.1045,2,19,21,36,21,21
16503,2012-11-25,Winter,2012,Nov,8,0,Sunday,0,Misty,0.22,0.2273,0.51,0.194,2,32,34,36,34,34
16504,2012-11-25,Winter,2012,Nov,9,0,Sunday,0,Misty,0.24,0.2273,0.48,0.2239,13,83,96,36,96,96
16505,2012-11-25,Winter,2012,Nov,10,0,Sunday,0,Clear,0.24,0.2273,0.48,0.2537,15,124,139,36,139,139
16506,2012-11-25,Winter,2012,Nov,11,0,Sunday,0,Misty,0.26,0.2576,0.41,0.2239,49,155,204,36,204,204
16507,2012-11-25,Winter,2012,Nov,12,0,Sunday,0,Misty,0.26,0.2576,0.41,0.2239,37,165,202,36,202,202
16508,2012-11-25,Winter,2012,Nov,13,0,Sunday,0,Misty,0.26,0.2576,0.41,0.1642,37,158,195,36,195,195
16509,2012-11-25,Winter,2012,Nov,14,0,Sunday,0,Misty,0.3,0.2879,0.42,0.2537,33,170,203,36,203,203
16510,2012-11-25,Winter,2012,Nov,15,0,Sunday,0,Clear,0.3,0.2879,0.42,0.2537,36,209,245,36,245,245
16511,2012-11-25,Winter,2012,Nov,16,0,Sunday,0,Clear,0.3,0.2879,0.39,0.2239,25,203,228,36,228,228
16512,2012-11-25,Winter,2012,Nov,17,0,Sunday,0,Clear,0.28,0.2727,0.41,0.1642,11,170,181,36,181,181
16513,2012-11-25,Winter,2012,Nov,18,0,Sunday,0,Clear,0.26,0.2576,0.44,0.1642,9,132,141,36,141,141
16514,2012-11-25,Winter,2012,Nov,19,0,Sunday,0,Clear,0.26,0.303,0.41,0.0,13,114,127,36,127,127
16515,2012-11-25,Winter,2012,Nov,20,0,Sunday,0,Clear,0.24,0.2879,0.6,0.0,9,110,119,36,119,119
16516,2012-11-25,Winter,2012,Nov,21,0,Sunday,0,Clear,0.26,0.303,0.48,0.0,4,60,64,36,64,64
16517,2012-11-25,Winter,2012,Nov,22,0,Sunday,0,Clear,0.24,0.2879,0.6,0.0,3,59,62,36,62,62
16518,2012-11-25,Winter,2012,Nov,23,0,Sunday,0,Clear,0.22,0.2576,0.69,0.0896,1,40,41,36,41,41
16519,2012-11-26,Winter,2012,Nov,0,0,Monday,1,Clear,0.22,0.2727,0.69,0.0,4,19,23,35,23,23
16520,2012-11-26,Winter,2012,Nov,1,0,Monday,1,Clear,0.2,0.2576,0.69,0.0,1,9,10,35,10,10
16521,2012-11-26,Winter,2012,Nov,2,0,Monday,1,Clear,0.2,0.2576,0.69,0.0,0,5,5,35,5,5
16522,2012-11-26,Winter,2012,Nov,3,0,Monday,1,Clear,0.2,0.2576,0.69,0.0,1,4,5,35,5,5
16523,2012-11-26,Winter,2012,Nov,4,0,Monday,1,Clear,0.22,0.2727,0.69,0.0,0,10,10,35,10,10
16524,2012-11-26,Winter,2012,Nov,5,0,Monday,1,Clear,0.22,0.2273,0.69,0.1642,0,41,41,35,41,41
16525,2012-11-26,Winter,2012,Nov,6,0,Monday,1,Clear,0.22,0.2727,0.69,0.0,1,123,124,35,124,124
16526,2012-11-26,Winter,2012,Nov,7,0,Monday,1,Clear,0.24,0.2879,0.65,0.0,2,363,365,35,365,365
16527,2012-11-26,Winter,2012,Nov,8,0,Monday,1,Clear,0.24,0.2879,0.65,0.0,9,629,638,35,638,638
16528,2012-11-26,Winter,2012,Nov,9,0,Monday,1,Clear,0.28,0.303,0.56,0.0896,10,276,286,35,286,286
16529,2012-11-26,Winter,2012,Nov,10,0,Monday,1,Clear,0.32,0.3485,0.49,0.0,20,127,147,35,147,147
16530,2012-11-26,Winter,2012,Nov,11,0,Monday,1,Clear,0.4,0.4091,0.37,0.2985,18,112,130,35,130,130
16531,2012-11-26,Winter,2012,Nov,12,0,Monday,1,Clear,0.42,0.4242,0.35,0.1045,22,188,210,35,210,210
16532,2012-11-26,Winter,2012,Nov,13,0,Monday,1,Clear,0.42,0.4242,0.35,0.1045,20,197,217,35,217,217
16533,2012-11-26,Winter,2012,Nov,14,0,Monday,1,Clear,0.42,0.4242,0.35,0.0,51,177,228,35,228,228
16534,2012-11-26,Winter,2012,Nov,15,0,Monday,1,Clear,0.42,0.4242,0.35,0.0896,49,181,230,35,230,230
16535,2012-11-26,Winter,2012,Nov,16,0,Monday,1,Clear,0.44,0.4394,0.3,0.0,49,297,346,35,346,346
16536,2012-11-26,Winter,2012,Nov,17,0,Monday,1,Clear,0.42,0.4242,0.32,0.0,13,540,553,35,553,553
16537,2012-11-26,Winter,2012,Nov,18,0,Monday,1,Clear,0.36,0.3485,0.5,0.1642,19,502,521,35,521,521
16538,2012-11-26,Winter,2012,Nov,19,0,Monday,1,Clear,0.34,0.3636,0.53,0.0,16,355,371,35,371,371
16539,2012-11-26,Winter,2012,Nov,20,0,Monday,1,Clear,0.34,0.3636,0.49,0.0,12,265,277,35,277,277
16540,2012-11-26,Winter,2012,Nov,21,0,Monday,1,Clear,0.34,0.3636,0.49,0.0,9,172,181,35,181,181
16541,2012-11-26,Winter,2012,Nov,22,0,Monday,1,Clear,0.32,0.3485,0.61,0.0,3,101,104,35,104,104
16542,2012-11-26,Winter,2012,Nov,23,0,Monday,1,Misty,0.32,0.3333,0.66,0.1045,8,57,65,35,65,65
16543,2012-11-27,Winter,2012,Nov,0,0,Tuesday,1,Misty,0.32,0.3333,0.66,0.0896,2,24,26,34,26,26
16544,2012-11-27,Winter,2012,Nov,1,0,Tuesday,1,Misty,0.32,0.3333,0.7,0.1343,0,6,6,34,6,6
16545,2012-11-27,Winter,2012,Nov,2,0,Tuesday,1,Misty,0.32,0.3182,0.7,0.1642,0,5,5,34,5,5
16546,2012-11-27,Winter,2012,Nov,3,0,Tuesday,1,Light_rainsnow,0.32,0.3333,0.7,0.1343,1,3,4,34,4,4
16547,2012-11-27,Winter,2012,Nov,4,0,Tuesday,1,Light_rainsnow,0.3,0.2879,0.81,0.194,0,5,5,34,5,5
16548,2012-11-27,Winter,2012,Nov,5,0,Tuesday,1,Misty,0.3,0.2879,0.81,0.2239,0,31,31,34,31,31
16549,2012-11-27,Winter,2012,Nov,6,0,Tuesday,1,Misty,0.3,0.303,0.81,0.1642,3,97,100,34,100,100
16550,2012-11-27,Winter,2012,Nov,7,0,Tuesday,1,Light_rainsnow,0.3,0.303,0.81,0.1343,4,289,293,34,293,293
16551,2012-11-27,Winter,2012,Nov,8,0,Tuesday,1,Light_rainsnow,0.32,0.3182,0.81,0.1642,6,494,500,34,500,500
16552,2012-11-27,Winter,2012,Nov,9,0,Tuesday,1,Misty,0.32,0.3333,0.81,0.1343,11,257,268,34,268,268
16553,2012-11-27,Winter,2012,Nov,10,0,Tuesday,1,Light_rainsnow,0.32,0.3182,0.81,0.194,5,52,57,34,57,57
16554,2012-11-27,Winter,2012,Nov,11,0,Tuesday,1,Light_rainsnow,0.3,0.2727,0.87,0.2985,6,59,65,34,65,65
16555,2012-11-27,Winter,2012,Nov,12,0,Tuesday,1,Light_rainsnow,0.28,0.2576,0.87,0.3881,6,70,76,34,76,76
16556,2012-11-27,Winter,2012,Nov,13,0,Tuesday,1,Light_rainsnow,0.28,0.2727,0.87,0.2537,4,73,77,34,77,77
16557,2012-11-27,Winter,2012,Nov,14,0,Tuesday,1,Light_rainsnow,0.28,0.2576,0.87,0.3582,8,86,94,34,94,94
16558,2012-11-27,Winter,2012,Nov,15,0,Tuesday,1,Misty,0.3,0.2727,0.75,0.2985,9,146,155,34,155,155
16559,2012-11-27,Winter,2012,Nov,16,0,Tuesday,1,Misty,0.3,0.2727,0.75,0.2985,5,252,257,34,257,257
16560,2012-11-27,Winter,2012,Nov,17,0,Tuesday,1,Misty,0.3,0.2727,0.75,0.3881,13,514,527,34,527,527
16561,2012-11-27,Winter,2012,Nov,18,0,Tuesday,1,Clear,0.26,0.2273,0.81,0.3582,13,469,482,34,482,482
16562,2012-11-27,Winter,2012,Nov,19,0,Tuesday,1,Clear,0.26,0.2576,0.73,0.2985,12,338,350,34,350,350
16563,2012-11-27,Winter,2012,Nov,20,0,Tuesday,1,Clear,0.26,0.2273,0.75,0.3284,4,228,232,34,232,232
16564,2012-11-27,Winter,2012,Nov,21,0,Tuesday,1,Clear,0.24,0.2121,0.81,0.2836,6,179,185,34,185,185
16565,2012-11-27,Winter,2012,Nov,22,0,Tuesday,1,Clear,0.24,0.2424,0.81,0.1642,2,95,97,34,97,97
16566,2012-11-27,Winter,2012,Nov,23,0,Tuesday,1,Misty,0.26,0.2424,0.81,0.2537,3,64,67,34,67,67
16567,2012-11-28,Winter,2012,Nov,0,0,Wednesday,1,Misty,0.26,0.2424,0.75,0.2537,1,22,23,33,23,23
16568,2012-11-28,Winter,2012,Nov,1,0,Wednesday,1,Misty,0.26,0.2576,0.75,0.2239,0,12,12,33,12,12
16569,2012-11-28,Winter,2012,Nov,2,0,Wednesday,1,Misty,0.26,0.2576,0.75,0.2239,0,1,1,33,1,1
16570,2012-11-28,Winter,2012,Nov,3,0,Wednesday,1,Misty,0.26,0.2576,0.7,0.2239,0,3,3,33,3,3
16571,2012-11-28,Winter,2012,Nov,4,0,Wednesday,1,Misty,0.26,0.2576,0.7,0.194,0,4,4,33,4,4
16572,2012-11-28,Winter,2012,Nov,5,0,Wednesday,1,Misty,0.26,0.2727,0.7,0.1343,0,39,39,33,39,39
16573,2012-11-28,Winter,2012,Nov,6,0,Wednesday,1,Misty,0.26,0.2576,0.65,0.2239,4,132,136,33,136,136
16574,2012-11-28,Winter,2012,Nov,7,0,Wednesday,1,Misty,0.26,0.2576,0.56,0.194,6,403,409,33,409,409
16575,2012-11-28,Winter,2012,Nov,8,0,Wednesday,1,Clear,0.24,0.2121,0.6,0.2836,9,683,692,33,692,692
16576,2012-11-28,Winter,2012,Nov,9,0,Wednesday,1,Clear,0.28,0.2727,0.52,0.194,13,309,322,33,322,322
16577,2012-11-28,Winter,2012,Nov,10,0,Wednesday,1,Clear,0.3,0.3182,0.49,0.1045,17,144,161,33,161,161
16578,2012-11-28,Winter,2012,Nov,11,0,Wednesday,1,Clear,0.32,0.3182,0.45,0.1642,19,127,146,33,146,146
16579,2012-11-28,Winter,2012,Nov,12,0,Wednesday,1,Clear,0.34,0.303,0.42,0.3881,19,189,208,33,208,208
16580,2012-11-28,Winter,2012,Nov,13,0,Wednesday,1,Clear,0.34,0.3333,0.42,0.194,21,193,214,33,214,214
16581,2012-11-28,Winter,2012,Nov,14,0,Wednesday,1,Clear,0.36,0.3333,0.4,0.2985,15,161,176,33,176,176
16582,2012-11-28,Winter,2012,Nov,15,0,Wednesday,1,Clear,0.36,0.3333,0.32,0.3284,7,172,179,33,179,179
16583,2012-11-28,Winter,2012,Nov,16,0,Wednesday,1,Clear,0.36,0.3333,0.29,0.2537,9,316,325,33,325,325
16584,2012-11-28,Winter,2012,Nov,17,0,Wednesday,1,Clear,0.34,0.3333,0.31,0.1343,17,546,563,33,563,563
16585,2012-11-28,Winter,2012,Nov,18,0,Wednesday,1,Clear,0.32,0.303,0.33,0.2836,12,530,542,33,542,542
16586,2012-11-28,Winter,2012,Nov,19,0,Wednesday,1,Clear,0.32,0.3182,0.36,0.1642,9,378,387,33,387,387
16587,2012-11-28,Winter,2012,Nov,20,0,Wednesday,1,Clear,0.32,0.3333,0.36,0.1343,5,258,263,33,263,263
16588,2012-11-28,Winter,2012,Nov,21,0,Wednesday,1,Clear,0.3,0.303,0.39,0.1642,4,219,223,33,223,223
16589,2012-11-28,Winter,2012,Nov,22,0,Wednesday,1,Clear,0.28,0.2727,0.45,0.1642,6,148,154,33,154,154
16590,2012-11-28,Winter,2012,Nov,23,0,Wednesday,1,Clear,0.26,0.2727,0.48,0.1343,5,73,78,33,78,78
16591,2012-11-29,Winter,2012,Nov,0,0,Thursday,1,Clear,0.24,0.2576,0.56,0.0896,4,25,29,32,29,29
16592,2012-11-29,Winter,2012,Nov,1,0,Thursday,1,Clear,0.22,0.2576,0.64,0.0896,1,15,16,32,16,16
16593,2012-11-29,Winter,2012,Nov,2,0,Thursday,1,Clear,0.22,0.2727,0.64,0.0,1,6,7,32,7,7
16594,2012-11-29,Winter,2012,Nov,4,0,Thursday,1,Clear,0.2,0.2273,0.75,0.0896,0,7,7,32,7,7
16595,2012-11-29,Winter,2012,Nov,5,0,Thursday,1,Clear,0.2,0.2576,0.69,0.0,0,42,42,32,42,42
16596,2012-11-29,Winter,2012,Nov,6,0,Thursday,1,Clear,0.22,0.2727,0.69,0.0,1,120,121,32,121,121
16597,2012-11-29,Winter,2012,Nov,7,0,Thursday,1,Clear,0.2,0.2576,0.64,0.0,8,354,362,32,362,362
16598,2012-11-29,Winter,2012,Nov,8,0,Thursday,1,Clear,0.2,0.2273,0.69,0.1045,15,664,679,32,679,679
16599,2012-11-29,Winter,2012,Nov,9,0,Thursday,1,Clear,0.24,0.2879,0.6,0.0,13,286,299,32,299,299
16600,2012-11-29,Winter,2012,Nov,10,0,Thursday,1,Clear,0.28,0.303,0.65,0.0896,25,153,178,32,178,178
16601,2012-11-29,Winter,2012,Nov,11,0,Thursday,1,Clear,0.36,0.3485,0.37,0.2239,13,150,163,32,163,163
16602,2012-11-29,Winter,2012,Nov,12,0,Thursday,1,Clear,0.36,0.3485,0.4,0.1642,11,225,236,32,236,236
16603,2012-11-29,Winter,2012,Nov,13,0,Thursday,1,Clear,0.38,0.3939,0.32,0.1343,15,209,224,32,224,224
16604,2012-11-29,Winter,2012,Nov,14,0,Thursday,1,Clear,0.36,0.3485,0.43,0.2239,13,174,187,32,187,187
16605,2012-11-29,Winter,2012,Nov,15,0,Thursday,1,Clear,0.36,0.3333,0.43,0.2836,19,201,220,32,220,220
16606,2012-11-29,Winter,2012,Nov,16,0,Thursday,1,Clear,0.36,0.3485,0.4,0.2239,24,346,370,32,370,370
16607,2012-11-29,Winter,2012,Nov,17,0,Thursday,1,Clear,0.34,0.3333,0.39,0.194,17,544,561,32,561,561
16608,2012-11-29,Winter,2012,Nov,18,0,Thursday,1,Clear,0.32,0.3182,0.49,0.1642,17,520,537,32,537,537
16609,2012-11-29,Winter,2012,Nov,19,0,Thursday,1,Clear,0.3,0.2879,0.52,0.194,18,326,344,32,344,344
16610,2012-11-29,Winter,2012,Nov,20,0,Thursday,1,Clear,0.3,0.303,0.52,0.1642,11,241,252,32,252,252
16611,2012-11-29,Winter,2012,Nov,21,0,Thursday,1,Clear,0.26,0.2727,0.65,0.1343,7,201,208,32,208,208
16612,2012-11-29,Winter,2012,Nov,22,0,Thursday,1,Clear,0.26,0.2879,0.7,0.0896,4,147,151,32,151,151
16613,2012-11-29,Winter,2012,Nov,23,0,Thursday,1,Clear,0.28,0.3182,0.61,0.0,6,124,130,32,130,130
16614,2012-11-30,Winter,2012,Nov,0,0,Friday,1,Clear,0.26,0.2576,0.7,0.1642,4,48,52,31,52,52
16615,2012-11-30,Winter,2012,Nov,1,0,Friday,1,Clear,0.24,0.2576,0.7,0.0896,2,17,19,31,19,19
16616,2012-11-30,Winter,2012,Nov,2,0,Friday,1,Clear,0.24,0.2879,0.75,0.0,2,10,12,31,12,12
16617,2012-11-30,Winter,2012,Nov,3,0,Friday,1,Clear,0.24,0.2879,0.75,0.0,0,4,4,31,4,4
16618,2012-11-30,Winter,2012,Nov,4,0,Friday,1,Clear,0.22,0.2727,0.75,0.0,0,3,3,31,3,3
16619,2012-11-30,Winter,2012,Nov,5,0,Friday,1,Clear,0.2,0.2576,0.8,0.0,1,39,40,31,40,40
16620,2012-11-30,Winter,2012,Nov,6,0,Friday,1,Clear,0.2,0.2576,0.86,0.0,2,104,106,31,106,106
16621,2012-11-30,Winter,2012,Nov,7,0,Friday,1,Clear,0.22,0.2727,0.8,0.0,6,346,352,31,352,352
16622,2012-11-30,Winter,2012,Nov,8,0,Friday,1,Misty,0.22,0.2576,0.8,0.0896,20,709,729,31,729,729
16623,2012-11-30,Winter,2012,Nov,9,0,Friday,1,Clear,0.24,0.2576,0.75,0.0896,17,313,330,31,330,330
16624,2012-11-30,Winter,2012,Nov,10,0,Friday,1,Misty,0.3,0.3333,0.65,0.0,10,159,169,31,169,169
16625,2012-11-30,Winter,2012,Nov,11,0,Friday,1,Misty,0.34,0.3485,0.53,0.0896,31,170,201,31,201,201
16626,2012-11-30,Winter,2012,Nov,12,0,Friday,1,Misty,0.38,0.3939,0.46,0.0,25,243,268,31,268,268
16627,2012-11-30,Winter,2012,Nov,13,0,Friday,1,Misty,0.4,0.4091,0.4,0.1642,21,241,262,31,262,262
16628,2012-11-30,Winter,2012,Nov,14,0,Friday,1,Misty,0.4,0.4091,0.4,0.1045,26,225,251,31,251,251
16629,2012-11-30,Winter,2012,Nov,15,0,Friday,1,Misty,0.42,0.4242,0.38,0.1045,34,262,296,31,296,296
16630,2012-11-30,Winter,2012,Nov,16,0,Friday,1,Clear,0.4,0.4091,0.43,0.1343,37,368,405,31,405,405
16631,2012-11-30,Winter,2012,Nov,17,0,Friday,1,Clear,0.36,0.3485,0.5,0.194,31,551,582,31,582,582
16632,2012-11-30,Winter,2012,Nov,18,0,Friday,1,Misty,0.34,0.3636,0.61,0.0,20,489,509,31,509,509
16633,2012-11-30,Winter,2012,Nov,19,0,Friday,1,Clear,0.32,0.3485,0.66,0.0,18,359,377,31,377,377
16634,2012-11-30,Winter,2012,Nov,20,0,Friday,1,Clear,0.32,0.3485,0.66,0.0,12,233,245,31,245,245
16635,2012-11-30,Winter,2012,Nov,21,0,Friday,1,Clear,0.3,0.3182,0.75,0.0896,14,169,183,31,183,183
16636,2012-11-30,Winter,2012,Nov,22,0,Friday,1,Clear,0.3,0.3333,0.75,0.0,18,145,163,31,163,163
16637,2012-11-30,Winter,2012,Nov,23,0,Friday,1,Misty,0.3,0.3182,0.75,0.0896,11,99,110,31,110,110
16638,2012-12-01,Winter,2012,Dec,0,0,Saturday,0,Clear,0.26,0.303,0.81,0.0,9,99,108,30,108,108
16639,2012-12-01,Winter,2012,Dec,1,0,Saturday,0,Clear,0.26,0.303,0.81,0.0,5,64,69,30,69,69
16640,2012-12-01,Winter,2012,Dec,2,0,Saturday,0,Misty,0.26,0.303,0.81,0.0,3,47,50,30,50,50
16641,2012-12-01,Winter,2012,Dec,3,0,Saturday,0,Misty,0.26,0.2727,0.81,0.1343,1,14,15,30,15,15
16642,2012-12-01,Winter,2012,Dec,4,0,Saturday,0,Clear,0.26,0.2879,0.81,0.0896,0,5,5,30,5,5
16643,2012-12-01,Winter,2012,Dec,5,0,Saturday,0,Clear,0.24,0.2576,0.87,0.0896,1,12,13,30,13,13
16644,2012-12-01,Winter,2012,Dec,6,0,Saturday,0,Clear,0.24,0.2424,0.87,0.1343,7,20,27,30,27,27
16645,2012-12-01,Winter,2012,Dec,7,0,Saturday,0,Misty,0.24,0.2424,0.87,0.1343,7,56,63,30,63,63
16646,2012-12-01,Winter,2012,Dec,8,0,Saturday,0,Misty,0.24,0.2424,0.87,0.1343,11,133,144,30,144,144
16647,2012-12-01,Winter,2012,Dec,9,0,Saturday,0,Misty,0.26,0.2424,0.93,0.2537,34,159,193,30,193,193
16648,2012-12-01,Winter,2012,Dec,10,0,Saturday,0,Misty,0.28,0.2727,0.89,0.1642,45,211,256,30,256,256
16649,2012-12-01,Winter,2012,Dec,11,0,Saturday,0,Misty,0.32,0.3333,0.76,0.1045,74,318,392,30,392,392
16650,2012-12-01,Winter,2012,Dec,12,0,Saturday,0,Misty,0.32,0.3333,0.81,0.0896,119,327,446,30,446,446
16651,2012-12-01,Winter,2012,Dec,13,0,Saturday,0,Misty,0.34,0.3636,0.76,0.0,123,386,509,30,509,509
16652,2012-12-01,Winter,2012,Dec,14,0,Saturday,0,Misty,0.36,0.3788,0.71,0.0,110,369,479,30,479,479
16653,2012-12-01,Winter,2012,Dec,15,0,Saturday,0,Misty,0.4,0.4091,0.62,0.0,113,371,484,30,484,484
16654,2012-12-01,Winter,2012,Dec,16,0,Saturday,0,Misty,0.38,0.3939,0.66,0.0,89,354,443,30,443,443
16655,2012-12-01,Winter,2012,Dec,17,0,Saturday,0,Misty,0.34,0.3485,0.76,0.1045,50,270,320,30,320,320
16656,2012-12-01,Winter,2012,Dec,18,0,Saturday,0,Misty,0.34,0.3636,0.76,0.0,42,255,297,30,297,297
16657,2012-12-01,Winter,2012,Dec,19,0,Saturday,0,Misty,0.32,0.3485,0.81,0.0,30,219,249,30,249,249
16658,2012-12-01,Winter,2012,Dec,20,0,Saturday,0,Clear,0.32,0.3485,0.81,0.0,28,170,198,30,198,198
16659,2012-12-01,Winter,2012,Dec,21,0,Saturday,0,Misty,0.3,0.3333,0.87,0.0,23,135,158,30,158,158
16660,2012-12-01,Winter,2012,Dec,22,0,Saturday,0,Misty,0.3,0.3333,0.87,0.0,17,130,147,30,147,147
16661,2012-12-01,Winter,2012,Dec,23,0,Saturday,0,Misty,0.32,0.3485,0.81,0.0,10,116,126,30,126,126
16662,2012-12-02,Winter,2012,Dec,0,0,Sunday,0,Misty,0.3,0.3182,0.87,0.0896,9,108,117,29,117,117
16663,2012-12-02,Winter,2012,Dec,1,0,Sunday,0,Misty,0.3,0.3182,0.87,0.0896,10,84,94,29,94,94
16664,2012-12-02,Winter,2012,Dec,2,0,Sunday,0,Misty,0.3,0.3333,0.87,0.0,2,72,74,29,74,74
16665,2012-12-02,Winter,2012,Dec,3,0,Sunday,0,Misty,0.26,0.303,0.93,0.0,4,21,25,29,25,25
16666,2012-12-02,Winter,2012,Dec,4,0,Sunday,0,Misty,0.26,0.303,0.93,0.0,1,6,7,29,7,7
16667,2012-12-02,Winter,2012,Dec,5,0,Sunday,0,Misty,0.26,0.303,0.93,0.0,1,7,8,29,8,8
16668,2012-12-02,Winter,2012,Dec,6,0,Sunday,0,Misty,0.24,0.2424,0.93,0.1343,1,15,16,29,16,16
16669,2012-12-02,Winter,2012,Dec,7,0,Sunday,0,Misty,0.24,0.2424,0.93,0.1343,5,26,31,29,31,31
16670,2012-12-02,Winter,2012,Dec,8,0,Sunday,0,Misty,0.26,0.2879,0.93,0.0896,12,81,93,29,93,93
16671,2012-12-02,Winter,2012,Dec,9,0,Sunday,0,Misty,0.28,0.2727,0.93,0.1642,37,135,172,29,172,172
16672,2012-12-02,Winter,2012,Dec,10,0,Sunday,0,Misty,0.3,0.3333,0.87,0.0,63,230,293,29,293,293
16673,2012-12-02,Winter,2012,Dec,11,0,Sunday,0,Misty,0.32,0.3182,0.81,0.1642,81,274,355,29,355,355
16674,2012-12-02,Winter,2012,Dec,12,0,Sunday,0,Misty,0.34,0.3333,0.81,0.1642,111,409,520,29,520,520
16675,2012-12-02,Winter,2012,Dec,13,0,Sunday,0,Clear,0.4,0.4091,0.71,0.2239,84,347,431,29,431,431
16676,2012-12-02,Winter,2012,Dec,14,0,Sunday,0,Clear,0.44,0.4394,0.62,0.2537,142,331,473,29,473,473
16677,2012-12-02,Winter,2012,Dec,15,0,Sunday,0,Clear,0.44,0.4394,0.67,0.1343,106,311,417,29,417,417
16678,2012-12-02,Winter,2012,Dec,16,0,Sunday,0,Misty,0.44,0.4394,0.67,0.1045,85,358,443,29,443,443
16679,2012-12-02,Winter,2012,Dec,17,0,Sunday,0,Light_rainsnow,0.4,0.4091,0.76,0.194,59,244,303,29,303,303
16680,2012-12-02,Winter,2012,Dec,18,0,Sunday,0,Misty,0.44,0.4394,0.72,0.1045,25,178,203,29,203,203
16681,2012-12-02,Winter,2012,Dec,19,0,Sunday,0,Misty,0.4,0.4091,0.82,0.194,16,158,174,29,174,174
16682,2012-12-02,Winter,2012,Dec,20,0,Sunday,0,Misty,0.42,0.4242,0.82,0.194,12,142,154,29,154,154
16683,2012-12-02,Winter,2012,Dec,21,0,Sunday,0,Misty,0.44,0.4394,0.77,0.2239,8,91,99,29,99,99
16684,2012-12-02,Winter,2012,Dec,22,0,Sunday,0,Misty,0.44,0.4394,0.77,0.194,11,85,96,29,96,96
16685,2012-12-02,Winter,2012,Dec,23,0,Sunday,0,Misty,0.42,0.4242,0.82,0.1343,7,44,51,29,51,51
16686,2012-12-03,Winter,2012,Dec,0,0,Monday,1,Misty,0.42,0.4242,0.82,0.1642,3,18,21,28,21,21
16687,2012-12-03,Winter,2012,Dec,1,0,Monday,1,Clear,0.4,0.4091,0.82,0.1343,2,11,13,28,13,13
16688,2012-12-03,Winter,2012,Dec,2,0,Monday,1,Clear,0.42,0.4242,0.77,0.1642,1,9,10,28,10,10
16689,2012-12-03,Winter,2012,Dec,3,0,Monday,1,Clear,0.38,0.3939,0.87,0.0,2,6,8,28,8,8
16690,2012-12-03,Winter,2012,Dec,4,0,Monday,1,Clear,0.36,0.3788,0.93,0.0,1,4,5,28,5,5
16691,2012-12-03,Winter,2012,Dec,5,0,Monday,1,Clear,0.34,0.3485,0.93,0.0896,0,38,38,28,38,38
16692,2012-12-03,Winter,2012,Dec,6,0,Monday,1,Clear,0.36,0.3788,0.93,0.0,2,136,138,28,138,138
16693,2012-12-03,Winter,2012,Dec,7,0,Monday,1,Misty,0.34,0.3636,0.93,0.0,9,387,396,28,396,396
16694,2012-12-03,Winter,2012,Dec,8,0,Monday,1,Clear,0.36,0.3788,0.93,0.0,19,712,731,28,731,731
16695,2012-12-03,Winter,2012,Dec,9,0,Monday,1,Clear,0.4,0.4091,0.87,0.0896,19,289,308,28,308,308
16696,2012-12-03,Winter,2012,Dec,10,0,Monday,1,Clear,0.44,0.4394,0.77,0.1343,31,105,136,28,136,136
16697,2012-12-03,Winter,2012,Dec,11,0,Monday,1,Clear,0.48,0.4697,0.77,0.1343,51,182,233,28,233,233
16698,2012-12-03,Winter,2012,Dec,12,0,Monday,1,Clear,0.52,0.5,0.68,0.1642,40,228,268,28,268,268
16699,2012-12-03,Winter,2012,Dec,13,0,Monday,1,Clear,0.58,0.5455,0.56,0.0896,81,240,321,28,321,321
16700,2012-12-03,Winter,2012,Dec,14,0,Monday,1,Clear,0.6,0.6212,0.53,0.0,51,209,260,28,260,260
16701,2012-12-03,Winter,2012,Dec,15,0,Monday,1,Clear,0.6,0.6212,0.56,0.0,58,210,268,28,268,268
16702,2012-12-03,Winter,2012,Dec,16,0,Monday,1,Clear,0.6,0.6212,0.53,0.1343,45,397,442,28,442,442
16703,2012-12-03,Winter,2012,Dec,17,0,Monday,1,Clear,0.52,0.5,0.63,0.1045,43,665,708,28,708,708
16704,2012-12-03,Winter,2012,Dec,18,0,Monday,1,Clear,0.5,0.4848,0.68,0.0896,26,666,692,28,692,692
16705,2012-12-03,Winter,2012,Dec,19,0,Monday,1,Clear,0.5,0.4848,0.68,0.0896,27,444,471,28,471,471
16706,2012-12-03,Winter,2012,Dec,20,0,Monday,1,Misty,0.46,0.4545,0.77,0.0,16,284,300,28,300,300
16707,2012-12-03,Winter,2012,Dec,21,0,Monday,1,Clear,0.44,0.4394,0.82,0.194,14,207,221,28,221,221
16708,2012-12-03,Winter,2012,Dec,22,0,Monday,1,Clear,0.42,0.4242,0.82,0.1045,5,139,144,28,144,144
16709,2012-12-03,Winter,2012,Dec,23,0,Monday,1,Clear,0.42,0.4242,0.82,0.1045,9,93,102,28,102,102
16710,2012-12-04,Winter,2012,Dec,0,0,Tuesday,1,Clear,0.42,0.4242,0.88,0.1045,6,49,55,27,55,55
16711,2012-12-04,Winter,2012,Dec,1,0,Tuesday,1,Clear,0.42,0.4242,0.82,0.1045,3,22,25,27,25,25
16712,2012-12-04,Winter,2012,Dec,2,0,Tuesday,1,Clear,0.42,0.4242,0.88,0.0896,3,5,8,27,8,8
16713,2012-12-04,Winter,2012,Dec,3,0,Tuesday,1,Misty,0.4,0.4091,0.87,0.1343,1,3,4,27,4,4
16714,2012-12-04,Winter,2012,Dec,4,0,Tuesday,1,Misty,0.4,0.4091,0.87,0.1343,0,7,7,27,7,7
16715,2012-12-04,Winter,2012,Dec,5,0,Tuesday,1,Misty,0.44,0.4394,0.88,0.0,1,45,46,27,46,46
16716,2012-12-04,Winter,2012,Dec,6,0,Tuesday,1,Misty,0.36,0.3788,0.93,0.0,3,150,153,27,153,153
16717,2012-12-04,Winter,2012,Dec,7,0,Tuesday,1,Clear,0.42,0.4242,0.88,0.1343,7,495,502,27,502,502
16718,2012-12-04,Winter,2012,Dec,8,0,Tuesday,1,Misty,0.44,0.4394,0.88,0.1642,21,700,721,27,721,721
16719,2012-12-04,Winter,2012,Dec,9,0,Tuesday,1,Clear,0.46,0.4545,0.82,0.1045,19,317,336,27,336,336
16720,2012-12-04,Winter,2012,Dec,10,0,Tuesday,1,Clear,0.46,0.4545,0.82,0.194,26,130,156,27,156,156
16721,2012-12-04,Winter,2012,Dec,11,0,Tuesday,1,Clear,0.48,0.4697,0.77,0.194,24,183,207,27,207,207
16722,2012-12-04,Winter,2012,Dec,12,0,Tuesday,1,Clear,0.52,0.5,0.68,0.194,39,273,312,27,312,312
16723,2012-12-04,Winter,2012,Dec,13,0,Tuesday,1,Misty,0.54,0.5152,0.64,0.1642,39,233,272,27,272,272
16724,2012-12-04,Winter,2012,Dec,14,0,Tuesday,1,Misty,0.58,0.5455,0.56,0.2239,39,231,270,27,270,270
16725,2012-12-04,Winter,2012,Dec,15,0,Tuesday,1,Misty,0.6,0.6212,0.49,0.2537,56,244,300,27,300,300
16726,2012-12-04,Winter,2012,Dec,16,0,Tuesday,1,Clear,0.58,0.5455,0.49,0.2836,44,391,435,27,435,435
16727,2012-12-04,Winter,2012,Dec,17,0,Tuesday,1,Clear,0.52,0.5,0.59,0.2239,43,700,743,27,743,743
16728,2012-12-04,Winter,2012,Dec,18,0,Tuesday,1,Clear,0.5,0.4848,0.63,0.2239,38,693,731,27,731,731
16729,2012-12-04,Winter,2012,Dec,19,0,Tuesday,1,Clear,0.48,0.4697,0.67,0.2239,46,414,460,27,460,460
16730,2012-12-04,Winter,2012,Dec,20,0,Tuesday,1,Misty,0.5,0.4848,0.63,0.2239,34,272,306,27,306,306
16731,2012-12-04,Winter,2012,Dec,21,0,Tuesday,1,Misty,0.5,0.4848,0.63,0.2537,28,252,280,27,280,280
16732,2012-12-04,Winter,2012,Dec,22,0,Tuesday,1,Misty,0.5,0.4848,0.63,0.2985,26,155,181,27,181,181
16733,2012-12-04,Winter,2012,Dec,23,0,Tuesday,1,Clear,0.48,0.4697,0.67,0.2537,5,91,96,27,96,96
16734,2012-12-05,Winter,2012,Dec,0,0,Wednesday,1,Clear,0.5,0.4848,0.59,0.2836,6,31,37,26,37,37
16735,2012-12-05,Winter,2012,Dec,1,0,Wednesday,1,Clear,0.52,0.5,0.55,0.3284,0,11,11,26,11,11
16736,2012-12-05,Winter,2012,Dec,2,0,Wednesday,1,Clear,0.46,0.4545,0.67,0.1642,2,7,9,26,9,9
16737,2012-12-05,Winter,2012,Dec,3,0,Wednesday,1,Clear,0.48,0.4697,0.67,0.1343,0,7,7,26,7,7
16738,2012-12-05,Winter,2012,Dec,4,0,Wednesday,1,Clear,0.5,0.4848,0.63,0.4478,1,9,10,26,10,10
16739,2012-12-05,Winter,2012,Dec,5,0,Wednesday,1,Clear,0.5,0.4848,0.59,0.2836,1,48,49,26,49,49
16740,2012-12-05,Winter,2012,Dec,6,0,Wednesday,1,Light_rainsnow,0.48,0.4697,0.55,0.3881,5,119,124,26,124,124
16741,2012-12-05,Winter,2012,Dec,7,0,Wednesday,1,Light_rainsnow,0.46,0.4545,0.59,0.2985,9,389,398,26,398,398
16742,2012-12-05,Winter,2012,Dec,8,0,Wednesday,1,Misty,0.44,0.4394,0.58,0.2836,22,737,759,26,759,759
16743,2012-12-05,Winter,2012,Dec,9,0,Wednesday,1,Misty,0.44,0.4394,0.51,0.2239,26,362,388,26,388,388
16744,2012-12-05,Winter,2012,Dec,10,0,Wednesday,1,Misty,0.44,0.4394,0.47,0.3582,14,127,141,26,141,141
16745,2012-12-05,Winter,2012,Dec,11,0,Wednesday,1,Clear,0.44,0.4394,0.44,0.2836,11,161,172,26,172,172
16746,2012-12-05,Winter,2012,Dec,12,0,Wednesday,1,Clear,0.44,0.4394,0.41,0.2836,24,208,232,26,232,232
16747,2012-12-05,Winter,2012,Dec,13,0,Wednesday,1,Clear,0.46,0.4545,0.41,0.2836,14,200,214,26,214,214
16748,2012-12-05,Winter,2012,Dec,14,0,Wednesday,1,Clear,0.48,0.4697,0.33,0.4925,39,179,218,26,218,218
16749,2012-12-05,Winter,2012,Dec,15,0,Wednesday,1,Clear,0.48,0.4697,0.33,0.2836,20,265,285,26,285,285
16750,2012-12-05,Winter,2012,Dec,16,0,Wednesday,1,Clear,0.46,0.4545,0.33,0.2836,23,354,377,26,377,377
16751,2012-12-05,Winter,2012,Dec,17,0,Wednesday,1,Clear,0.44,0.4394,0.35,0.2836,29,576,605,26,605,605
16752,2012-12-05,Winter,2012,Dec,18,0,Wednesday,1,Clear,0.42,0.4242,0.35,0.4478,29,580,609,26,609,609
16753,2012-12-05,Winter,2012,Dec,19,0,Wednesday,1,Clear,0.38,0.3939,0.43,0.3582,14,400,414,26,414,414
16754,2012-12-05,Winter,2012,Dec,20,0,Wednesday,1,Clear,0.34,0.303,0.46,0.3881,19,274,293,26,293,293
16755,2012-12-05,Winter,2012,Dec,21,0,Wednesday,1,Clear,0.34,0.303,0.46,0.4179,14,184,198,26,198,198
16756,2012-12-05,Winter,2012,Dec,22,0,Wednesday,1,Clear,0.32,0.2879,0.45,0.3881,4,101,105,26,105,105
16757,2012-12-05,Winter,2012,Dec,23,0,Wednesday,1,Clear,0.3,0.2727,0.49,0.3881,5,69,74,26,74,74
16758,2012-12-06,Winter,2012,Dec,0,0,Thursday,1,Clear,0.26,0.2424,0.48,0.2836,1,43,44,25,44,44
16759,2012-12-06,Winter,2012,Dec,1,0,Thursday,1,Clear,0.26,0.2424,0.48,0.2836,0,16,16,25,16,16
16760,2012-12-06,Winter,2012,Dec,2,0,Thursday,1,Clear,0.24,0.2121,0.52,0.2836,0,9,9,25,9,9
16761,2012-12-06,Winter,2012,Dec,3,0,Thursday,1,Clear,0.22,0.2273,0.55,0.194,0,2,2,25,2,2
16762,2012-12-06,Winter,2012,Dec,4,0,Thursday,1,Clear,0.22,0.2121,0.55,0.2985,1,8,9,25,9,9
16763,2012-12-06,Winter,2012,Dec,5,0,Thursday,1,Clear,0.22,0.2121,0.55,0.2836,0,32,32,25,32,32
16764,2012-12-06,Winter,2012,Dec,6,0,Thursday,1,Clear,0.22,0.2121,0.55,0.2985,2,122,124,25,124,124
16765,2012-12-06,Winter,2012,Dec,7,0,Thursday,1,Clear,0.22,0.2121,0.51,0.2985,8,381,389,25,389,389
16766,2012-12-06,Winter,2012,Dec,8,0,Thursday,1,Clear,0.22,0.2121,0.51,0.2985,13,646,659,25,659,659
16767,2012-12-06,Winter,2012,Dec,9,0,Thursday,1,Clear,0.24,0.2273,0.48,0.194,19,257,276,25,276,276
16768,2012-12-06,Winter,2012,Dec,10,0,Thursday,1,Clear,0.24,0.2273,0.52,0.194,23,122,145,25,145,145
16769,2012-12-06,Winter,2012,Dec,11,0,Thursday,1,Clear,0.26,0.2576,0.48,0.1642,16,162,178,25,178,178
16770,2012-12-06,Winter,2012,Dec,12,0,Thursday,1,Clear,0.28,0.3182,0.41,0.0,29,206,235,25,235,235
16771,2012-12-06,Winter,2012,Dec,13,0,Thursday,1,Clear,0.3,0.3333,0.39,0.0,33,212,245,25,245,245
16772,2012-12-06,Winter,2012,Dec,14,0,Thursday,1,Clear,0.3,0.3182,0.42,0.0896,37,175,212,25,212,212
16773,2012-12-06,Winter,2012,Dec,15,0,Thursday,1,Clear,0.32,0.3485,0.39,0.0,38,232,270,25,270,270
16774,2012-12-06,Winter,2012,Dec,16,0,Thursday,1,Clear,0.32,0.3485,0.42,0.0,39,292,331,25,331,331
16775,2012-12-06,Winter,2012,Dec,17,0,Thursday,1,Clear,0.3,0.3182,0.45,0.1045,31,586,617,25,617,617
16776,2012-12-06,Winter,2012,Dec,18,0,Thursday,1,Clear,0.28,0.2727,0.45,0.1642,23,542,565,25,565,565
16777,2012-12-06,Winter,2012,Dec,19,0,Thursday,1,Clear,0.26,0.2576,0.6,0.194,13,360,373,25,373,373
16778,2012-12-06,Winter,2012,Dec,20,0,Thursday,1,Misty,0.24,0.2576,0.6,0.1045,5,222,227,25,227,227
16779,2012-12-06,Winter,2012,Dec,21,0,Thursday,1,Misty,0.24,0.2424,0.6,0.1343,7,184,191,25,191,191
16780,2012-12-06,Winter,2012,Dec,22,0,Thursday,1,Clear,0.24,0.2424,0.65,0.1642,2,131,133,25,133,133
16781,2012-12-06,Winter,2012,Dec,23,0,Thursday,1,Clear,0.24,0.2424,0.65,0.1642,0,93,93,25,93,93
16782,2012-12-07,Winter,2012,Dec,0,0,Friday,1,Clear,0.24,0.2576,0.7,0.1045,3,45,48,24,48,48
16783,2012-12-07,Winter,2012,Dec,1,0,Friday,1,Misty,0.24,0.2273,0.7,0.194,2,26,28,24,28,28
16784,2012-12-07,Winter,2012,Dec,2,0,Friday,1,Misty,0.26,0.2727,0.7,0.1343,0,11,11,24,11,11
16785,2012-12-07,Winter,2012,Dec,3,0,Friday,1,Misty,0.26,0.2576,0.81,0.194,0,5,5,24,5,5
16786,2012-12-07,Winter,2012,Dec,4,0,Friday,1,Clear,0.26,0.2727,0.75,0.1045,0,10,10,24,10,10
16787,2012-12-07,Winter,2012,Dec,5,0,Friday,1,Misty,0.26,0.2727,0.81,0.1045,1,25,26,24,26,26
16788,2012-12-07,Winter,2012,Dec,6,0,Friday,1,Misty,0.28,0.2727,0.75,0.1642,0,84,84,24,84,84
16789,2012-12-07,Winter,2012,Dec,7,0,Friday,1,Light_rainsnow,0.28,0.2727,0.81,0.1642,3,212,215,24,215,215
16790,2012-12-07,Winter,2012,Dec,8,0,Friday,1,Misty,0.3,0.2879,0.75,0.194,11,430,441,24,441,441
16791,2012-12-07,Winter,2012,Dec,9,0,Friday,1,Misty,0.3,0.303,0.81,0.1343,10,291,301,24,301,301
16792,2012-12-07,Winter,2012,Dec,10,0,Friday,1,Misty,0.32,0.3182,0.76,0.1642,16,150,166,24,166,166
16793,2012-12-07,Winter,2012,Dec,11,0,Friday,1,Misty,0.32,0.3182,0.76,0.194,20,183,203,24,203,203
16794,2012-12-07,Winter,2012,Dec,12,0,Friday,1,Misty,0.34,0.3333,0.71,0.194,36,204,240,24,240,240
16795,2012-12-07,Winter,2012,Dec,13,0,Friday,1,Misty,0.36,0.3485,0.66,0.1343,23,197,220,24,220,220
16796,2012-12-07,Winter,2012,Dec,14,0,Friday,1,Misty,0.36,0.3485,0.71,0.1642,40,175,215,24,215,215
16797,2012-12-07,Winter,2012,Dec,15,0,Friday,1,Misty,0.36,0.3485,0.71,0.1642,34,269,303,24,303,303
16798,2012-12-07,Winter,2012,Dec,16,0,Friday,1,Clear,0.36,0.3485,0.76,0.1343,39,336,375,24,375,375
16799,2012-12-07,Winter,2012,Dec,17,0,Friday,1,Misty,0.38,0.3939,0.66,0.0,29,539,568,24,568,568
16800,2012-12-07,Winter,2012,Dec,18,0,Friday,1,Misty,0.38,0.3939,0.71,0.1045,25,473,498,24,498,498
16801,2012-12-07,Winter,2012,Dec,19,0,Friday,1,Misty,0.38,0.3939,0.76,0.0,15,337,352,24,352,352
16802,2012-12-07,Winter,2012,Dec,20,0,Friday,1,Light_rainsnow,0.38,0.3939,0.76,0.1045,12,229,241,24,241,241
16803,2012-12-07,Winter,2012,Dec,21,0,Friday,1,Misty,0.36,0.3636,0.93,0.1045,9,162,171,24,171,171
16804,2012-12-07,Winter,2012,Dec,22,0,Friday,1,Misty,0.36,0.3636,0.93,0.0896,15,150,165,24,165,165
16805,2012-12-07,Winter,2012,Dec,23,0,Friday,1,Misty,0.36,0.3636,0.93,0.0896,6,116,122,24,122,122
16806,2012-12-08,Winter,2012,Dec,0,0,Saturday,0,Misty,0.36,0.3636,0.93,0.0896,5,98,103,23,103,103
16807,2012-12-08,Winter,2012,Dec,1,0,Saturday,0,Misty,0.36,0.3485,0.93,0.1343,16,84,100,23,100,100
16808,2012-12-08,Winter,2012,Dec,2,0,Saturday,0,Misty,0.36,0.3485,0.93,0.1343,3,67,70,23,70,70
16809,2012-12-08,Winter,2012,Dec,3,0,Saturday,0,Misty,0.36,0.3636,0.93,0.1045,6,23,29,23,29,29
16810,2012-12-08,Winter,2012,Dec,4,0,Saturday,0,Misty,0.36,0.3788,0.93,0.0,3,9,12,23,12,12
16811,2012-12-08,Winter,2012,Dec,5,0,Saturday,0,Misty,0.36,0.3636,0.93,0.1045,2,4,6,23,6,6
16812,2012-12-08,Winter,2012,Dec,6,0,Saturday,0,Misty,0.36,0.3636,0.93,0.1045,1,19,20,23,20,20
16813,2012-12-08,Winter,2012,Dec,7,0,Saturday,0,Misty,0.36,0.3636,1.0,0.0896,3,36,39,23,39,39
16814,2012-12-08,Winter,2012,Dec,8,0,Saturday,0,Misty,0.38,0.3939,0.94,0.0896,5,106,111,23,111,111
16815,2012-12-08,Winter,2012,Dec,9,0,Saturday,0,Misty,0.38,0.3939,0.94,0.0,17,153,170,23,170,170
16816,2012-12-08,Winter,2012,Dec,10,0,Saturday,0,Misty,0.4,0.4091,0.87,0.1343,43,244,287,23,287,287
16817,2012-12-08,Winter,2012,Dec,11,0,Saturday,0,Misty,0.4,0.4091,0.87,0.1045,63,341,404,23,404,404
16818,2012-12-08,Winter,2012,Dec,12,0,Saturday,0,Misty,0.4,0.4091,0.87,0.2239,122,364,486,23,486,486
16819,2012-12-08,Winter,2012,Dec,13,0,Saturday,0,Misty,0.4,0.4091,0.87,0.1642,148,399,547,23,547,547
16820,2012-12-08,Winter,2012,Dec,14,0,Saturday,0,Misty,0.4,0.4091,0.87,0.2836,164,378,542,23,542,542
16821,2012-12-08,Winter,2012,Dec,15,0,Saturday,0,Clear,0.42,0.4242,0.82,0.1642,167,374,541,23,541,541
16822,2012-12-08,Winter,2012,Dec,16,0,Saturday,0,Clear,0.42,0.4242,0.82,0.1642,139,368,507,23,507,507
16823,2012-12-08,Winter,2012,Dec,17,0,Saturday,0,Clear,0.38,0.3939,0.87,0.1343,77,268,345,23,345,345
16824,2012-12-08,Winter,2012,Dec,18,0,Saturday,0,Clear,0.4,0.4091,0.87,0.1045,40,264,304,23,304,304
16825,2012-12-08,Winter,2012,Dec,19,0,Saturday,0,Clear,0.4,0.4091,0.87,0.0,34,212,246,23,246,246
16826,2012-12-08,Winter,2012,Dec,20,0,Saturday,0,Misty,0.36,0.3788,1.0,0.0,20,162,182,23,182,182
16827,2012-12-08,Winter,2012,Dec,21,0,Saturday,0,Misty,0.36,0.3788,1.0,0.0,34,175,209,23,209,209
16828,2012-12-08,Winter,2012,Dec,22,0,Saturday,0,Misty,0.38,0.3939,0.94,0.1045,23,137,160,23,160,160
16829,2012-12-08,Winter,2012,Dec,23,0,Saturday,0,Misty,0.4,0.4091,0.94,0.0,18,144,162,23,162,162
16830,2012-12-09,Winter,2012,Dec,0,0,Sunday,0,Misty,0.4,0.4091,0.87,0.1343,15,103,118,22,118,118
16831,2012-12-09,Winter,2012,Dec,1,0,Sunday,0,Misty,0.4,0.4091,0.87,0.1045,17,85,102,22,102,102
16832,2012-12-09,Winter,2012,Dec,2,0,Sunday,0,Misty,0.4,0.4091,0.87,0.1045,8,70,78,22,78,78
16833,2012-12-09,Winter,2012,Dec,3,0,Sunday,0,Misty,0.4,0.4091,0.87,0.1045,14,34,48,22,48,48
16834,2012-12-09,Winter,2012,Dec,4,0,Sunday,0,Misty,0.4,0.4091,0.94,0.1045,1,11,12,22,12,12
16835,2012-12-09,Winter,2012,Dec,5,0,Sunday,0,Misty,0.4,0.4091,0.87,0.1045,0,8,8,22,8,8
16836,2012-12-09,Winter,2012,Dec,6,0,Sunday,0,Light_rainsnow,0.4,0.4091,0.94,0.1045,0,6,6,22,6,6
16837,2012-12-09,Winter,2012,Dec,7,0,Sunday,0,Light_rainsnow,0.4,0.4091,0.87,0.2239,1,22,23,22,23,23
16838,2012-12-09,Winter,2012,Dec,8,0,Sunday,0,Light_rainsnow,0.4,0.4091,0.87,0.1642,1,68,69,22,69,69
16839,2012-12-09,Winter,2012,Dec,9,0,Sunday,0,Misty,0.4,0.4091,0.87,0.2537,9,94,103,22,103,103
16840,2012-12-09,Winter,2012,Dec,10,0,Sunday,0,Misty,0.4,0.4091,0.87,0.2836,39,180,219,22,219,219
16841,2012-12-09,Winter,2012,Dec,11,0,Sunday,0,Misty,0.4,0.4091,0.87,0.2985,40,210,250,22,250,250
16842,2012-12-09,Winter,2012,Dec,12,0,Sunday,0,Misty,0.4,0.4091,0.82,0.2985,60,255,315,22,315,315
16843,2012-12-09,Winter,2012,Dec,13,0,Sunday,0,Misty,0.38,0.3939,0.87,0.2836,65,220,285,22,285,285
16844,2012-12-09,Winter,2012,Dec,14,0,Sunday,0,Misty,0.38,0.3939,0.87,0.194,42,190,232,22,232,232
16845,2012-12-09,Winter,2012,Dec,15,0,Sunday,0,Light_rainsnow,0.36,0.3485,0.93,0.1642,25,200,225,22,225,225
16846,2012-12-09,Winter,2012,Dec,16,0,Sunday,0,Light_rainsnow,0.36,0.3485,0.93,0.1642,33,220,253,22,253,253
16847,2012-12-09,Winter,2012,Dec,17,0,Sunday,0,Light_rainsnow,0.36,0.3485,0.93,0.1343,20,209,229,22,229,229
16848,2012-12-09,Winter,2012,Dec,18,0,Sunday,0,Light_rainsnow,0.36,0.3636,0.93,0.0896,17,181,198,22,198,198
16849,2012-12-09,Winter,2012,Dec,19,0,Sunday,0,Light_rainsnow,0.38,0.3939,0.94,0.0896,12,110,122,22,122,122
16850,2012-12-09,Winter,2012,Dec,20,0,Sunday,0,Light_rainsnow,0.36,0.3636,1.0,0.0896,6,102,108,22,108,108
16851,2012-12-09,Winter,2012,Dec,21,0,Sunday,0,Misty,0.36,0.3636,1.0,0.1045,10,86,96,22,96,96
16852,2012-12-09,Winter,2012,Dec,22,0,Sunday,0,Light_rainsnow,0.36,0.3636,0.93,0.1045,3,75,78,22,78,78
16853,2012-12-09,Winter,2012,Dec,23,0,Sunday,0,Light_rainsnow,0.36,0.3636,1.0,0.0896,3,48,51,22,51,51
16854,2012-12-10,Winter,2012,Dec,0,0,Monday,1,Light_rainsnow,0.36,0.3636,1.0,0.0896,0,20,20,21,20,20
16855,2012-12-10,Winter,2012,Dec,1,0,Monday,1,Misty,0.36,0.3788,1.0,0.0,0,4,4,21,4,4
16856,2012-12-10,Winter,2012,Dec,2,0,Monday,1,Misty,0.38,0.3939,0.94,0.1045,2,3,5,21,5,5
16857,2012-12-10,Winter,2012,Dec,3,0,Monday,1,Misty,0.38,0.3939,0.94,0.1045,0,4,4,21,4,4
16858,2012-12-10,Winter,2012,Dec,4,0,Monday,1,Misty,0.38,0.3939,0.94,0.1045,3,9,12,21,12,12
16859,2012-12-10,Winter,2012,Dec,5,0,Monday,1,Misty,0.38,0.3939,0.94,0.1045,0,27,27,21,27,27
16860,2012-12-10,Winter,2012,Dec,6,0,Monday,1,Misty,0.38,0.3939,0.94,0.1642,2,121,123,21,123,123
16861,2012-12-10,Winter,2012,Dec,7,0,Monday,1,Misty,0.38,0.3939,0.94,0.2537,3,291,294,21,294,294
16862,2012-12-10,Winter,2012,Dec,8,0,Monday,1,Misty,0.42,0.4242,1.0,0.2537,9,575,584,21,584,584
16863,2012-12-10,Winter,2012,Dec,9,0,Monday,1,Misty,0.42,0.4242,1.0,0.2239,11,273,284,21,284,284
16864,2012-12-10,Winter,2012,Dec,10,0,Monday,1,Misty,0.44,0.4394,0.94,0.2239,12,121,133,21,133,133
16865,2012-12-10,Winter,2012,Dec,11,0,Monday,1,Light_rainsnow,0.46,0.4545,0.94,0.2239,8,126,134,21,134,134
16866,2012-12-10,Winter,2012,Dec,12,0,Monday,1,Light_rainsnow,0.44,0.4394,1.0,0.2239,23,150,173,21,173,173
16867,2012-12-10,Winter,2012,Dec,13,0,Monday,1,Light_rainsnow,0.44,0.4394,1.0,0.2239,30,190,220,21,220,220
16868,2012-12-10,Winter,2012,Dec,14,0,Monday,1,Misty,0.5,0.4848,0.94,0.2239,31,179,210,21,210,210
16869,2012-12-10,Winter,2012,Dec,15,0,Monday,1,Misty,0.5,0.4848,0.87,0.1642,29,207,236,21,236,236
16870,2012-12-10,Winter,2012,Dec,16,0,Monday,1,Misty,0.5,0.4848,0.88,0.1045,37,308,345,21,345,345
16871,2012-12-10,Winter,2012,Dec,17,0,Monday,1,Misty,0.48,0.4697,0.82,0.2836,38,578,616,21,616,616
16872,2012-12-10,Winter,2012,Dec,18,0,Monday,1,Misty,0.46,0.4545,0.88,0.2836,20,544,564,21,564,564
16873,2012-12-10,Winter,2012,Dec,19,0,Monday,1,Clear,0.52,0.5,0.77,0.2836,18,409,427,21,427,427
16874,2012-12-10,Winter,2012,Dec,20,0,Monday,1,Clear,0.46,0.4545,0.88,0.2537,13,287,300,21,300,300
16875,2012-12-10,Winter,2012,Dec,21,0,Monday,1,Misty,0.46,0.4545,0.94,0.194,21,224,245,21,245,245
16876,2012-12-10,Winter,2012,Dec,22,0,Monday,1,Misty,0.5,0.4848,0.82,0.2239,11,115,126,21,126,126
16877,2012-12-10,Winter,2012,Dec,23,0,Monday,1,Clear,0.46,0.4545,0.88,0.2537,8,76,84,21,84,84
16878,2012-12-11,Winter,2012,Dec,0,0,Tuesday,1,Light_rainsnow,0.46,0.4545,0.77,0.4627,2,29,31,20,31,31
16879,2012-12-11,Winter,2012,Dec,1,0,Tuesday,1,Clear,0.42,0.4242,0.71,0.4478,1,7,8,20,8,8
16880,2012-12-11,Winter,2012,Dec,2,0,Tuesday,1,Misty,0.4,0.4091,0.66,0.3284,0,1,1,20,1,1
16881,2012-12-11,Winter,2012,Dec,3,0,Tuesday,1,Light_rainsnow,0.36,0.3333,0.76,0.2836,0,3,3,20,3,3
16882,2012-12-11,Winter,2012,Dec,4,0,Tuesday,1,Misty,0.34,0.3182,0.76,0.2836,0,8,8,20,8,8
16883,2012-12-11,Winter,2012,Dec,5,0,Tuesday,1,Light_rainsnow,0.34,0.303,0.71,0.3284,1,40,41,20,41,41
16884,2012-12-11,Winter,2012,Dec,6,0,Tuesday,1,Misty,0.34,0.303,0.71,0.2985,0,118,118,20,118,118
16885,2012-12-11,Winter,2012,Dec,7,0,Tuesday,1,Clear,0.34,0.303,0.66,0.4179,8,372,380,20,380,380
16886,2012-12-11,Winter,2012,Dec,8,0,Tuesday,1,Misty,0.34,0.303,0.61,0.2985,16,708,724,20,724,724
16887,2012-12-11,Winter,2012,Dec,9,0,Tuesday,1,Clear,0.34,0.303,0.61,0.3881,12,322,334,20,334,334
16888,2012-12-11,Winter,2012,Dec,10,0,Tuesday,1,Clear,0.36,0.3333,0.57,0.3284,12,142,154,20,154,154
16889,2012-12-11,Winter,2012,Dec,11,0,Tuesday,1,Misty,0.36,0.3333,0.53,0.3582,28,145,173,20,173,173
16890,2012-12-11,Winter,2012,Dec,12,0,Tuesday,1,Misty,0.36,0.3182,0.53,0.4478,13,213,226,20,226,226
16891,2012-12-11,Winter,2012,Dec,13,0,Tuesday,1,Misty,0.38,0.3939,0.5,0.2239,28,226,254,20,254,254
16892,2012-12-11,Winter,2012,Dec,14,0,Tuesday,1,Misty,0.38,0.3939,0.5,0.2239,19,185,204,20,204,204
16893,2012-12-11,Winter,2012,Dec,15,0,Tuesday,1,Misty,0.38,0.3939,0.5,0.2239,20,250,270,20,270,270
16894,2012-12-11,Winter,2012,Dec,16,0,Tuesday,1,Misty,0.38,0.3939,0.5,0.2239,24,334,358,20,358,358
16895,2012-12-11,Winter,2012,Dec,17,0,Tuesday,1,Clear,0.32,0.303,0.53,0.2239,21,580,601,20,601,601
16896,2012-12-11,Winter,2012,Dec,18,0,Tuesday,1,Clear,0.32,0.303,0.53,0.2239,23,523,546,20,546,546
16897,2012-12-11,Winter,2012,Dec,19,0,Tuesday,1,Clear,0.32,0.303,0.53,0.2239,21,412,433,20,433,433
16898,2012-12-11,Winter,2012,Dec,20,0,Tuesday,1,Clear,0.32,0.303,0.53,0.2239,9,248,257,20,257,257
16899,2012-12-11,Winter,2012,Dec,21,0,Tuesday,1,Clear,0.32,0.3182,0.53,0.194,14,193,207,20,207,207
16900,2012-12-11,Winter,2012,Dec,22,0,Tuesday,1,Clear,0.3,0.2879,0.56,0.2239,6,100,106,20,106,106
16901,2012-12-11,Winter,2012,Dec,23,0,Tuesday,1,Clear,0.3,0.2879,0.52,0.2239,4,60,64,20,64,64
16902,2012-12-12,Winter,2012,Dec,0,0,Wednesday,1,Clear,0.3,0.303,0.52,0.1642,1,33,34,19,34,34
16903,2012-12-12,Winter,2012,Dec,1,0,Wednesday,1,Clear,0.28,0.2727,0.61,0.2239,3,18,21,19,21,21
16904,2012-12-12,Winter,2012,Dec,2,0,Wednesday,1,Clear,0.28,0.2727,0.56,0.1642,5,4,9,19,9,9
16905,2012-12-12,Winter,2012,Dec,3,0,Wednesday,1,Clear,0.26,0.2727,0.6,0.1343,3,7,10,19,10,10
16906,2012-12-12,Winter,2012,Dec,4,0,Wednesday,1,Clear,0.26,0.303,0.6,0.0,0,4,4,19,4,4
16907,2012-12-12,Winter,2012,Dec,5,0,Wednesday,1,Clear,0.26,0.2576,0.6,0.194,0,37,37,19,37,37
16908,2012-12-12,Winter,2012,Dec,6,0,Wednesday,1,Misty,0.26,0.2424,0.6,0.2537,2,126,128,19,128,128
16909,2012-12-12,Winter,2012,Dec,7,0,Wednesday,1,Misty,0.26,0.2576,0.6,0.194,3,366,369,19,369,369
16910,2012-12-12,Winter,2012,Dec,8,0,Wednesday,1,Misty,0.26,0.2576,0.65,0.1642,18,670,688,19,688,688
16911,2012-12-12,Winter,2012,Dec,9,0,Wednesday,1,Misty,0.28,0.2879,0.61,0.1343,13,272,285,19,285,285
16912,2012-12-12,Winter,2012,Dec,10,0,Wednesday,1,Misty,0.3,0.303,0.56,0.1642,20,116,136,19,136,136
16913,2012-12-12,Winter,2012,Dec,11,0,Wednesday,1,Misty,0.32,0.303,0.49,0.2239,24,148,172,19,172,172
16914,2012-12-12,Winter,2012,Dec,12,0,Wednesday,1,Misty,0.34,0.3636,0.42,0.0,14,218,232,19,232,232
16915,2012-12-12,Winter,2012,Dec,13,0,Wednesday,1,Misty,0.34,0.3636,0.42,0.0,18,220,238,19,238,238
16916,2012-12-12,Winter,2012,Dec,14,0,Wednesday,1,Misty,0.34,0.3636,0.46,0.0,34,191,225,19,225,225
16917,2012-12-12,Winter,2012,Dec,15,0,Wednesday,1,Misty,0.34,0.3485,0.46,0.1045,21,207,228,19,228,228
16918,2012-12-12,Winter,2012,Dec,16,0,Wednesday,1,Misty,0.34,0.3333,0.46,0.1343,19,310,329,19,329,329
16919,2012-12-12,Winter,2012,Dec,17,0,Wednesday,1,Misty,0.32,0.303,0.53,0.2239,21,540,561,19,561,561
16920,2012-12-12,Winter,2012,Dec,18,0,Wednesday,1,Misty,0.32,0.303,0.49,0.2239,25,515,540,19,540,540
16921,2012-12-12,Winter,2012,Dec,19,0,Wednesday,1,Misty,0.3,0.2879,0.56,0.2239,18,384,402,19,402,402
16922,2012-12-12,Winter,2012,Dec,20,0,Wednesday,1,Clear,0.3,0.2879,0.52,0.2836,25,243,268,19,268,268
16923,2012-12-12,Winter,2012,Dec,21,0,Wednesday,1,Misty,0.3,0.2879,0.52,0.2537,16,186,202,19,202,202
16924,2012-12-12,Winter,2012,Dec,22,0,Wednesday,1,Misty,0.3,0.2879,0.52,0.2239,4,118,122,19,122,122
16925,2012-12-12,Winter,2012,Dec,23,0,Wednesday,1,Misty,0.28,0.2727,0.56,0.2239,3,76,79,19,79,79
16926,2012-12-13,Winter,2012,Dec,0,0,Thursday,1,Misty,0.28,0.2727,0.52,0.2239,1,31,32,18,32,32
16927,2012-12-13,Winter,2012,Dec,1,0,Thursday,1,Misty,0.28,0.2576,0.52,0.2836,4,19,23,18,23,23
16928,2012-12-13,Winter,2012,Dec,2,0,Thursday,1,Misty,0.26,0.2424,0.56,0.2537,3,5,8,18,8,8
16929,2012-12-13,Winter,2012,Dec,3,0,Thursday,1,Misty,0.26,0.2424,0.56,0.2836,0,2,2,18,2,2
16930,2012-12-13,Winter,2012,Dec,4,0,Thursday,1,Misty,0.26,0.2576,0.56,0.194,0,8,8,18,8,8
16931,2012-12-13,Winter,2012,Dec,5,0,Thursday,1,Misty,0.26,0.2576,0.56,0.1642,2,31,33,18,33,33
16932,2012-12-13,Winter,2012,Dec,6,0,Thursday,1,Clear,0.26,0.2424,0.56,0.2537,2,112,114,18,114,114
16933,2012-12-13,Winter,2012,Dec,7,0,Thursday,1,Clear,0.24,0.2273,0.6,0.2239,5,380,385,18,385,385
16934,2012-12-13,Winter,2012,Dec,8,0,Thursday,1,Clear,0.24,0.2273,0.6,0.194,24,655,679,18,679,679
16935,2012-12-13,Winter,2012,Dec,9,0,Thursday,1,Clear,0.28,0.2727,0.52,0.2537,25,300,325,18,325,325
16936,2012-12-13,Winter,2012,Dec,10,0,Thursday,1,Clear,0.32,0.303,0.45,0.2836,28,139,167,18,167,167
16937,2012-12-13,Winter,2012,Dec,11,0,Thursday,1,Clear,0.34,0.3182,0.42,0.2537,25,164,189,18,189,189
16938,2012-12-13,Winter,2012,Dec,12,0,Thursday,1,Clear,0.36,0.3333,0.4,0.2537,30,252,282,18,282,282
16939,2012-12-13,Winter,2012,Dec,13,0,Thursday,1,Clear,0.36,0.3485,0.34,0.194,41,230,271,18,271,271
16940,2012-12-13,Winter,2012,Dec,14,0,Thursday,1,Clear,0.36,0.3485,0.34,0.1642,31,211,242,18,242,242
16941,2012-12-13,Winter,2012,Dec,15,0,Thursday,1,Clear,0.36,0.3485,0.34,0.1343,40,240,280,18,280,280
16942,2012-12-13,Winter,2012,Dec,16,0,Thursday,1,Clear,0.34,0.3485,0.39,0.1045,50,356,406,18,406,406
16943,2012-12-13,Winter,2012,Dec,17,0,Thursday,1,Clear,0.32,0.3333,0.42,0.1045,43,507,550,18,550,550
16944,2012-12-13,Winter,2012,Dec,18,0,Thursday,1,Clear,0.32,0.3333,0.42,0.1045,20,446,466,18,466,466
16945,2012-12-13,Winter,2012,Dec,19,0,Thursday,1,Clear,0.3,0.303,0.45,0.1642,20,328,348,18,348,348
16946,2012-12-13,Winter,2012,Dec,20,0,Thursday,1,Clear,0.3,0.3333,0.45,0.0,6,235,241,18,241,241
16947,2012-12-13,Winter,2012,Dec,21,0,Thursday,1,Clear,0.28,0.3182,0.48,0.0,13,200,213,18,213,213
16948,2012-12-13,Winter,2012,Dec,22,0,Thursday,1,Clear,0.26,0.2879,0.6,0.0896,7,141,148,18,148,148
16949,2012-12-13,Winter,2012,Dec,23,0,Thursday,1,Clear,0.26,0.303,0.6,0.0,5,115,120,18,120,120
16950,2012-12-14,Winter,2012,Dec,0,0,Friday,1,Clear,0.22,0.2576,0.64,0.0896,4,43,47,17,47,47
16951,2012-12-14,Winter,2012,Dec,1,0,Friday,1,Clear,0.22,0.2576,0.69,0.0896,0,26,26,17,26,26
16952,2012-12-14,Winter,2012,Dec,2,0,Friday,1,Clear,0.22,0.2727,0.69,0.0,3,6,9,17,9,9
16953,2012-12-14,Winter,2012,Dec,3,0,Friday,1,Clear,0.2,0.2273,0.69,0.1045,0,12,12,17,12,12
16954,2012-12-14,Winter,2012,Dec,4,0,Friday,1,Clear,0.2,0.2273,0.75,0.0896,1,9,10,17,10,10
16955,2012-12-14,Winter,2012,Dec,5,0,Friday,1,Clear,0.2,0.2273,0.69,0.1045,0,34,34,17,34,34
16956,2012-12-14,Winter,2012,Dec,6,0,Friday,1,Clear,0.16,0.1818,0.8,0.1045,1,112,113,17,113,113
16957,2012-12-14,Winter,2012,Dec,7,0,Friday,1,Clear,0.2,0.2121,0.72,0.1045,3,305,308,17,308,308
16958,2012-12-14,Winter,2012,Dec,8,0,Friday,1,Clear,0.2,0.2273,0.69,0.0896,13,623,636,17,636,636
16959,2012-12-14,Winter,2012,Dec,9,0,Friday,1,Clear,0.24,0.2424,0.75,0.1343,13,330,343,17,343,343
16960,2012-12-14,Winter,2012,Dec,10,0,Friday,1,Clear,0.26,0.2576,0.81,0.194,28,162,190,17,190,190
16961,2012-12-14,Winter,2012,Dec,11,0,Friday,1,Clear,0.32,0.303,0.65,0.194,31,180,211,17,211,211
16962,2012-12-14,Winter,2012,Dec,12,0,Friday,1,Clear,0.36,0.3485,0.5,0.194,29,244,273,17,273,273
16963,2012-12-14,Winter,2012,Dec,13,0,Friday,1,Clear,0.36,0.3485,0.5,0.2239,39,274,313,17,313,313
16964,2012-12-14,Winter,2012,Dec,14,0,Friday,1,Clear,0.4,0.4091,0.43,0.194,48,251,299,17,299,299
16965,2012-12-14,Winter,2012,Dec,15,0,Friday,1,Clear,0.4,0.4091,0.47,0.1642,57,252,309,17,309,309
16966,2012-12-14,Winter,2012,Dec,16,0,Friday,1,Clear,0.38,0.3939,0.54,0.194,45,372,417,17,417,417
16967,2012-12-14,Winter,2012,Dec,17,0,Friday,1,Clear,0.34,0.3333,0.57,0.1642,40,582,622,17,622,622
16968,2012-12-14,Winter,2012,Dec,18,0,Friday,1,Clear,0.36,0.3485,0.46,0.1343,23,432,455,17,455,455
16969,2012-12-14,Winter,2012,Dec,19,0,Friday,1,Clear,0.34,0.3485,0.53,0.0896,17,302,319,17,319,319
16970,2012-12-14,Winter,2012,Dec,20,0,Friday,1,Clear,0.32,0.3333,0.61,0.1343,12,209,221,17,221,221
16971,2012-12-14,Winter,2012,Dec,21,0,Friday,1,Clear,0.3,0.303,0.75,0.1642,7,165,172,17,172,172
16972,2012-12-14,Winter,2012,Dec,22,0,Friday,1,Clear,0.28,0.2879,0.75,0.1045,4,134,138,17,138,138
16973,2012-12-14,Winter,2012,Dec,23,0,Friday,1,Clear,0.28,0.303,0.75,0.0896,11,123,134,17,134,134
16974,2012-12-15,Winter,2012,Dec,0,0,Saturday,0,Clear,0.3,0.3333,0.7,0.0,4,90,94,16,94,94
16975,2012-12-15,Winter,2012,Dec,1,0,Saturday,0,Misty,0.26,0.2879,0.81,0.0896,9,86,95,16,95,95
16976,2012-12-15,Winter,2012,Dec,2,0,Saturday,0,Clear,0.26,0.303,0.81,0.0,6,63,69,16,69,69
16977,2012-12-15,Winter,2012,Dec,3,0,Saturday,0,Misty,0.24,0.2879,0.81,0.0,5,18,23,16,23,23
16978,2012-12-15,Winter,2012,Dec,4,0,Saturday,0,Misty,0.24,0.2576,0.87,0.1045,1,5,6,16,6,6
16979,2012-12-15,Winter,2012,Dec,5,0,Saturday,0,Misty,0.26,0.303,0.75,0.0,0,3,3,16,3,3
16980,2012-12-15,Winter,2012,Dec,6,0,Saturday,0,Misty,0.24,0.2879,0.75,0.0,0,11,11,16,11,11
16981,2012-12-15,Winter,2012,Dec,7,0,Saturday,0,Misty,0.24,0.2576,0.75,0.0896,1,47,48,16,48,48
16982,2012-12-15,Winter,2012,Dec,8,0,Saturday,0,Misty,0.26,0.2879,0.75,0.0896,8,111,119,16,119,119
16983,2012-12-15,Winter,2012,Dec,9,0,Saturday,0,Clear,0.26,0.2727,0.75,0.1045,17,203,220,16,220,220
16984,2012-12-15,Winter,2012,Dec,10,0,Saturday,0,Clear,0.32,0.3182,0.61,0.1642,23,250,273,16,273,273
16985,2012-12-15,Winter,2012,Dec,11,0,Saturday,0,Clear,0.34,0.3485,0.61,0.0896,66,327,393,16,393,393
16986,2012-12-15,Winter,2012,Dec,12,0,Saturday,0,Clear,0.38,0.3939,0.5,0.0896,89,364,453,16,453,453
16987,2012-12-15,Winter,2012,Dec,13,0,Saturday,0,Clear,0.38,0.3939,0.54,0.2537,88,368,456,16,456,456
16988,2012-12-15,Winter,2012,Dec,14,0,Saturday,0,Clear,0.4,0.4091,0.5,0.1642,92,334,426,16,426,426
16989,2012-12-15,Winter,2012,Dec,15,0,Saturday,0,Clear,0.42,0.4242,0.47,0.0,95,352,447,16,447,447
16990,2012-12-15,Winter,2012,Dec,16,0,Saturday,0,Clear,0.4,0.4091,0.5,0.1343,85,328,413,16,413,413
16991,2012-12-15,Winter,2012,Dec,17,0,Saturday,0,Clear,0.4,0.4091,0.5,0.2239,35,274,309,16,309,309
16992,2012-12-15,Winter,2012,Dec,18,0,Saturday,0,Clear,0.38,0.3939,0.58,0.1642,40,232,272,16,272,272
16993,2012-12-15,Winter,2012,Dec,19,0,Saturday,0,Clear,0.36,0.3485,0.62,0.1343,32,225,257,16,257,257
16994,2012-12-15,Winter,2012,Dec,20,0,Saturday,0,Misty,0.36,0.3485,0.57,0.194,23,178,201,16,201,201
16995,2012-12-15,Winter,2012,Dec,21,0,Saturday,0,Clear,0.36,0.3485,0.62,0.1343,15,169,184,16,184,184
16996,2012-12-15,Winter,2012,Dec,22,0,Saturday,0,Clear,0.36,0.3485,0.62,0.194,22,134,156,16,156,156
16997,2012-12-15,Winter,2012,Dec,23,0,Saturday,0,Misty,0.36,0.3485,0.62,0.1343,11,108,119,16,119,119
16998,2012-12-16,Winter,2012,Dec,0,0,Sunday,0,Misty,0.36,0.3788,0.62,0.0,8,102,110,15,110,110
16999,2012-12-16,Winter,2012,Dec,1,0,Sunday,0,Light_rainsnow,0.34,0.3485,0.76,0.1045,14,82,96,15,96,96
17000,2012-12-16,Winter,2012,Dec,2,0,Sunday,0,Misty,0.34,0.3485,0.87,0.0896,8,79,87,15,87,87
17001,2012-12-16,Winter,2012,Dec,3,0,Sunday,0,Misty,0.34,0.3333,0.87,0.194,1,37,38,15,38,38
17002,2012-12-16,Winter,2012,Dec,4,0,Sunday,0,Misty,0.34,0.3636,0.87,0.0,1,10,11,15,11,11
17003,2012-12-16,Winter,2012,Dec,5,0,Sunday,0,Misty,0.34,0.3636,0.87,0.0,0,9,9,15,9,9
17004,2012-12-16,Winter,2012,Dec,6,0,Sunday,0,Misty,0.34,0.3636,0.87,0.0,0,6,6,15,6,6
17005,2012-12-16,Winter,2012,Dec,7,0,Sunday,0,Misty,0.34,0.3485,0.87,0.0896,5,22,27,15,27,27
17006,2012-12-16,Winter,2012,Dec,8,0,Sunday,0,Misty,0.36,0.3485,0.87,0.1343,12,76,88,15,88,88
17007,2012-12-16,Winter,2012,Dec,9,0,Sunday,0,Misty,0.36,0.3485,0.87,0.1343,19,113,132,15,132,132
17008,2012-12-16,Winter,2012,Dec,10,0,Sunday,0,Misty,0.36,0.3485,0.87,0.1343,42,215,257,15,257,257
17009,2012-12-16,Winter,2012,Dec,11,0,Sunday,0,Misty,0.36,0.3485,0.87,0.1343,47,248,295,15,295,295
17010,2012-12-16,Winter,2012,Dec,12,0,Sunday,0,Misty,0.38,0.3939,0.82,0.194,67,350,417,15,417,417
17011,2012-12-16,Winter,2012,Dec,13,0,Sunday,0,Misty,0.38,0.3939,0.76,0.194,67,289,356,15,356,356
17012,2012-12-16,Winter,2012,Dec,14,0,Sunday,0,Misty,0.38,0.3939,0.76,0.1343,50,260,310,15,310,310
17013,2012-12-16,Winter,2012,Dec,15,0,Sunday,0,Misty,0.38,0.3939,0.82,0.1045,46,292,338,15,338,338
17014,2012-12-16,Winter,2012,Dec,16,0,Sunday,0,Misty,0.38,0.3939,0.82,0.1045,66,334,400,15,400,400
17015,2012-12-16,Winter,2012,Dec,17,0,Sunday,0,Misty,0.38,0.3939,0.82,0.1045,29,214,243,15,243,243
17016,2012-12-16,Winter,2012,Dec,18,0,Sunday,0,Light_rainsnow,0.38,0.3939,0.82,0.1045,8,99,107,15,107,107
17017,2012-12-16,Winter,2012,Dec,19,0,Sunday,0,Clear,0.36,0.3485,0.93,0.1343,10,99,109,15,109,109
17018,2012-12-16,Winter,2012,Dec,20,0,Sunday,0,Misty,0.38,0.3939,0.82,0.0,14,108,122,15,122,122
17019,2012-12-16,Winter,2012,Dec,21,0,Sunday,0,Misty,0.36,0.3788,0.93,0.0,14,92,106,15,106,106
17020,2012-12-16,Winter,2012,Dec,22,0,Sunday,0,Misty,0.4,0.4091,0.82,0.194,6,83,89,15,89,89
17021,2012-12-16,Winter,2012,Dec,23,0,Sunday,0,Misty,0.36,0.3485,0.93,0.1343,4,29,33,15,33,33
17022,2012-12-17,Winter,2012,Dec,0,0,Monday,1,Misty,0.38,0.3939,0.87,0.0,2,26,28,14,28,28
17023,2012-12-17,Winter,2012,Dec,1,0,Monday,1,Misty,0.38,0.3939,0.87,0.1045,1,14,15,14,15,15
17024,2012-12-17,Winter,2012,Dec,2,0,Monday,1,Misty,0.38,0.3939,0.94,0.0,1,4,5,14,5,5
17025,2012-12-17,Winter,2012,Dec,3,0,Monday,1,Misty,0.36,0.3788,0.93,0.0,0,3,3,14,3,3
17026,2012-12-17,Winter,2012,Dec,4,0,Monday,1,Light_rainsnow,0.36,0.3788,1.0,0.0,2,3,5,14,5,5
17027,2012-12-17,Winter,2012,Dec,5,0,Monday,1,Misty,0.38,0.3939,0.87,0.0,0,24,24,14,24,24
17028,2012-12-17,Winter,2012,Dec,6,0,Monday,1,Misty,0.36,0.3485,0.93,0.1343,1,107,108,14,108,108
17029,2012-12-17,Winter,2012,Dec,7,0,Monday,1,Misty,0.36,0.3485,0.93,0.1343,5,314,319,14,319,319
17030,2012-12-17,Winter,2012,Dec,8,0,Monday,1,Misty,0.38,0.3939,0.87,0.1045,10,582,592,14,592,592
17031,2012-12-17,Winter,2012,Dec,9,0,Monday,1,Misty,0.4,0.4091,0.87,0.0,11,271,282,14,282,282
17032,2012-12-17,Winter,2012,Dec,10,0,Monday,1,Misty,0.38,0.3939,0.87,0.0896,15,120,135,14,135,135
17033,2012-12-17,Winter,2012,Dec,11,0,Monday,1,Misty,0.4,0.4091,0.87,0.0896,22,148,170,14,170,170
17034,2012-12-17,Winter,2012,Dec,12,0,Monday,1,Misty,0.4,0.4091,0.87,0.0,21,211,232,14,232,232
17035,2012-12-17,Winter,2012,Dec,13,0,Monday,1,Misty,0.4,0.4091,0.87,0.1343,16,194,210,14,210,210
17036,2012-12-17,Winter,2012,Dec,14,0,Monday,1,Misty,0.4,0.4091,0.87,0.0896,12,169,181,14,181,181
17037,2012-12-17,Winter,2012,Dec,15,0,Monday,1,Misty,0.42,0.4242,0.88,0.0,15,196,211,14,211,211
17038,2012-12-17,Winter,2012,Dec,16,0,Monday,1,Light_rainsnow,0.4,0.4091,0.94,0.2537,15,287,302,14,302,302
17039,2012-12-17,Winter,2012,Dec,17,0,Monday,1,Misty,0.4,0.4091,0.94,0.2537,17,478,495,14,495,495
17040,2012-12-17,Winter,2012,Dec,18,0,Monday,1,Misty,0.4,0.4091,0.94,0.0896,14,493,507,14,507,507
17041,2012-12-17,Winter,2012,Dec,19,0,Monday,1,Misty,0.42,0.4242,0.88,0.1343,7,333,340,14,340,340
17042,2012-12-17,Winter,2012,Dec,20,0,Monday,1,Misty,0.42,0.4242,0.94,0.2537,8,192,200,14,200,200
17043,2012-12-17,Winter,2012,Dec,21,0,Monday,1,Misty,0.42,0.4242,0.94,0.1343,6,114,120,14,120,120
17044,2012-12-17,Winter,2012,Dec,22,0,Monday,1,Misty,0.42,0.4242,0.94,0.1343,5,49,54,14,54,54
17045,2012-12-17,Winter,2012,Dec,23,0,Monday,1,Light_rainsnow,0.42,0.4242,0.94,0.2239,6,41,47,14,47,47
17046,2012-12-18,Winter,2012,Dec,0,0,Tuesday,1,Misty,0.44,0.4394,0.94,0.1343,0,18,18,13,18,18
17047,2012-12-18,Winter,2012,Dec,1,0,Tuesday,1,Misty,0.44,0.4394,0.94,0.1343,0,15,15,13,15,15
17048,2012-12-18,Winter,2012,Dec,2,0,Tuesday,1,Misty,0.44,0.4394,0.88,0.2239,2,5,7,13,7,7
17049,2012-12-18,Winter,2012,Dec,3,0,Tuesday,1,Clear,0.42,0.4242,0.88,0.194,0,5,5,13,5,5
17050,2012-12-18,Winter,2012,Dec,4,0,Tuesday,1,Clear,0.42,0.4242,0.82,0.1642,3,5,8,13,8,8
17051,2012-12-18,Winter,2012,Dec,5,0,Tuesday,1,Clear,0.38,0.3939,0.87,0.0896,0,36,36,13,36,36
17052,2012-12-18,Winter,2012,Dec,6,0,Tuesday,1,Clear,0.36,0.3485,0.93,0.1642,1,117,118,13,118,118
17053,2012-12-18,Winter,2012,Dec,7,0,Tuesday,1,Clear,0.36,0.3485,0.93,0.1343,4,351,355,13,355,355
17054,2012-12-18,Winter,2012,Dec,8,0,Tuesday,1,Clear,0.38,0.3939,0.94,0.0,10,652,662,13,662,662
17055,2012-12-18,Winter,2012,Dec,9,0,Tuesday,1,Clear,0.4,0.4091,0.87,0.0896,19,307,326,13,326,326
17056,2012-12-18,Winter,2012,Dec,10,0,Tuesday,1,Clear,0.44,0.4394,0.77,0.0896,22,162,184,13,184,184
17057,2012-12-18,Winter,2012,Dec,11,0,Tuesday,1,Clear,0.48,0.4697,0.63,0.2239,58,211,269,13,269,269
17058,2012-12-18,Winter,2012,Dec,12,0,Tuesday,1,Light_rainsnow,0.48,0.4697,0.48,0.2537,49,264,313,13,313,313
17059,2012-12-18,Winter,2012,Dec,13,0,Tuesday,1,Clear,0.5,0.4848,0.42,0.2836,51,235,286,13,286,286
17060,2012-12-18,Winter,2012,Dec,14,0,Tuesday,1,Clear,0.46,0.4545,0.47,0.4478,56,191,247,13,247,247
17061,2012-12-18,Winter,2012,Dec,15,0,Tuesday,1,Clear,0.46,0.4545,0.44,0.4925,28,218,246,13,246,246
17062,2012-12-18,Winter,2012,Dec,16,0,Tuesday,1,Clear,0.44,0.4394,0.41,0.4627,40,323,363,13,363,363
17063,2012-12-18,Winter,2012,Dec,17,0,Tuesday,1,Clear,0.4,0.4091,0.47,0.4478,39,533,572,13,572,572
17064,2012-12-18,Winter,2012,Dec,18,0,Tuesday,1,Clear,0.38,0.3939,0.46,0.3284,13,512,525,13,525,525
17065,2012-12-18,Winter,2012,Dec,19,0,Tuesday,1,Clear,0.38,0.3939,0.46,0.3881,19,334,353,13,353,353
17066,2012-12-18,Winter,2012,Dec,20,0,Tuesday,1,Clear,0.36,0.3333,0.5,0.2537,4,264,268,13,268,268
17067,2012-12-18,Winter,2012,Dec,21,0,Tuesday,1,Clear,0.36,0.3485,0.5,0.2239,9,159,168,13,168,168
17068,2012-12-18,Winter,2012,Dec,22,0,Tuesday,1,Clear,0.34,0.3333,0.49,0.0,5,127,132,13,132,132
17069,2012-12-18,Winter,2012,Dec,23,0,Tuesday,1,Clear,0.34,0.3485,0.49,0.0896,1,80,81,13,81,81
17070,2012-12-19,Winter,2012,Dec,0,0,Wednesday,1,Clear,0.3,0.3182,0.61,0.0,6,35,41,12,41,41
17071,2012-12-19,Winter,2012,Dec,1,0,Wednesday,1,Clear,0.3,0.3182,0.65,0.0896,1,14,15,12,15,15
17072,2012-12-19,Winter,2012,Dec,2,0,Wednesday,1,Clear,0.28,0.303,0.65,0.0896,1,2,3,12,3,3
17073,2012-12-19,Winter,2012,Dec,3,0,Wednesday,1,Clear,0.26,0.2727,0.75,0.1343,0,5,5,12,5,5
17074,2012-12-19,Winter,2012,Dec,4,0,Wednesday,1,Clear,0.24,0.2424,0.75,0.1343,1,6,7,12,7,7
17075,2012-12-19,Winter,2012,Dec,5,0,Wednesday,1,Clear,0.26,0.2879,0.75,0.0896,2,29,31,12,31,31
17076,2012-12-19,Winter,2012,Dec,6,0,Wednesday,1,Clear,0.24,0.2576,0.75,0.0896,3,109,112,12,112,112
17077,2012-12-19,Winter,2012,Dec,7,0,Wednesday,1,Clear,0.26,0.2727,0.75,0.1343,3,360,363,12,363,363
17078,2012-12-19,Winter,2012,Dec,8,0,Wednesday,1,Clear,0.24,0.2576,0.87,0.1045,13,665,678,12,678,678
17079,2012-12-19,Winter,2012,Dec,9,0,Wednesday,1,Clear,0.28,0.2879,0.75,0.1045,8,309,317,12,317,317
17080,2012-12-19,Winter,2012,Dec,10,0,Wednesday,1,Clear,0.32,0.3333,0.7,0.1045,17,147,164,12,164,164
17081,2012-12-19,Winter,2012,Dec,11,0,Wednesday,1,Clear,0.4,0.4091,0.54,0.2239,31,169,200,12,200,200
17082,2012-12-19,Winter,2012,Dec,12,0,Wednesday,1,Clear,0.4,0.4091,0.54,0.2836,33,203,236,12,236,236
17083,2012-12-19,Winter,2012,Dec,13,0,Wednesday,1,Clear,0.42,0.4242,0.5,0.194,30,183,213,12,213,213
17084,2012-12-19,Winter,2012,Dec,14,0,Wednesday,1,Clear,0.42,0.4242,0.5,0.194,33,185,218,12,218,218
17085,2012-12-19,Winter,2012,Dec,15,0,Wednesday,1,Clear,0.42,0.4242,0.5,0.2836,28,209,237,12,237,237
17086,2012-12-19,Winter,2012,Dec,16,0,Wednesday,1,Clear,0.42,0.4242,0.5,0.3582,37,297,334,12,334,334
17087,2012-12-19,Winter,2012,Dec,17,0,Wednesday,1,Clear,0.4,0.4091,0.5,0.3881,26,536,562,12,562,562
17088,2012-12-19,Winter,2012,Dec,18,0,Wednesday,1,Clear,0.38,0.3939,0.5,0.3582,23,546,569,12,569,569
17089,2012-12-19,Winter,2012,Dec,19,0,Wednesday,1,Clear,0.38,0.3939,0.5,0.3881,7,329,336,12,336,336
17090,2012-12-19,Winter,2012,Dec,20,0,Wednesday,1,Clear,0.36,0.3485,0.57,0.2239,10,231,241,12,241,241
17091,2012-12-19,Winter,2012,Dec,21,0,Wednesday,1,Clear,0.34,0.3182,0.61,0.2239,4,164,168,12,168,168
17092,2012-12-19,Winter,2012,Dec,22,0,Wednesday,1,Clear,0.34,0.3485,0.61,0.0896,12,117,129,12,129,129
17093,2012-12-19,Winter,2012,Dec,23,0,Wednesday,1,Clear,0.32,0.3333,0.66,0.1343,4,84,88,12,88,88
17094,2012-12-20,Winter,2012,Dec,0,0,Thursday,1,Clear,0.32,0.3333,0.61,0.1343,2,40,42,11,42,42
17095,2012-12-20,Winter,2012,Dec,1,0,Thursday,1,Clear,0.32,0.3485,0.66,0.0,1,19,20,11,20,20
17096,2012-12-20,Winter,2012,Dec,2,0,Thursday,1,Clear,0.32,0.3485,0.66,0.0,2,6,8,11,8,8
17097,2012-12-20,Winter,2012,Dec,3,0,Thursday,1,Misty,0.3,0.3182,0.7,0.0896,1,3,4,11,4,4
17098,2012-12-20,Winter,2012,Dec,4,0,Thursday,1,Misty,0.3,0.3182,0.7,0.0896,0,6,6,11,6,6
17099,2012-12-20,Winter,2012,Dec,5,0,Thursday,1,Misty,0.3,0.3182,0.7,0.1045,0,35,35,11,35,35
17100,2012-12-20,Winter,2012,Dec,6,0,Thursday,1,Misty,0.3,0.3333,0.65,0.0,4,114,118,11,118,118
17101,2012-12-20,Winter,2012,Dec,7,0,Thursday,1,Misty,0.3,0.3333,0.7,0.0,4,346,350,11,350,350
17102,2012-12-20,Winter,2012,Dec,8,0,Thursday,1,Misty,0.3,0.3333,0.7,0.0,14,585,599,11,599,599
17103,2012-12-20,Winter,2012,Dec,9,0,Thursday,1,Misty,0.3,0.3333,0.7,0.0,14,303,317,11,317,317
17104,2012-12-20,Winter,2012,Dec,10,0,Thursday,1,Misty,0.32,0.3333,0.66,0.0,23,138,161,11,161,161
17105,2012-12-20,Winter,2012,Dec,11,0,Thursday,1,Misty,0.34,0.3182,0.57,0.2239,22,168,190,11,190,190
17106,2012-12-20,Winter,2012,Dec,12,0,Thursday,1,Misty,0.36,0.3485,0.53,0.1642,31,181,212,11,212,212
17107,2012-12-20,Winter,2012,Dec,13,0,Thursday,1,Misty,0.36,0.3485,0.57,0.194,46,171,217,11,217,217
17108,2012-12-20,Winter,2012,Dec,14,0,Thursday,1,Misty,0.36,0.3485,0.53,0.194,43,171,214,11,214,214
17109,2012-12-20,Winter,2012,Dec,15,0,Thursday,1,Misty,0.34,0.3333,0.57,0.194,33,216,249,11,249,249
17110,2012-12-20,Winter,2012,Dec,16,0,Thursday,1,Misty,0.34,0.303,0.53,0.3284,21,281,302,11,302,302
17111,2012-12-20,Winter,2012,Dec,17,0,Thursday,1,Misty,0.34,0.3333,0.66,0.194,25,450,475,11,475,475
17112,2012-12-20,Winter,2012,Dec,18,0,Thursday,1,Misty,0.34,0.3333,0.71,0.194,22,359,381,11,381,381
17113,2012-12-20,Winter,2012,Dec,19,0,Thursday,1,Light_rainsnow,0.34,0.3182,0.71,0.2537,3,115,118,11,118,118
17114,2012-12-20,Winter,2012,Dec,20,0,Thursday,1,Light_rainsnow,0.34,0.3333,0.76,0.1642,1,49,50,11,50,50
17115,2012-12-20,Winter,2012,Dec,21,0,Thursday,1,Light_rainsnow,0.34,0.3333,0.76,0.1642,1,25,26,11,26,26
17116,2012-12-20,Winter,2012,Dec,22,0,Thursday,1,Light_rainsnow,0.34,0.3333,0.87,0.194,1,20,21,11,21,21
17117,2012-12-20,Winter,2012,Dec,23,0,Thursday,1,Light_rainsnow,0.4,0.4091,0.82,0.2985,0,13,13,11,13,13
17118,2012-12-21,Spring,2012,Dec,0,0,Friday,1,Light_rainsnow,0.42,0.4242,0.88,0.2985,0,17,17,10,17,17
17119,2012-12-21,Spring,2012,Dec,1,0,Friday,1,Light_rainsnow,0.44,0.4394,0.88,0.3881,2,7,9,10,9,9
17120,2012-12-21,Spring,2012,Dec,2,0,Friday,1,Light_rainsnow,0.46,0.4545,0.94,0.3881,0,3,3,10,3,3
17121,2012-12-21,Spring,2012,Dec,3,0,Friday,1,Light_rainsnow,0.46,0.4545,0.94,0.3881,0,3,3,10,3,3
17122,2012-12-21,Spring,2012,Dec,4,0,Friday,1,Misty,0.36,0.3182,0.71,0.4925,1,5,6,10,6,6
17123,2012-12-21,Spring,2012,Dec,5,0,Friday,1,Misty,0.34,0.303,0.76,0.4179,0,13,13,10,13,13
17124,2012-12-21,Spring,2012,Dec,6,0,Friday,1,Misty,0.34,0.2879,0.57,0.5821,4,76,80,10,80,80
17125,2012-12-21,Spring,2012,Dec,7,0,Friday,1,Misty,0.32,0.3182,0.57,0.194,3,205,208,10,208,208
17126,2012-12-21,Spring,2012,Dec,8,0,Friday,1,Misty,0.32,0.303,0.57,0.2836,8,464,472,10,472,472
17127,2012-12-21,Spring,2012,Dec,9,0,Friday,1,Misty,0.32,0.2727,0.45,0.5522,2,265,267,10,267,267
17128,2012-12-21,Spring,2012,Dec,10,0,Friday,1,Clear,0.32,0.2879,0.42,0.4627,8,146,154,10,154,154
17129,2012-12-21,Spring,2012,Dec,11,0,Friday,1,Misty,0.32,0.2879,0.42,0.4179,12,150,162,10,162,162
17130,2012-12-21,Spring,2012,Dec,12,0,Friday,1,Misty,0.32,0.2879,0.39,0.3582,25,199,224,10,224,224
17131,2012-12-21,Spring,2012,Dec,13,0,Friday,1,Misty,0.32,0.2879,0.39,0.4179,26,214,240,10,240,240
17132,2012-12-21,Spring,2012,Dec,14,0,Friday,1,Misty,0.32,0.2879,0.39,0.4478,20,199,219,10,219,219
17133,2012-12-21,Spring,2012,Dec,15,0,Friday,1,Misty,0.3,0.2727,0.42,0.3881,29,234,263,10,263,263
17134,2012-12-21,Spring,2012,Dec,16,0,Friday,1,Misty,0.3,0.2727,0.39,0.3284,28,253,281,10,281,281
17135,2012-12-21,Spring,2012,Dec,17,0,Friday,1,Misty,0.26,0.2273,0.56,0.3284,24,297,321,10,321,321
17136,2012-12-21,Spring,2012,Dec,18,0,Friday,1,Misty,0.26,0.2273,0.56,0.2985,7,236,243,10,243,243
17137,2012-12-21,Spring,2012,Dec,19,0,Friday,1,Clear,0.28,0.2576,0.45,0.2985,5,148,153,10,153,153
17138,2012-12-21,Spring,2012,Dec,20,0,Friday,1,Clear,0.28,0.2727,0.41,0.2537,8,104,112,10,112,112
17139,2012-12-21,Spring,2012,Dec,21,0,Friday,1,Clear,0.26,0.2273,0.41,0.4179,2,68,70,10,70,70
17140,2012-12-21,Spring,2012,Dec,22,0,Friday,1,Clear,0.26,0.2273,0.44,0.2985,6,57,63,10,63,63
17141,2012-12-21,Spring,2012,Dec,23,0,Friday,1,Clear,0.26,0.2424,0.44,0.2836,1,39,40,10,40,40
17142,2012-12-22,Spring,2012,Dec,0,0,Saturday,0,Clear,0.26,0.2121,0.44,0.5821,1,30,31,9,31,31
17143,2012-12-22,Spring,2012,Dec,1,0,Saturday,0,Clear,0.26,0.2121,0.44,0.4478,1,34,35,9,35,35
17144,2012-12-22,Spring,2012,Dec,2,0,Saturday,0,Clear,0.26,0.2121,0.44,0.5224,0,23,23,9,23,23
17145,2012-12-22,Spring,2012,Dec,3,0,Saturday,0,Clear,0.26,0.2121,0.48,0.4478,0,7,7,9,7,7
17146,2012-12-22,Spring,2012,Dec,4,0,Saturday,0,Clear,0.26,0.2576,0.48,0.194,3,2,5,9,5,5
17147,2012-12-22,Spring,2012,Dec,5,0,Saturday,0,Clear,0.26,0.2273,0.48,0.4179,0,5,5,9,5,5
17148,2012-12-22,Spring,2012,Dec,6,0,Saturday,0,Clear,0.26,0.2273,0.44,0.4179,0,13,13,9,13,13
17149,2012-12-22,Spring,2012,Dec,7,0,Saturday,0,Clear,0.26,0.2273,0.44,0.4179,2,18,20,9,20,20
17150,2012-12-22,Spring,2012,Dec,8,0,Saturday,0,Clear,0.26,0.2121,0.44,0.6119,0,29,29,9,29,29
17151,2012-12-22,Spring,2012,Dec,9,0,Saturday,0,Clear,0.26,0.2273,0.48,0.3881,13,77,90,9,90,90
17152,2012-12-22,Spring,2012,Dec,10,0,Saturday,0,Clear,0.26,0.2273,0.48,0.3284,13,105,118,9,118,118
17153,2012-12-22,Spring,2012,Dec,11,0,Saturday,0,Clear,0.28,0.2576,0.41,0.3582,29,130,159,9,159,159
17154,2012-12-22,Spring,2012,Dec,12,0,Saturday,0,Clear,0.3,0.2576,0.36,0.6567,18,128,146,9,146,146
17155,2012-12-22,Spring,2012,Dec,13,0,Saturday,0,Clear,0.32,0.2879,0.36,0.4478,23,135,158,9,158,158
17156,2012-12-22,Spring,2012,Dec,14,0,Saturday,0,Clear,0.32,0.2879,0.36,0.4627,20,141,161,9,161,161
17157,2012-12-22,Spring,2012,Dec,15,0,Saturday,0,Clear,0.32,0.2727,0.33,0.5821,14,139,153,9,153,153
17158,2012-12-22,Spring,2012,Dec,16,0,Saturday,0,Clear,0.3,0.2727,0.39,0.4478,23,124,147,9,147,147
17159,2012-12-22,Spring,2012,Dec,17,0,Saturday,0,Clear,0.28,0.2576,0.41,0.2985,15,99,114,9,114,114
17160,2012-12-22,Spring,2012,Dec,18,0,Saturday,0,Clear,0.26,0.2121,0.44,0.4627,7,75,82,9,82,82
17161,2012-12-22,Spring,2012,Dec,19,0,Saturday,0,Clear,0.24,0.2121,0.48,0.3582,9,51,60,9,60,60
17162,2012-12-22,Spring,2012,Dec,20,0,Saturday,0,Clear,0.24,0.2424,0.48,0.1642,6,55,61,9,61,61
17163,2012-12-22,Spring,2012,Dec,21,0,Saturday,0,Clear,0.22,0.2121,0.51,0.2836,4,49,53,9,53,53
17164,2012-12-22,Spring,2012,Dec,22,0,Saturday,0,Clear,0.22,0.2121,0.51,0.2836,1,38,39,9,39,39
17165,2012-12-22,Spring,2012,Dec,23,0,Saturday,0,Clear,0.22,0.2273,0.51,0.194,3,37,40,9,40,40
17166,2012-12-23,Spring,2012,Dec,0,0,Sunday,0,Clear,0.22,0.2121,0.47,0.2836,3,24,27,8,27,27
17167,2012-12-23,Spring,2012,Dec,1,0,Sunday,0,Clear,0.22,0.2273,0.47,0.194,1,19,20,8,20,20
17168,2012-12-23,Spring,2012,Dec,2,0,Sunday,0,Clear,0.2,0.2121,0.51,0.1642,1,17,18,8,18,18
17169,2012-12-23,Spring,2012,Dec,3,0,Sunday,0,Clear,0.2,0.2121,0.51,0.1343,0,9,9,8,9,9
17170,2012-12-23,Spring,2012,Dec,4,0,Sunday,0,Clear,0.2,0.2121,0.47,0.1343,1,3,4,8,4,4
17171,2012-12-23,Spring,2012,Dec,5,0,Sunday,0,Clear,0.2,0.2576,0.51,0.0,0,6,6,8,6,6
17172,2012-12-23,Spring,2012,Dec,6,0,Sunday,0,Clear,0.16,0.197,0.64,0.0896,4,5,9,8,9,9
17173,2012-12-23,Spring,2012,Dec,7,0,Sunday,0,Clear,0.16,0.197,0.64,0.0896,3,16,19,8,19,19
17174,2012-12-23,Spring,2012,Dec,8,0,Sunday,0,Clear,0.14,0.1667,0.69,0.1045,5,43,48,8,48,48
17175,2012-12-23,Spring,2012,Dec,9,0,Sunday,0,Clear,0.2,0.2273,0.59,0.1045,7,49,56,8,56,56
17176,2012-12-23,Spring,2012,Dec,10,0,Sunday,0,Clear,0.22,0.2273,0.64,0.194,26,67,93,8,93,93
17177,2012-12-23,Spring,2012,Dec,11,0,Sunday,0,Clear,0.24,0.2273,0.52,0.194,48,104,152,8,152,152
17178,2012-12-23,Spring,2012,Dec,12,0,Sunday,0,Clear,0.3,0.2879,0.42,0.194,52,144,196,8,196,196
17179,2012-12-23,Spring,2012,Dec,13,0,Sunday,0,Clear,0.32,0.303,0.39,0.2239,63,123,186,8,186,186
17180,2012-12-23,Spring,2012,Dec,14,0,Sunday,0,Clear,0.34,0.303,0.31,0.2985,57,118,175,8,175,175
17181,2012-12-23,Spring,2012,Dec,15,0,Sunday,0,Clear,0.34,0.3333,0.34,0.1343,39,98,137,8,137,137
17182,2012-12-23,Spring,2012,Dec,16,0,Sunday,0,Clear,0.34,0.3333,0.34,0.194,53,137,190,8,190,190
17183,2012-12-23,Spring,2012,Dec,17,0,Sunday,0,Clear,0.32,0.3182,0.49,0.194,21,93,114,8,114,114
17184,2012-12-23,Spring,2012,Dec,18,0,Sunday,0,Clear,0.3,0.303,0.45,0.1642,8,85,93,8,93,93
17185,2012-12-23,Spring,2012,Dec,19,0,Sunday,0,Clear,0.3,0.3333,0.42,0.0,4,54,58,8,58,58
17186,2012-12-23,Spring,2012,Dec,20,0,Sunday,0,Clear,0.26,0.303,0.65,0.0,0,52,52,8,52,52
17187,2012-12-23,Spring,2012,Dec,21,0,Sunday,0,Clear,0.24,0.2879,0.7,0.0,4,38,42,8,42,42
17188,2012-12-23,Spring,2012,Dec,22,0,Sunday,0,Clear,0.24,0.2576,0.6,0.1045,5,53,58,8,58,58
17189,2012-12-23,Spring,2012,Dec,23,0,Sunday,0,Clear,0.24,0.2879,0.6,0.0,3,22,25,8,25,25
17190,2012-12-24,Spring,2012,Dec,0,0,Monday,1,Clear,0.22,0.2727,0.69,0.0,0,12,12,7,12,12
17191,2012-12-24,Spring,2012,Dec,1,0,Monday,1,Clear,0.22,0.2727,0.69,0.0,0,11,11,7,11,11
17192,2012-12-24,Spring,2012,Dec,2,0,Monday,1,Clear,0.2,0.2576,0.75,0.0,0,5,5,7,5,5
17193,2012-12-24,Spring,2012,Dec,3,0,Monday,1,Clear,0.2,0.2576,0.75,0.0,1,2,3,7,3,3
17194,2012-12-24,Spring,2012,Dec,5,0,Monday,1,Clear,0.18,0.197,0.8,0.1343,0,9,9,7,9,9
17195,2012-12-24,Spring,2012,Dec,6,0,Monday,1,Clear,0.2,0.2576,0.75,0.0,1,16,17,7,17,17
17196,2012-12-24,Spring,2012,Dec,7,0,Monday,1,Clear,0.2,0.2576,0.69,0.0,3,27,30,7,30,30
17197,2012-12-24,Spring,2012,Dec,8,0,Monday,1,Clear,0.22,0.2727,0.69,0.0,4,62,66,7,66,66
17198,2012-12-24,Spring,2012,Dec,9,0,Monday,1,Misty,0.24,0.2576,0.65,0.1045,17,68,85,7,85,85
17199,2012-12-24,Spring,2012,Dec,10,0,Monday,1,Misty,0.26,0.303,0.65,0.0,21,82,103,7,103,103
17200,2012-12-24,Spring,2012,Dec,11,0,Monday,1,Misty,0.26,0.2576,0.6,0.1642,20,104,124,7,124,124
17201,2012-12-24,Spring,2012,Dec,12,0,Monday,1,Misty,0.28,0.303,0.56,0.0896,22,113,135,7,135,135
17202,2012-12-24,Spring,2012,Dec,13,0,Monday,1,Light_rainsnow,0.24,0.2576,0.81,0.1045,16,54,70,7,70,70
17203,2012-12-24,Spring,2012,Dec,14,0,Monday,1,Light_rainsnow,0.24,0.2576,0.87,0.1045,13,33,46,7,46,46
17204,2012-12-24,Spring,2012,Dec,15,0,Monday,1,Light_rainsnow,0.24,0.2273,0.87,0.2239,6,27,33,7,33,33
17205,2012-12-24,Spring,2012,Dec,16,0,Monday,1,Light_rainsnow,0.24,0.2273,0.87,0.2239,6,27,33,7,33,33
17206,2012-12-24,Spring,2012,Dec,17,0,Monday,1,Light_rainsnow,0.24,0.2424,0.93,0.1642,7,19,26,7,26,26
17207,2012-12-24,Spring,2012,Dec,18,0,Monday,1,Light_rainsnow,0.24,0.2576,0.93,0.1045,6,20,26,7,26,26
17208,2012-12-24,Spring,2012,Dec,19,0,Monday,1,Misty,0.24,0.2424,0.93,0.1343,4,14,18,7,18,18
17209,2012-12-24,Spring,2012,Dec,20,0,Monday,1,Light_rainsnow,0.24,0.2424,0.93,0.1343,6,17,23,7,23,23
17210,2012-12-24,Spring,2012,Dec,21,0,Monday,1,Light_rainsnow,0.24,0.2576,0.93,0.0896,13,9,22,7,22,22
17211,2012-12-24,Spring,2012,Dec,22,0,Monday,1,Misty,0.24,0.2879,0.93,0.0,7,5,12,7,12,12
17212,2012-12-24,Spring,2012,Dec,23,0,Monday,1,Light_rainsnow,0.24,0.2879,0.93,0.0,1,10,11,7,11,11
17213,2012-12-25,Spring,2012,Dec,0,1,Tuesday,0,Light_rainsnow,0.24,0.2576,0.93,0.0896,3,10,13,6,13,13
17214,2012-12-25,Spring,2012,Dec,1,1,Tuesday,0,Misty,0.26,0.2576,0.87,0.1642,0,13,13,6,13,13
17215,2012-12-25,Spring,2012,Dec,2,1,Tuesday,0,Misty,0.26,0.2576,0.87,0.1642,0,7,7,6,7,7
17216,2012-12-25,Spring,2012,Dec,4,1,Tuesday,0,Misty,0.24,0.2576,0.87,0.0896,0,1,1,6,1,1
17217,2012-12-25,Spring,2012,Dec,5,1,Tuesday,0,Misty,0.22,0.2273,0.93,0.1343,2,1,3,6,3,3
17218,2012-12-25,Spring,2012,Dec,6,1,Tuesday,0,Misty,0.22,0.2273,0.93,0.1343,1,6,7,6,7,7
17219,2012-12-25,Spring,2012,Dec,7,1,Tuesday,0,Misty,0.22,0.2273,0.93,0.1642,0,6,6,6,6,6
17220,2012-12-25,Spring,2012,Dec,8,1,Tuesday,0,Misty,0.24,0.2879,0.87,0.0,1,10,11,6,11,11
17221,2012-12-25,Spring,2012,Dec,9,1,Tuesday,0,Misty,0.24,0.2576,0.87,0.0,7,21,28,6,28,28
17222,2012-12-25,Spring,2012,Dec,10,1,Tuesday,0,Clear,0.28,0.3182,0.81,0.0,11,21,32,6,32,32
17223,2012-12-25,Spring,2012,Dec,11,1,Tuesday,0,Clear,0.3,0.3182,0.75,0.0896,43,43,86,6,86,86
17224,2012-12-25,Spring,2012,Dec,12,1,Tuesday,0,Clear,0.32,0.3333,0.76,0.0896,62,52,114,6,114,114
17225,2012-12-25,Spring,2012,Dec,13,1,Tuesday,0,Clear,0.4,0.4091,0.5,0.3284,75,46,121,6,121,121
17226,2012-12-25,Spring,2012,Dec,14,1,Tuesday,0,Clear,0.38,0.3939,0.46,0.2985,58,68,126,6,126,126
17227,2012-12-25,Spring,2012,Dec,15,1,Tuesday,0,Clear,0.36,0.3333,0.5,0.2537,51,56,107,6,107,107
17228,2012-12-25,Spring,2012,Dec,16,1,Tuesday,0,Misty,0.36,0.3333,0.5,0.2537,48,38,86,6,86,86
17229,2012-12-25,Spring,2012,Dec,17,1,Tuesday,0,Misty,0.32,0.303,0.57,0.2537,16,34,50,6,50,50
17230,2012-12-25,Spring,2012,Dec,18,1,Tuesday,0,Misty,0.32,0.303,0.66,0.2537,20,23,43,6,43,43
17231,2012-12-25,Spring,2012,Dec,19,1,Tuesday,0,Misty,0.32,0.303,0.66,0.2239,16,20,36,6,36,36
17232,2012-12-25,Spring,2012,Dec,20,1,Tuesday,0,Misty,0.32,0.303,0.66,0.2836,11,29,40,6,40,40
17233,2012-12-25,Spring,2012,Dec,21,1,Tuesday,0,Misty,0.3,0.2879,0.65,0.194,8,26,34,6,34,34
17234,2012-12-25,Spring,2012,Dec,22,1,Tuesday,0,Misty,0.3,0.303,0.7,0.1642,3,16,19,6,19,19
17235,2012-12-25,Spring,2012,Dec,23,1,Tuesday,0,Misty,0.28,0.2727,0.65,0.2537,4,26,30,6,30,30
17236,2012-12-26,Spring,2012,Dec,0,0,Wednesday,1,Misty,0.28,0.2727,0.65,0.2537,1,8,9,5,9,9
17237,2012-12-26,Spring,2012,Dec,1,0,Wednesday,1,Misty,0.26,0.2273,0.65,0.2985,0,7,7,5,7,7
17238,2012-12-26,Spring,2012,Dec,2,0,Wednesday,1,Misty,0.26,0.2273,0.65,0.2985,0,1,1,5,1,1
17239,2012-12-26,Spring,2012,Dec,3,0,Wednesday,1,Misty,0.24,0.2121,0.7,0.3582,0,2,2,5,2,2
17240,2012-12-26,Spring,2012,Dec,4,0,Wednesday,1,Clear,0.22,0.197,0.69,0.3582,0,2,2,5,2,2
17241,2012-12-26,Spring,2012,Dec,5,0,Wednesday,1,Misty,0.22,0.2121,0.69,0.2836,0,11,11,5,11,11
17242,2012-12-26,Spring,2012,Dec,6,0,Wednesday,1,Misty,0.22,0.2121,0.69,0.2239,0,36,36,5,36,36
17243,2012-12-26,Spring,2012,Dec,7,0,Wednesday,1,Light_rainsnow,0.2,0.1818,0.86,0.3284,0,26,26,5,26,26
17244,2012-12-26,Spring,2012,Dec,8,0,Wednesday,1,Light_rainsnow,0.2,0.1818,0.86,0.3284,0,31,31,5,31,31
17245,2012-12-26,Spring,2012,Dec,9,0,Wednesday,1,Light_rainsnow,0.2,0.1818,0.86,0.3284,1,22,23,5,23,23
17246,2012-12-26,Spring,2012,Dec,10,0,Wednesday,1,Light_rainsnow,0.2,0.1818,0.86,0.2985,0,8,8,5,8,8
17247,2012-12-26,Spring,2012,Dec,11,0,Wednesday,1,Light_rainsnow,0.2,0.1667,0.86,0.4627,0,10,10,5,10,10
17248,2012-12-26,Spring,2012,Dec,12,0,Wednesday,1,Light_rainsnow,0.22,0.197,0.87,0.3284,0,10,10,5,10,10
17249,2012-12-26,Spring,2012,Dec,13,0,Wednesday,1,Light_rainsnow,0.22,0.197,0.87,0.3284,0,15,15,5,15,15
17250,2012-12-26,Spring,2012,Dec,14,0,Wednesday,1,Light_rainsnow,0.22,0.2121,0.93,0.2537,0,20,20,5,20,20
17251,2012-12-26,Spring,2012,Dec,15,0,Wednesday,1,Light_rainsnow,0.26,0.2273,0.87,0.3582,0,13,13,5,13,13
17252,2012-12-26,Spring,2012,Dec,16,0,Wednesday,1,Light_rainsnow,0.26,0.2273,0.87,0.3582,0,13,13,5,13,13
17253,2012-12-26,Spring,2012,Dec,17,0,Wednesday,1,Light_rainsnow,0.26,0.2273,0.93,0.3582,2,51,53,5,53,53
17254,2012-12-26,Spring,2012,Dec,18,0,Wednesday,1,Light_rainsnow,0.28,0.2576,0.93,0.2985,1,42,43,5,43,43
17255,2012-12-26,Spring,2012,Dec,19,0,Wednesday,1,Light_rainsnow,0.3,0.2879,0.87,0.194,2,33,35,5,35,35
17256,2012-12-26,Spring,2012,Dec,20,0,Wednesday,1,Light_rainsnow,0.32,0.303,0.93,0.2537,0,32,32,5,32,32
17257,2012-12-26,Spring,2012,Dec,21,0,Wednesday,1,Misty,0.3,0.2727,0.87,0.2985,0,20,20,5,20,20
17258,2012-12-26,Spring,2012,Dec,22,0,Wednesday,1,Light_rainsnow,0.24,0.197,0.93,0.4478,0,11,11,5,11,11
17259,2012-12-26,Spring,2012,Dec,23,0,Wednesday,1,Light_rainsnow,0.26,0.2273,0.87,0.2985,2,8,10,5,10,10
17260,2012-12-27,Spring,2012,Dec,0,0,Thursday,1,Light_rainsnow,0.26,0.2273,0.87,0.2985,0,3,3,4,3,3
17261,2012-12-27,Spring,2012,Dec,1,0,Thursday,1,Light_rainsnow,0.24,0.197,0.93,0.4478,0,5,5,4,5,5
17262,2012-12-27,Spring,2012,Dec,2,0,Thursday,1,Misty,0.24,0.197,0.87,0.4478,0,2,2,4,2,2
17263,2012-12-27,Spring,2012,Dec,3,0,Thursday,1,Misty,0.24,0.2273,0.87,0.2239,0,1,1,4,1,1
17264,2012-12-27,Spring,2012,Dec,4,0,Thursday,1,Misty,0.24,0.2121,0.87,0.3284,0,3,3,4,3,3
17265,2012-12-27,Spring,2012,Dec,5,0,Thursday,1,Clear,0.24,0.2424,0.75,0.1642,1,10,11,4,11,11
17266,2012-12-27,Spring,2012,Dec,6,0,Thursday,1,Clear,0.24,0.197,0.7,0.4925,0,45,45,4,45,45
17267,2012-12-27,Spring,2012,Dec,7,0,Thursday,1,Clear,0.24,0.2273,0.7,0.2239,0,90,90,4,90,90
17268,2012-12-27,Spring,2012,Dec,8,0,Thursday,1,Clear,0.26,0.2273,0.65,0.3582,2,206,208,4,208,208
17269,2012-12-27,Spring,2012,Dec,9,0,Thursday,1,Clear,0.26,0.2121,0.6,0.4925,6,127,133,4,133,133
17270,2012-12-27,Spring,2012,Dec,10,0,Thursday,1,Clear,0.28,0.2273,0.56,0.5224,8,67,75,4,75,75
17271,2012-12-27,Spring,2012,Dec,11,0,Thursday,1,Misty,0.28,0.2424,0.56,0.4478,23,80,103,4,103,103
17272,2012-12-27,Spring,2012,Dec,12,0,Thursday,1,Clear,0.3,0.2727,0.49,0.4627,22,87,109,4,109,109
17273,2012-12-27,Spring,2012,Dec,13,0,Thursday,1,Clear,0.3,0.2727,0.49,0.4627,19,99,118,4,118,118
17274,2012-12-27,Spring,2012,Dec,14,0,Thursday,1,Misty,0.26,0.2121,0.56,0.5224,25,94,119,4,119,119
17275,2012-12-27,Spring,2012,Dec,15,0,Thursday,1,Misty,0.26,0.2121,0.56,0.4478,31,89,120,4,120,120
17276,2012-12-27,Spring,2012,Dec,16,0,Thursday,1,Misty,0.26,0.2424,0.52,0.2836,23,151,174,4,174,174
17277,2012-12-27,Spring,2012,Dec,17,0,Thursday,1,Misty,0.26,0.2424,0.52,0.2836,30,227,257,4,257,257
17278,2012-12-27,Spring,2012,Dec,18,0,Thursday,1,Misty,0.24,0.2273,0.6,0.2537,9,188,197,4,197,197
17279,2012-12-27,Spring,2012,Dec,19,0,Thursday,1,Clear,0.24,0.2121,0.6,0.2836,11,106,117,4,117,117
17280,2012-12-27,Spring,2012,Dec,20,0,Thursday,1,Clear,0.24,0.2424,0.6,0.1642,12,79,91,4,91,91
17281,2012-12-27,Spring,2012,Dec,21,0,Thursday,1,Misty,0.24,0.2273,0.6,0.2537,12,51,63,4,63,63
17282,2012-12-27,Spring,2012,Dec,22,0,Thursday,1,Misty,0.24,0.2121,0.6,0.2836,11,33,44,4,44,44
17283,2012-12-27,Spring,2012,Dec,23,0,Thursday,1,Misty,0.24,0.2273,0.6,0.2537,2,24,26,4,26,26
17284,2012-12-28,Spring,2012,Dec,0,0,Friday,1,Misty,0.24,0.2424,0.6,0.1642,3,22,25,3,25,25
17285,2012-12-28,Spring,2012,Dec,1,0,Friday,1,Clear,0.24,0.2273,0.6,0.194,0,9,9,3,9,9
17286,2012-12-28,Spring,2012,Dec,2,0,Friday,1,Clear,0.24,0.2273,0.6,0.2537,0,5,5,3,5,5
17287,2012-12-28,Spring,2012,Dec,3,0,Friday,1,Misty,0.24,0.2424,0.6,0.1642,0,2,2,3,2,2
17288,2012-12-28,Spring,2012,Dec,4,0,Friday,1,Misty,0.24,0.2576,0.6,0.1045,0,4,4,3,4,4
17289,2012-12-28,Spring,2012,Dec,5,0,Friday,1,Misty,0.24,0.2576,0.6,0.0896,0,15,15,3,15,15
17290,2012-12-28,Spring,2012,Dec,6,0,Friday,1,Clear,0.22,0.2121,0.64,0.2836,2,49,51,3,51,51
17291,2012-12-28,Spring,2012,Dec,7,0,Friday,1,Clear,0.22,0.2273,0.64,0.1642,1,111,112,3,112,112
17292,2012-12-28,Spring,2012,Dec,8,0,Friday,1,Misty,0.24,0.2424,0.6,0.1343,1,238,239,3,239,239
17293,2012-12-28,Spring,2012,Dec,9,0,Friday,1,Misty,0.24,0.2121,0.6,0.2836,18,173,191,3,191,191
17294,2012-12-28,Spring,2012,Dec,10,0,Friday,1,Misty,0.26,0.2424,0.56,0.2537,77,85,162,3,162,162
17295,2012-12-28,Spring,2012,Dec,11,0,Friday,1,Misty,0.28,0.2727,0.52,0.2239,71,107,178,3,178,178
17296,2012-12-28,Spring,2012,Dec,12,0,Friday,1,Misty,0.3,0.303,0.49,0.1343,72,150,222,3,222,222
17297,2012-12-28,Spring,2012,Dec,13,0,Friday,1,Misty,0.3,0.303,0.49,0.1343,76,146,222,3,222,222
17298,2012-12-28,Spring,2012,Dec,14,0,Friday,1,Misty,0.3,0.303,0.49,0.1343,84,177,261,3,261,261
17299,2012-12-28,Spring,2012,Dec,15,0,Friday,1,Misty,0.3,0.3182,0.49,0.0,74,151,225,3,225,225
17300,2012-12-28,Spring,2012,Dec,16,0,Friday,1,Clear,0.3,0.303,0.49,0.1343,42,208,250,3,250,250
17301,2012-12-28,Spring,2012,Dec,17,0,Friday,1,Clear,0.24,0.2424,0.6,0.1343,43,228,271,3,271,271
17302,2012-12-28,Spring,2012,Dec,18,0,Friday,1,Clear,0.24,0.2424,0.6,0.1343,16,197,213,3,213,213
17303,2012-12-28,Spring,2012,Dec,19,0,Friday,1,Misty,0.24,0.2273,0.65,0.194,15,113,128,3,128,128
17304,2012-12-28,Spring,2012,Dec,20,0,Friday,1,Misty,0.24,0.2576,0.65,0.1045,14,83,97,3,97,97
17305,2012-12-28,Spring,2012,Dec,21,0,Friday,1,Misty,0.24,0.2424,0.7,0.1343,17,75,92,3,92,92
17306,2012-12-28,Spring,2012,Dec,22,0,Friday,1,Misty,0.24,0.2576,0.7,0.0896,13,49,62,3,62,62
17307,2012-12-28,Spring,2012,Dec,23,0,Friday,1,Misty,0.24,0.2576,0.65,0.0896,5,54,59,3,59,59
17308,2012-12-29,Spring,2012,Dec,0,0,Saturday,0,Misty,0.24,0.2424,0.7,0.0,1,25,26,2,26,26
17309,2012-12-29,Spring,2012,Dec,1,0,Saturday,0,Misty,0.24,0.2424,0.75,0.0896,6,31,37,2,37,37
17310,2012-12-29,Spring,2012,Dec,2,0,Saturday,0,Misty,0.24,0.2424,0.7,0.0,1,18,19,2,19,19
17311,2012-12-29,Spring,2012,Dec,3,0,Saturday,0,Misty,0.24,0.2424,0.75,0.0,1,5,6,2,6,6
17312,2012-12-29,Spring,2012,Dec,4,0,Saturday,0,Misty,0.24,0.2424,0.75,0.0896,0,3,3,2,3,3
17313,2012-12-29,Spring,2012,Dec,5,0,Saturday,0,Misty,0.24,0.2424,0.75,0.0896,0,3,3,2,3,3
17314,2012-12-29,Spring,2012,Dec,6,0,Saturday,0,Misty,0.26,0.2424,0.7,0.1045,0,7,7,2,7,7
17315,2012-12-29,Spring,2012,Dec,7,0,Saturday,0,Misty,0.26,0.2424,0.7,0.1343,1,17,18,2,18,18
17316,2012-12-29,Spring,2012,Dec,8,0,Saturday,0,Misty,0.26,0.2424,0.81,0.0,9,35,44,2,44,44
17317,2012-12-29,Spring,2012,Dec,9,0,Saturday,0,Misty,0.26,0.2424,0.81,0.0,16,33,49,2,49,49
17318,2012-12-29,Spring,2012,Dec,10,0,Saturday,0,Light_rainsnow,0.26,0.2424,0.81,0.1343,6,35,41,2,41,41
17319,2012-12-29,Spring,2012,Dec,11,0,Saturday,0,Light_rainsnow,0.2,0.2424,0.93,0.0896,7,38,45,2,45,45
17320,2012-12-29,Spring,2012,Dec,12,0,Saturday,0,Light_rainsnow,0.2,0.2424,1.0,0.0,5,43,48,2,48,48
17321,2012-12-29,Spring,2012,Dec,13,0,Saturday,0,Light_rainsnow,0.2,0.2424,1.0,0.0,13,71,84,2,84,84
17322,2012-12-29,Spring,2012,Dec,14,0,Saturday,0,Misty,0.24,0.2424,0.87,0.0896,10,88,98,2,98,98
17323,2012-12-29,Spring,2012,Dec,15,0,Saturday,0,Misty,0.24,0.2424,0.87,0.0,19,110,129,2,129,129
17324,2012-12-29,Spring,2012,Dec,16,0,Saturday,0,Clear,0.3,0.2424,0.75,0.1045,22,125,147,2,147,147
17325,2012-12-29,Spring,2012,Dec,17,0,Saturday,0,Clear,0.26,0.2424,0.79,0.1045,18,100,118,2,118,118
17326,2012-12-29,Spring,2012,Dec,18,0,Saturday,0,Clear,0.3,0.2424,0.7,0.194,8,102,110,2,110,110
17327,2012-12-29,Spring,2012,Dec,19,0,Saturday,0,Misty,0.3,0.2424,0.61,0.2537,7,90,97,2,97,97
17328,2012-12-29,Spring,2012,Dec,20,0,Saturday,0,Misty,0.3,0.2424,0.56,0.5522,2,64,66,2,66,66
17329,2012-12-29,Spring,2012,Dec,21,0,Saturday,0,Misty,0.28,0.2424,0.56,0.4925,4,56,60,2,60,60
17330,2012-12-29,Spring,2012,Dec,22,0,Saturday,0,Misty,0.26,0.2424,0.6,0.4627,3,51,54,2,54,54
17331,2012-12-29,Spring,2012,Dec,23,0,Saturday,0,Misty,0.26,0.2424,0.6,0.0,0,32,32,2,32,32
17332,2012-12-30,Spring,2012,Dec,0,0,Sunday,0,Misty,0.26,0.2576,0.6,0.1642,0,41,41,1,41,41
17333,2012-12-30,Spring,2012,Dec,1,0,Sunday,0,Misty,0.26,0.2273,0.56,0.4179,1,27,28,1,28,28
17334,2012-12-30,Spring,2012,Dec,2,0,Sunday,0,Misty,0.26,0.2424,0.56,0.2836,0,19,19,1,19,19
17335,2012-12-30,Spring,2012,Dec,3,0,Sunday,0,Misty,0.26,0.2273,0.56,0.4179,1,14,15,1,15,15
17336,2012-12-30,Spring,2012,Dec,4,0,Sunday,0,Misty,0.26,0.2576,0.56,0.2239,0,7,7,1,7,7
17337,2012-12-30,Spring,2012,Dec,5,0,Sunday,0,Misty,0.26,0.2273,0.48,0.2985,0,2,2,1,2,2
17338,2012-12-30,Spring,2012,Dec,6,0,Sunday,0,Misty,0.24,0.197,0.52,0.4179,1,7,8,1,8,8
17339,2012-12-30,Spring,2012,Dec,7,0,Sunday,0,Clear,0.24,0.2121,0.56,0.3582,0,13,13,1,13,13
17340,2012-12-30,Spring,2012,Dec,8,0,Sunday,0,Clear,0.24,0.197,0.52,0.4627,1,32,33,1,33,33
17341,2012-12-30,Spring,2012,Dec,9,0,Sunday,0,Clear,0.24,0.2121,0.52,0.3881,9,65,74,1,74,74
17342,2012-12-30,Spring,2012,Dec,10,0,Sunday,0,Clear,0.26,0.2121,0.41,0.5821,31,91,122,1,122,122
17343,2012-12-30,Spring,2012,Dec,11,0,Sunday,0,Clear,0.26,0.2273,0.41,0.4179,33,103,136,1,136,136
17344,2012-12-30,Spring,2012,Dec,12,0,Sunday,0,Clear,0.28,0.2273,0.36,0.5821,47,97,144,1,144,144
17345,2012-12-30,Spring,2012,Dec,13,0,Sunday,0,Clear,0.3,0.2576,0.36,0.6567,49,120,169,1,169,169
17346,2012-12-30,Spring,2012,Dec,14,0,Sunday,0,Clear,0.3,0.2727,0.36,0.4627,39,121,160,1,160,160
17347,2012-12-30,Spring,2012,Dec,15,0,Sunday,0,Clear,0.28,0.2576,0.38,0.3284,37,101,138,1,138,138
17348,2012-12-30,Spring,2012,Dec,16,0,Sunday,0,Clear,0.28,0.2424,0.38,0.4179,31,102,133,1,133,133
17349,2012-12-30,Spring,2012,Dec,17,0,Sunday,0,Clear,0.26,0.2273,0.41,0.3284,26,97,123,1,123,123
17350,2012-12-30,Spring,2012,Dec,18,0,Sunday,0,Misty,0.24,0.2121,0.44,0.2985,12,113,125,1,125,125
17351,2012-12-30,Spring,2012,Dec,19,0,Sunday,0,Clear,0.34,0.3636,0.61,0.0,16,86,102,1,102,102
17352,2012-12-30,Spring,2012,Dec,20,0,Sunday,0,Clear,0.22,0.197,0.47,0.3284,9,63,72,1,72,72
17353,2012-12-30,Spring,2012,Dec,21,0,Sunday,0,Clear,0.2,0.2121,0.51,0.1642,5,42,47,1,47,47
17354,2012-12-30,Spring,2012,Dec,22,0,Sunday,0,Clear,0.2,0.197,0.55,0.194,6,30,36,1,36,36
17355,2012-12-30,Spring,2012,Dec,23,0,Sunday,0,Clear,0.2,0.197,0.51,0.2239,10,39,49,1,49,49
17356,2012-12-31,Spring,2012,Dec,0,0,Monday,1,Clear,0.18,0.1818,0.55,0.194,4,30,34,0,34,34
17357,2012-12-31,Spring,2012,Dec,1,0,Monday,1,Clear,0.18,0.1818,0.55,0.194,6,13,19,0,19,19
17358,2012-12-31,Spring,2012,Dec,2,0,Monday,1,Clear,0.16,0.1667,0.59,0.1642,3,8,11,0,11,11
17359,2012-12-31,Spring,2012,Dec,3,0,Monday,1,Clear,0.16,0.1818,0.59,0.1045,0,1,1,0,1,1
17360,2012-12-31,Spring,2012,Dec,4,0,Monday,1,Clear,0.14,0.1667,0.69,0.1045,0,3,3,0,3,3
17361,2012-12-31,Spring,2012,Dec,5,0,Monday,1,Clear,0.16,0.1515,0.64,0.194,0,9,9,0,9,9
17362,2012-12-31,Spring,2012,Dec,6,0,Monday,1,Clear,0.16,0.1667,0.64,0.1642,0,40,40,0,40,40
17363,2012-12-31,Spring,2012,Dec,7,0,Monday,1,Clear,0.16,0.1818,0.64,0.1343,2,83,85,0,85,85
17364,2012-12-31,Spring,2012,Dec,8,0,Monday,1,Clear,0.14,0.1515,0.69,0.1343,9,187,196,0,196,196
17365,2012-12-31,Spring,2012,Dec,9,0,Monday,1,Misty,0.18,0.2121,0.64,0.1045,13,144,157,0,157,157
17366,2012-12-31,Spring,2012,Dec,10,0,Monday,1,Misty,0.2,0.2121,0.69,0.1343,33,87,120,0,120,120
17367,2012-12-31,Spring,2012,Dec,11,0,Monday,1,Misty,0.22,0.2273,0.6,0.194,43,114,157,0,157,157
17368,2012-12-31,Spring,2012,Dec,12,0,Monday,1,Misty,0.24,0.2273,0.56,0.194,52,172,224,0,224,224
17369,2012-12-31,Spring,2012,Dec,13,0,Monday,1,Misty,0.26,0.2576,0.44,0.1642,38,165,203,0,203,203
17370,2012-12-31,Spring,2012,Dec,14,0,Monday,1,Misty,0.28,0.2727,0.45,0.2239,62,185,247,0,247,247
17371,2012-12-31,Spring,2012,Dec,15,0,Monday,1,Misty,0.28,0.2879,0.45,0.1343,69,246,315,0,315,315
17372,2012-12-31,Spring,2012,Dec,16,0,Monday,1,Misty,0.26,0.2576,0.48,0.194,30,184,214,0,214,214
17373,2012-12-31,Spring,2012,Dec,17,0,Monday,1,Misty,0.26,0.2879,0.48,0.0896,14,150,164,0,164,164
17374,2012-12-31,Spring,2012,Dec,18,0,Monday,1,Misty,0.26,0.2727,0.48,0.1343,10,112,122,0,122,122
17375,2012-12-31,Spring,2012,Dec,19,0,Monday,1,Misty,0.26,0.2576,0.6,0.1642,11,108,119,0,119,119
17376,2012-12-31,Spring,2012,Dec,20,0,Monday,1,Misty,0.26,0.2576,0.6,0.1642,8,81,89,0,89,89
17377,2012-12-31,Spring,2012,Dec,21,0,Monday,1,Clear,0.26,0.2576,0.6,0.1642,7,83,90,0,90,90
17378,2012-12-31,Spring,2012,Dec,22,0,Monday,1,Clear,0.26,0.2727,0.56,0.1343,13,48,61,0,61,61
17379,2012-12-31,Spring,2012,Dec,23,0,Monday,1,Clear,0.26,0.2727,0.65,0.1343,12,37,49,0,49,49
